Account Number,Balance Date,Transaction Value,Balance
10005367,31/01/2023,,728.25
10005367,02/02/2023,-1097.6,-369.3499999999999
10005367,04/02/2023,144.75,-224.5999999999999
10005367,04/02/2023,-67.01,-291.6099999999999
10005367,05/02/2023,-108.26,-399.8699999999999
10005367,08/02/2023,941.0,541.1300000000001
10005367,08/02/2023,-65.49,475.6400000000001
10005367,10/02/2023,-27.61,448.0300000000001
10005367,11/02/2023,137.25,585.2800000000001
10011977,31/01/2023,,676.54
10011977,02/02/2023,-51.0,625.54
10011977,03/02/2023,120.88,746.42
10011977,04/02/2023,58.05,804.4699999999999
10011977,04/02/2023,-170.56,633.91
10011977,04/02/2023,-189.38,444.53
10011977,05/02/2023,-124.61,319.91999999999996
10011977,08/02/2023,133.74,453.65999999999997
10011977,10/02/2023,-103.55,350.10999999999996
10011977,11/02/2023,-43.89,306.21999999999997
10011977,14/02/2023,1100.7,1406.92
10024680,31/01/2023,,567.46
10024680,01/02/2023,-153.43,414.03000000000003
10024680,03/02/2023,676.5,1090.53
10024680,07/02/2023,-91.92,998.61
10024680,07/02/2023,-127.45,871.16
10024680,08/02/2023,-138.18,732.98
10031238,31/01/2023,,576.52
10031238,05/02/2023,121.7,698.22
10031238,05/02/2023,-110.07,588.15
10031238,09/02/2023,-35.39,552.76
10031238,10/02/2023,65.02,617.78
10031238,10/02/2023,-160.6,457.18
10031238,11/02/2023,-157.96,299.22
10034341,31/01/2023,,390.39
10034341,03/02/2023,1566.6,1956.9899999999998
10034341,05/02/2023,-217.15,1739.8399999999997
10034341,08/02/2023,-110.25,1629.5899999999997
10034341,12/02/2023,123.13,1752.7199999999998
10034341,14/02/2023,-74.72,1677.9999999999998
10079965,31/01/2023,,799.27
10079965,03/02/2023,156.35,955.62
10079965,08/02/2023,-63.9,891.72
10079965,08/02/2023,-132.2,759.52
10079965,08/02/2023,-442.3,317.21999999999997
10091076,31/01/2023,,831.83
10091076,01/02/2023,75.45,907.2800000000001
10091076,01/02/2023,-18.77,888.51
10091076,01/02/2023,-83.96,804.5500000000001
10091076,05/02/2023,53.92,858.47
10091076,14/02/2023,53.72,912.19
10091076,14/02/2023,-10.22,901.97
10231977,31/01/2023,,61.63
10231977,01/02/2023,116.0,177.63
10231977,08/02/2023,-68.31,109.32
10231977,09/02/2023,-1410.1,-1300.78
10231977,14/02/2023,78.92,-1221.86
10231977,14/02/2023,-723.4,-1945.26
10232603,31/01/2023,,732.55
10232603,01/02/2023,125.68,858.23
10232603,02/02/2023,-1190.9,-332.6700000000001
10232603,04/02/2023,-888.9,-1221.5700000000002
10232603,06/02/2023,88.22,-1133.3500000000001
10232603,07/02/2023,-185.47,-1318.8200000000002
10232603,10/02/2023,85.03,-1233.79
10232603,10/02/2023,-1128.4,-2362.19
10243581,31/01/2023,,104.27
10243581,04/02/2023,-109.65,-5.38000000000001
10243581,06/02/2023,-78.93,-84.31000000000002
10243581,10/02/2023,83.3,-1.0100000000000193
10243581,12/02/2023,-1482.9,-1483.91
10243581,13/02/2023,-20.17,-1504.0800000000002
10243581,14/02/2023,-134.51,-1638.5900000000001
10271519,31/01/2023,,50.02
10271519,03/02/2023,2285.6,2335.62
10271519,03/02/2023,95.05,2430.67
10271519,03/02/2023,17.57,2448.24
10271519,03/02/2023,-100.99,2347.25
10271519,11/02/2023,-89.55,2257.7
10271519,12/02/2023,98.81,2356.5099999999998
10271519,12/02/2023,76.71,2433.22
10273387,31/01/2023,,581.83
10273387,03/02/2023,113.03,694.86
10273387,03/02/2023,-556.5,138.36
10273387,06/02/2023,181.24,319.6
10273387,07/02/2023,-38.41,281.19000000000005
10273387,08/02/2023,-140.45,140.74000000000004
10273387,10/02/2023,138.8,279.5400000000001
10273387,10/02/2023,-71.11,208.43000000000006
10273387,12/02/2023,130.68,339.11000000000007
10273387,14/02/2023,278.4,617.51
10288821,31/01/2023,,642.41
10288821,07/02/2023,-151.7,490.71
10288821,11/02/2023,85.41,576.12
10288821,12/02/2023,228.52,804.64
10288821,14/02/2023,94.21,898.85
10295384,31/01/2023,,153.85
10295384,03/02/2023,10.64,164.49
10295384,04/02/2023,55.98,220.47
10295384,04/02/2023,-96.09,124.38
10295384,06/02/2023,100.34,224.72
10295384,06/02/2023,87.57,312.28999999999996
10295384,07/02/2023,186.15,498.44
10295384,07/02/2023,133.09,631.53
10295384,09/02/2023,-110.01,521.52
10295384,11/02/2023,-62.52,459.0
10295384,13/02/2023,128.0,587.0
10350324,31/01/2023,,861.81
10350324,03/02/2023,247.64,1109.4499999999998
10350324,04/02/2023,81.35,1190.8
10350324,04/02/2023,47.39,1238.1899999999998
10350324,07/02/2023,-42.19,1196.0
10350324,10/02/2023,-91.04,1104.96
10350324,11/02/2023,132.19,1237.1499999999999
10350324,11/02/2023,119.75,1356.8999999999999
10350324,13/02/2023,-142.63,1214.27
10437896,31/01/2023,,661.08
10437896,04/02/2023,55.24,716.32
10437896,04/02/2023,-51.84,664.48
10437896,06/02/2023,68.72,733.2
10437896,09/02/2023,116.34,849.5400000000001
10437896,11/02/2023,1107.1,1956.6399999999999
10437896,13/02/2023,73.97,2030.61
10449180,31/01/2023,,228.24
10449180,01/02/2023,48.99,277.23
10449180,02/02/2023,25.81,303.04
10449180,06/02/2023,784.3,1087.34
10449180,11/02/2023,75.88,1163.2199999999998
10464544,31/01/2023,,755.99
10464544,01/02/2023,-89.56,666.4300000000001
10464544,07/02/2023,135.77,802.2
10464544,08/02/2023,132.1,934.3
10464544,12/02/2023,-463.1,471.2
10464544,14/02/2023,987.9,1459.1
10464544,14/02/2023,-81.26,1377.84
10473116,31/01/2023,,387.7
10473116,01/02/2023,-94.91,292.78999999999996
10473116,03/02/2023,87.46,380.25
10473116,06/02/2023,-1194.9,-814.6500000000001
10473116,08/02/2023,103.49,-711.1600000000001
10473116,10/02/2023,28.23,-682.9300000000001
10473116,12/02/2023,-108.51,-791.44
10521885,31/01/2023,,54.87
10521885,01/02/2023,127.41,182.28
10521885,01/02/2023,-83.86,98.42
10521885,03/02/2023,120.33,218.75
10521885,09/02/2023,37.14,255.89
10521885,12/02/2023,70.6,326.49
10521885,14/02/2023,150.19,476.68
10521885,14/02/2023,53.35,530.03
10553619,31/01/2023,,756.2
10553619,01/02/2023,72.18,828.3800000000001
10553619,01/02/2023,-112.77,715.61
10553619,03/02/2023,133.94,849.5500000000001
10553619,04/02/2023,-1263.9,-414.35
10553619,05/02/2023,-89.62,-503.97
10553619,06/02/2023,-1085.4,-1589.3700000000001
10553619,11/02/2023,873.9,-715.4700000000001
10553619,14/02/2023,1485.6,770.1299999999998
10553619,14/02/2023,-43.02,727.1099999999998
10554116,31/01/2023,,243.95
10554116,01/02/2023,-121.83,122.11999999999999
10586481,31/01/2023,,73.83
10586481,03/02/2023,100.42,174.25
10586481,11/02/2023,142.56,316.81
10586481,12/02/2023,128.32,445.13
10586481,12/02/2023,-49.53,395.6
10586481,14/02/2023,-24.89,370.71
10608220,31/01/2023,,632.92
10608220,01/02/2023,33.49,666.41
10608220,01/02/2023,-89.41,577.0
10608220,04/02/2023,-117.26,459.73999999999995
10608220,05/02/2023,78.8,538.54
10608220,10/02/2023,-55.88,482.65999999999997
10608220,11/02/2023,-142.56,340.09999999999997
10608220,13/02/2023,86.79,426.89
10608220,13/02/2023,-98.19,328.7
10608220,13/02/2023,-118.5,210.2
10631690,31/01/2023,,947.45
10631690,03/02/2023,165.39,1112.8400000000001
10631690,03/02/2023,-41.04,1071.8
10631690,11/02/2023,-151.02,920.78
10675607,31/01/2023,,284.84
10675607,01/02/2023,-114.21,170.63
10675607,08/02/2023,-19.11,151.51999999999998
10675607,14/02/2023,-908.4,-756.88
10725127,31/01/2023,,984.69
10725127,04/02/2023,-1268.7,-284.01
10725127,09/02/2023,148.39,-135.62
10725127,11/02/2023,102.03,-33.59
10725127,12/02/2023,-228.52,-262.11
10725127,13/02/2023,-157.99,-420.1
10769769,31/01/2023,,906.91
10769769,01/02/2023,-93.28,813.63
10769769,02/02/2023,38.78,852.41
10769769,02/02/2023,-20.72,831.6899999999999
10769769,02/02/2023,-96.8,734.89
10769769,02/02/2023,-1502.2,-767.3100000000001
10769769,03/02/2023,-89.51,-856.82
10769769,05/02/2023,145.08,-711.74
10769769,05/02/2023,-59.15,-770.8900000000001
10769769,08/02/2023,-143.57,-914.46
10769769,09/02/2023,58.86,-855.6
10769769,10/02/2023,-51.82,-907.4200000000001
10769769,10/02/2023,-85.7,-993.1200000000001
10769769,11/02/2023,666.5,-326.6200000000001
10769769,11/02/2023,172.32,-154.30000000000013
10783139,31/01/2023,,992.98
10783139,04/02/2023,103.81,1096.79
10783139,05/02/2023,-92.78,1004.01
10783139,08/02/2023,-96.33,907.6800000000001
10783139,09/02/2023,9.69,917.37
10783139,09/02/2023,-129.76,787.61
10783139,10/02/2023,72.06,859.6700000000001
10783139,12/02/2023,109.08,968.75
10799356,31/01/2023,,915.04
10799356,06/02/2023,138.24,1053.28
10799356,06/02/2023,127.85,1181.1299999999999
10799356,11/02/2023,-120.98,1060.1499999999999
10799356,11/02/2023,-259.39,800.76
10799356,12/02/2023,-94.16,706.6
10799356,14/02/2023,-1314.7,-608.1
10819898,31/01/2023,,750.25
10819898,01/02/2023,103.68,853.9300000000001
10819898,02/02/2023,15.52,869.45
10819898,03/02/2023,-91.02,778.4300000000001
10819898,05/02/2023,-36.13,742.3
10819898,08/02/2023,123.29,865.59
10819898,10/02/2023,-104.75,760.84
10819898,12/02/2023,98.15,858.99
10819898,14/02/2023,114.54,973.53
10819898,14/02/2023,47.83,1021.36
10842511,31/01/2023,,651.77
10842511,02/02/2023,-155.92,495.85
10842511,13/02/2023,102.44,598.29
10847941,31/01/2023,,40.25
10847941,06/02/2023,-64.29,-24.040000000000006
10847941,07/02/2023,-143.62,-167.66000000000003
10847941,08/02/2023,92.54,-75.12000000000002
10847941,10/02/2023,-146.12,-221.24
10847941,11/02/2023,1094.0,872.76
10864084,31/01/2023,,119.98
10864084,02/02/2023,-150.75,-30.769999999999996
10864084,02/02/2023,-179.69,-210.45999999999998
10864084,05/02/2023,-39.08,-249.53999999999996
10864084,06/02/2023,154.92,-94.62
10864084,06/02/2023,114.81,20.189999999999998
10864084,06/02/2023,72.7,92.89
10864084,10/02/2023,98.32,191.20999999999998
10864084,11/02/2023,65.15,256.36
10864084,13/02/2023,-1545.5,-1289.1399999999999
10942334,31/01/2023,,55.42
10942334,05/02/2023,-92.89,-37.47
10942334,07/02/2023,-33.98,-71.44999999999999
10942334,10/02/2023,116.67,45.22
10942334,11/02/2023,84.45,129.67000000000002
10949168,31/01/2023,,471.8
10949168,04/02/2023,-105.89,365.91
10949168,04/02/2023,-127.73,238.18
10949168,07/02/2023,71.99,310.17
10949168,09/02/2023,-214.76,95.41000000000003
10949168,11/02/2023,146.95,242.36
10949168,12/02/2023,52.81,295.17
10949168,14/02/2023,-13.43,281.74
10989769,31/01/2023,,334.18
10989769,03/02/2023,854.4,1188.58
10989769,12/02/2023,-154.56,1034.02
10989769,13/02/2023,102.22,1136.24
10989769,13/02/2023,-66.55,1069.69
11008868,31/01/2023,,271.3
11008868,02/02/2023,-0.91,270.39
11008868,07/02/2023,-207.86,62.53
11008868,13/02/2023,96.98,159.51
11008868,13/02/2023,93.56,253.07
11008868,14/02/2023,131.58,384.65000000000003
11026937,31/01/2023,,303.44
11026937,02/02/2023,90.91,394.35
11026937,02/02/2023,-47.72,346.63
11026937,06/02/2023,-85.44,261.19
11026937,07/02/2023,-75.08,186.11
11026937,07/02/2023,-92.55,93.56
11026937,13/02/2023,-42.26,51.300000000000004
11026937,14/02/2023,67.47,118.77000000000001
11061291,31/01/2023,,72.7
11061291,01/02/2023,-162.41,-89.71
11061291,03/02/2023,-53.42,-143.13
11061291,03/02/2023,-149.54,-292.66999999999996
11061291,04/02/2023,186.95,-105.72
11061291,08/02/2023,61.41,-44.31
11061291,08/02/2023,5.73,-38.58
11061291,09/02/2023,-119.17,-157.75
11061291,12/02/2023,121.86,-35.89
11061291,14/02/2023,-78.98,-114.87
11067879,31/01/2023,,481.56
11067879,01/02/2023,187.01,668.5699999999999
11067879,01/02/2023,-812.6,-144.02999999999997
11067879,02/02/2023,-15.52,-159.54999999999998
11067879,04/02/2023,81.63,-77.91999999999997
11067879,06/02/2023,97.09,19.17000000000003
11067879,07/02/2023,151.33,170.50000000000006
11067879,07/02/2023,-96.93,73.57000000000002
11067879,07/02/2023,-123.45,-49.87999999999998
11067879,08/02/2023,-66.39,-116.26999999999998
11067879,11/02/2023,172.57,56.30000000000001
11067879,11/02/2023,-87.16,-30.859999999999985
11067879,13/02/2023,-78.91,-109.76999999999998
11110085,31/01/2023,,861.29
11110085,03/02/2023,107.9,969.1899999999999
11110085,05/02/2023,1712.2,2681.39
11110085,06/02/2023,97.33,2778.7200000000003
11110085,11/02/2023,109.66,2888.38
11110085,12/02/2023,122.36,3010.7400000000002
11110085,12/02/2023,-66.27,2944.4700000000003
11110085,13/02/2023,-147.67,2796.8
11110085,14/02/2023,1397.8,4194.6
11110085,14/02/2023,-152.84,4041.76
11150945,31/01/2023,,858.83
11150945,01/02/2023,240.2,1099.03
11150945,01/02/2023,-345.3,753.73
11150945,03/02/2023,32.07,785.8000000000001
11150945,03/02/2023,-189.03,596.77
11150945,06/02/2023,43.59,640.36
11150945,09/02/2023,133.16,773.52
11150945,09/02/2023,98.03,871.55
11150945,13/02/2023,763.2,1634.75
11150945,13/02/2023,-126.72,1508.03
11228111,31/01/2023,,130.36
11228111,01/02/2023,-142.2,-11.839999999999975
11228111,02/02/2023,-1501.3,-1513.1399999999999
11228111,09/02/2023,179.65,-1333.4899999999998
11228111,10/02/2023,169.47,-1164.02
11228111,11/02/2023,77.54,-1086.4799999999998
11228111,11/02/2023,69.11,-1017.3699999999999
11242986,31/01/2023,,344.68
11242986,01/02/2023,-160.4,184.28
11242986,06/02/2023,-21.12,163.16
11242986,08/02/2023,-93.77,69.39
11242986,09/02/2023,55.87,125.25999999999999
11242986,11/02/2023,-102.16,23.099999999999994
11251776,31/01/2023,,504.02
11251776,03/02/2023,88.94,592.96
11251776,04/02/2023,84.15,677.11
11251776,09/02/2023,150.22,827.3299999999999
11251776,10/02/2023,-67.69,759.64
11251776,11/02/2023,79.08,838.72
11251776,14/02/2023,-950.7,-111.98000000000002
11302888,31/01/2023,,458.83
11302888,04/02/2023,117.6,576.43
11302888,05/02/2023,-80.56,495.87
11302888,06/02/2023,182.96,678.8299999999999
11302888,10/02/2023,-19.72,659.11
11306584,31/01/2023,,522.4
11306584,01/02/2023,52.0,574.4
11306584,03/02/2023,-432.2,142.2
11306584,07/02/2023,1198.9,1341.1000000000001
11306584,07/02/2023,45.38,1386.4800000000002
11306584,09/02/2023,151.14,1537.6200000000001
11306584,10/02/2023,-30.61,1507.0100000000002
11306584,11/02/2023,63.83,1570.8400000000001
11306584,12/02/2023,1681.9,3252.7400000000002
11306584,12/02/2023,-71.74,3181.0000000000005
11306584,14/02/2023,-701.1,2479.9
11333185,31/01/2023,,693.23
11333185,02/02/2023,99.58,792.8100000000001
11333185,06/02/2023,113.2,906.01
11333185,06/02/2023,-676.7,229.30999999999995
11333185,07/02/2023,186.08,415.39
11333185,07/02/2023,-1440.9,-1025.5100000000002
11333185,10/02/2023,-67.29,-1092.8000000000002
11333185,11/02/2023,155.81,-936.9900000000002
11333185,11/02/2023,88.41,-848.5800000000003
11333185,11/02/2023,-138.48,-987.0600000000002
11333185,13/02/2023,1582.4,595.3399999999999
11346696,31/01/2023,,661.99
11346696,04/02/2023,-91.69,570.3
11346696,06/02/2023,-75.77,494.53000000000003
11346696,09/02/2023,-113.15,381.38
11346696,10/02/2023,-812.8,-431.41999999999996
11346696,13/02/2023,-1487.7,-1919.12
11359678,31/01/2023,,837.17
11359678,07/02/2023,65.16,902.3299999999999
11359678,07/02/2023,-67.04,835.29
11359678,11/02/2023,62.24,897.53
11359678,14/02/2023,-74.53,823.0
11360263,31/01/2023,,136.79
11360263,01/02/2023,100.02,236.81
11360263,03/02/2023,130.53,367.34
11360263,03/02/2023,101.8,469.14
11360263,06/02/2023,173.03,642.17
11360263,06/02/2023,80.15,722.3199999999999
11360263,09/02/2023,-68.25,654.0699999999999
11360263,12/02/2023,-47.25,606.8199999999999
11368995,31/01/2023,,565.8
11368995,01/02/2023,-63.48,502.31999999999994
11368995,02/02/2023,150.75,653.0699999999999
11368995,02/02/2023,-140.61,512.4599999999999
11368995,04/02/2023,-121.49,390.96999999999997
11368995,05/02/2023,-92.6,298.36999999999995
11368995,06/02/2023,52.22,350.59
11368995,08/02/2023,65.06,415.65
11437275,31/01/2023,,115.34
11437275,05/02/2023,98.47,213.81
11437275,07/02/2023,112.5,326.31
11437275,07/02/2023,-144.5,181.81
11437275,09/02/2023,94.06,275.87
11437275,10/02/2023,-100.43,175.44
11437275,10/02/2023,-112.61,62.83
11438427,31/01/2023,,484.08
11438427,06/02/2023,123.77,607.85
11438427,07/02/2023,-23.9,583.9499999999999
11438427,08/02/2023,-190.12,393.83
11438427,08/02/2023,-1686.0,-1292.17
11463412,31/01/2023,,342.53
11463412,07/02/2023,-97.82,244.70999999999998
11463412,09/02/2023,1582.3,1827.01
11475827,31/01/2023,,363.88
11475827,01/02/2023,48.39,412.27
11475827,07/02/2023,89.09,501.36
11475827,08/02/2023,-45.54,455.82
11475827,11/02/2023,1129.9,1585.72
11475827,11/02/2023,86.86,1672.58
11475827,12/02/2023,106.02,1778.6
11522216,31/01/2023,,590.37
11522216,03/02/2023,43.61,633.98
11522216,04/02/2023,199.41,833.39
11522216,10/02/2023,106.62,940.01
11522216,10/02/2023,82.97,1022.98
11522216,14/02/2023,81.37,1104.35
11662506,31/01/2023,,573.89
11662506,01/02/2023,-167.85,406.03999999999996
11662506,05/02/2023,102.96,509.0
11662506,05/02/2023,89.72,598.72
11662506,09/02/2023,-38.09,560.63
11662506,09/02/2023,-134.78,425.84999999999997
11662506,11/02/2023,-84.35,341.5
11662506,14/02/2023,-77.33,264.16999999999996
11662506,14/02/2023,-1397.8,-1133.63
11694020,31/01/2023,,379.2
11694020,04/02/2023,-189.72,189.48
11694020,06/02/2023,44.43,233.91
11694020,09/02/2023,-1363.6,-1129.6899999999998
11694020,12/02/2023,1.29,-1128.3999999999999
11694020,14/02/2023,725.0,-403.39999999999986
11717885,31/01/2023,,6.06
11717885,05/02/2023,-72.53,-66.47
11717885,13/02/2023,-86.51,-152.98000000000002
11728970,31/01/2023,,711.65
11728970,06/02/2023,123.61,835.26
11728970,06/02/2023,84.79,920.05
11728970,09/02/2023,-135.18,784.87
11728970,14/02/2023,93.35,878.22
11736814,31/01/2023,,381.51
11736814,03/02/2023,-133.06,248.45
11736814,05/02/2023,-790.5,-542.05
11736814,06/02/2023,98.86,-443.18999999999994
11736814,11/02/2023,-1851.4,-2294.59
11744491,31/01/2023,,105.92
11744491,01/02/2023,142.98,248.89999999999998
11744491,01/02/2023,112.17,361.07
11744491,03/02/2023,656.3,1017.3699999999999
11744491,04/02/2023,-144.75,872.6199999999999
11744491,06/02/2023,-92.39,780.2299999999999
11744491,09/02/2023,87.15,867.3799999999999
11744491,09/02/2023,-176.85,690.53
11744491,10/02/2023,-39.7,650.8299999999999
11744491,11/02/2023,85.89,736.7199999999999
11744491,12/02/2023,-55.81,680.9099999999999
11744491,13/02/2023,115.86,796.7699999999999
11744491,13/02/2023,-121.39,675.3799999999999
11764022,31/01/2023,,286.66
11764022,01/02/2023,-117.24,169.42000000000002
11764022,03/02/2023,3.65,173.07000000000002
11764022,10/02/2023,86.61,259.68000000000006
11778031,31/01/2023,,514.7
11778031,08/02/2023,-37.69,477.01000000000005
11778031,09/02/2023,-64.44,412.57000000000005
11778031,11/02/2023,102.08,514.6500000000001
11778031,13/02/2023,569.6,1084.25
11790056,31/01/2023,,49.7
11790056,01/02/2023,119.97,169.67000000000002
11790056,01/02/2023,-95.49,74.18
11790056,03/02/2023,12.0,86.18
11790056,05/02/2023,-91.81,-5.6299999999999955
11790056,06/02/2023,-47.78,-53.41
11790056,06/02/2023,-688.5,-741.91
11790056,08/02/2023,90.7,-651.2099999999999
11790056,08/02/2023,-41.57,-692.78
11790056,09/02/2023,-969.7,-1662.48
11804173,31/01/2023,,353.62
11804173,02/02/2023,119.36,472.98
11804173,04/02/2023,100.25,573.23
11804173,04/02/2023,-159.42,413.81
11804173,11/02/2023,-53.59,360.22
11826060,31/01/2023,,782.13
11826060,05/02/2023,63.32,845.45
11826060,07/02/2023,81.64,927.09
11826060,09/02/2023,38.13,965.22
11826060,11/02/2023,-63.83,901.39
11826060,13/02/2023,118.67,1020.06
11826060,13/02/2023,93.04,1113.1
11831265,31/01/2023,,292.14
11831265,01/02/2023,-91.77,200.37
11831265,01/02/2023,-103.4,96.96999999999998
11831265,01/02/2023,-140.67,-43.7
11831265,09/02/2023,-98.31,-142.01
11831265,10/02/2023,89.98,-52.03
11831265,13/02/2023,157.99,105.96000000000001
11831265,14/02/2023,-85.67,20.290000000000006
11836917,31/01/2023,,650.14
11836917,01/02/2023,-138.19,511.95
11836917,12/02/2023,90.66,602.61
11836917,14/02/2023,165.55,768.16
11836917,14/02/2023,87.88,856.04
11846043,31/01/2023,,915.59
11846043,02/02/2023,69.49,985.08
11846043,06/02/2023,87.82,1072.9
11846043,07/02/2023,-56.28,1016.62
11846043,10/02/2023,-1640.4,-623.7800000000001
11846043,12/02/2023,139.76,-484.0200000000001
11882775,31/01/2023,,299.41
11882775,01/02/2023,-105.63,193.78000000000003
11882775,01/02/2023,-1058.7,-864.9200000000001
11882775,03/02/2023,118.76,-746.1600000000001
11882775,03/02/2023,-753.5,-1499.66
11882775,05/02/2023,84.05,-1415.6100000000001
11882775,06/02/2023,-90.05,-1505.66
11882775,06/02/2023,-1791.9,-3297.5600000000004
11882775,08/02/2023,209.73,-3087.8300000000004
11882775,09/02/2023,1202.9,-1884.93
11910409,31/01/2023,,241.22
11910409,01/02/2023,-80.43,160.79
11910409,04/02/2023,-78.93,81.85999999999999
11910409,05/02/2023,78.36,160.21999999999997
11910409,05/02/2023,-118.22,41.999999999999986
11910409,06/02/2023,-53.53,-11.530000000000015
11910409,12/02/2023,103.79,92.25999999999999
11910409,13/02/2023,112.31,204.57
11928523,31/01/2023,,818.51
11928523,05/02/2023,-149.91,668.6
11928523,07/02/2023,-76.58,592.02
11928523,08/02/2023,-74.38,517.64
11928523,11/02/2023,99.31,616.95
11928523,12/02/2023,2208.4,2825.3500000000004
11928523,13/02/2023,68.67,2894.02
12035637,31/01/2023,,461.35
12035637,02/02/2023,-779.9,-318.54999999999995
12035637,02/02/2023,-1138.0,-1456.55
12035637,03/02/2023,-36.14,-1492.69
12035637,07/02/2023,1190.8,-301.8900000000001
12035637,07/02/2023,260.82,-41.07000000000011
12035637,07/02/2023,230.31,189.2399999999999
12035637,08/02/2023,-90.52,98.7199999999999
12035637,08/02/2023,-143.15,-44.430000000000106
12035637,08/02/2023,-1169.6,-1214.03
12035637,10/02/2023,551.6,-662.43
12035637,11/02/2023,-137.31,-799.74
12035637,12/02/2023,-123.5,-923.24
12042151,31/01/2023,,336.44
12042151,03/02/2023,-89.74,246.7
12042151,05/02/2023,97.45,344.15
12042151,07/02/2023,101.5,445.65
12042151,09/02/2023,-64.03,381.62
12042151,11/02/2023,1271.5,1653.12
12042151,11/02/2023,-32.04,1621.08
12042151,13/02/2023,-61.53,1559.55
12088180,31/01/2023,,656.51
12088180,11/02/2023,22.62,679.13
12088180,12/02/2023,190.9,870.03
12088180,14/02/2023,-45.9,824.13
12099406,31/01/2023,,681.11
12099406,01/02/2023,-94.97,586.14
12099406,07/02/2023,-934.2,-348.06000000000006
12099406,10/02/2023,-143.73,-491.7900000000001
12099406,12/02/2023,1201.1,709.3099999999998
12099406,13/02/2023,112.0,821.3099999999998
12111805,31/01/2023,,890.99
12111805,01/02/2023,110.9,1001.89
12111805,03/02/2023,-79.35,922.54
12111805,06/02/2023,128.91,1051.45
12111805,10/02/2023,-185.21,866.24
12111805,11/02/2023,-77.84,788.4
12111805,13/02/2023,-202.54,585.86
12111805,14/02/2023,-94.45,491.41
12172627,31/01/2023,,550.41
12172627,02/02/2023,137.03,687.4399999999999
12172627,05/02/2023,-116.16,571.28
12172627,12/02/2023,-76.51,494.77
12185627,31/01/2023,,873.23
12185627,02/02/2023,-30.52,842.71
12185627,03/02/2023,225.89,1068.6
12185627,04/02/2023,-50.19,1018.41
12185627,05/02/2023,-80.67,937.74
12185627,10/02/2023,206.97,1144.71
12185627,11/02/2023,193.89,1338.6
12185627,11/02/2023,100.94,1439.54
12185627,12/02/2023,-72.94,1366.6
12185627,13/02/2023,-91.8,1274.8
12198380,31/01/2023,,445.46
12198380,03/02/2023,145.97,591.43
12198380,04/02/2023,134.24,725.67
12198380,05/02/2023,100.05,825.72
12198380,05/02/2023,-144.38,681.3399999999999
12198380,05/02/2023,-171.75,509.59
12198380,07/02/2023,-34.47,475.12
12198380,09/02/2023,145.71,620.8299999999999
12198380,12/02/2023,67.66,688.49
12198380,14/02/2023,-85.37,603.12
12199229,31/01/2023,,804.0
12199229,11/02/2023,-30.47,773.53
12199229,11/02/2023,-31.4,742.13
12233762,31/01/2023,,386.05
12233762,05/02/2023,-114.97,271.08000000000004
12233762,06/02/2023,-102.35,168.73000000000002
12233762,07/02/2023,-110.05,58.68000000000002
12233762,07/02/2023,-134.62,-75.93999999999998
12233762,10/02/2023,83.93,7.990000000000023
12233762,11/02/2023,-370.4,-362.40999999999997
12233762,12/02/2023,150.86,-211.54999999999995
12233762,14/02/2023,-176.37,-387.91999999999996
12240007,31/01/2023,,894.48
12240007,02/02/2023,93.98,988.46
12240007,04/02/2023,-2.44,986.02
12240007,05/02/2023,1748.6,2734.62
12240007,05/02/2023,-64.41,2670.21
12240007,12/02/2023,-127.13,2543.08
12240007,13/02/2023,-562.4,1980.6799999999998
12241820,31/01/2023,,207.29
12388837,31/01/2023,,463.31
12388837,03/02/2023,55.47,518.78
12388837,05/02/2023,-183.42,335.36
12388837,07/02/2023,65.45,400.81
12388837,13/02/2023,111.37,512.1800000000001
12388837,14/02/2023,87.61,599.79
12420291,31/01/2023,,578.47
12420291,03/02/2023,-1223.8,-645.3299999999999
12420291,08/02/2023,-796.3,-1441.6299999999999
12420291,11/02/2023,-105.46,-1547.09
12420291,12/02/2023,-70.05,-1617.1399999999999
12423613,31/01/2023,,459.18
12423613,02/02/2023,-1805.5,-1346.32
12423613,04/02/2023,95.13,-1251.19
12423613,14/02/2023,73.71,-1177.48
12440230,31/01/2023,,842.67
12440230,07/02/2023,16.27,858.9399999999999
12440230,07/02/2023,-197.12,661.8199999999999
12440230,14/02/2023,-175.06,486.76
12493067,31/01/2023,,404.61
12493067,03/02/2023,86.49,491.1
12493067,06/02/2023,114.74,605.84
12493067,08/02/2023,-105.32,500.52
12493067,13/02/2023,-93.04,407.48
12493067,14/02/2023,44.96,452.44
12494185,31/01/2023,,762.16
12494185,04/02/2023,71.39,833.55
12494185,04/02/2023,-97.26,736.29
12494185,07/02/2023,-97.29,639.0
12494185,07/02/2023,-117.32,521.68
12499656,31/01/2023,,96.27
12499656,01/02/2023,168.84,265.11
12499656,01/02/2023,75.09,340.2
12499656,02/02/2023,140.57,480.77
12499656,03/02/2023,-111.35,369.41999999999996
12499656,05/02/2023,147.75,517.17
12499656,06/02/2023,-88.22,428.95
12499656,07/02/2023,-38.62,390.33
12499656,10/02/2023,152.92,543.25
12499656,13/02/2023,98.34,641.5899999999999
12499656,14/02/2023,-156.27,485.31999999999994
12560453,31/01/2023,,85.03
12560453,01/02/2023,147.6,232.63
12560453,05/02/2023,152.02,384.65
12560453,05/02/2023,71.33,455.98
12560453,08/02/2023,47.58,503.56
12560453,08/02/2023,-55.71,447.85
12560453,13/02/2023,-49.05,398.8
12583269,31/01/2023,,910.46
12583269,02/02/2023,125.46,1035.92
12583269,03/02/2023,-118.33,917.59
12583269,04/02/2023,-129.11,788.48
12583269,05/02/2023,80.89,869.37
12583269,14/02/2023,63.34,932.71
12666385,31/01/2023,,554.24
12666385,01/02/2023,246.14,800.38
12666385,01/02/2023,106.46,906.84
12666385,04/02/2023,1593.8,2500.64
12666385,12/02/2023,149.57,2650.21
12680102,31/01/2023,,674.64
12680102,05/02/2023,-41.65,632.99
12680102,08/02/2023,603.0,1235.99
12680102,09/02/2023,-97.29,1138.7
12680102,11/02/2023,-1010.6,128.10000000000002
12680102,12/02/2023,94.03,222.13000000000002
12680102,13/02/2023,-851.7,-629.57
12725274,31/01/2023,,26.19
12725274,01/02/2023,167.85,194.04
12725274,04/02/2023,125.11,319.15
12725274,05/02/2023,-58.28,260.87
12725274,14/02/2023,412.8,673.6700000000001
12725274,14/02/2023,-162.9,510.77
12859818,31/01/2023,,151.06
12859818,01/02/2023,89.22,240.28
12859818,03/02/2023,-129.38,110.9
12859818,04/02/2023,-81.01,29.89
12859818,04/02/2023,-110.3,-80.41
12859818,07/02/2023,-106.24,-186.64999999999998
12859818,10/02/2023,-36.91,-223.56
12859818,10/02/2023,-131.38,-354.94
12859818,13/02/2023,-203.37,-558.31
12859818,14/02/2023,24.89,-533.42
12899540,31/01/2023,,957.2
12899540,01/02/2023,-83.35,873.85
12899540,04/02/2023,125.25,999.1
12899540,06/02/2023,159.04,1158.14
12899540,06/02/2023,-78.47,1079.67
12899540,10/02/2023,-85.03,994.6400000000001
12964138,31/01/2023,,557.04
12964138,01/02/2023,101.62,658.66
12964138,01/02/2023,-55.49,603.17
12964138,06/02/2023,104.0,707.17
12964138,13/02/2023,-357.3,349.86999999999995
12985543,31/01/2023,,402.94
12985543,01/02/2023,-140.27,262.66999999999996
12985543,07/02/2023,-99.51,163.15999999999997
12985543,09/02/2023,118.41,281.57
12985543,11/02/2023,57.3,338.87
12985543,13/02/2023,-62.13,276.73999999999995
13058003,31/01/2023,,218.0
13058003,02/02/2023,-35.9,182.1
13058003,09/02/2023,-1246.4,-1064.3000000000002
13058003,11/02/2023,-96.36,-1160.66
13058003,13/02/2023,565.6,-595.0600000000002
13076932,31/01/2023,,419.47
13076932,02/02/2023,-125.46,294.01000000000005
13076932,08/02/2023,-94.91,199.10000000000002
13076932,11/02/2023,146.03,345.13000000000005
13076932,13/02/2023,136.72,481.85
13117442,31/01/2023,,799.69
13117442,02/02/2023,-46.31,753.3800000000001
13117442,05/02/2023,101.84,855.22
13117442,05/02/2023,59.8,915.0200000000001
13117442,05/02/2023,-164.35,750.6700000000001
13117442,08/02/2023,-109.72,640.95
13117442,11/02/2023,1828.9,2469.8500000000004
13117442,12/02/2023,-132.28,2337.57
13167285,31/01/2023,,301.93
13167285,01/02/2023,-3.89,298.04
13167285,01/02/2023,-199.99,98.05000000000001
13167285,03/02/2023,139.6,237.65
13167285,03/02/2023,-529.6,-291.95000000000005
13167285,05/02/2023,-21.67,-313.62000000000006
13167285,06/02/2023,204.86,-108.76000000000005
13167285,07/02/2023,-78.2,-186.96000000000004
13167285,09/02/2023,-20.1,-207.06000000000006
13167285,13/02/2023,-99.54,-306.6
13167285,13/02/2023,-136.9,-443.50000000000006
13167285,14/02/2023,38.92,-404.58000000000004
13176075,31/01/2023,,67.3
13176075,04/02/2023,127.96,195.26
13176075,08/02/2023,-167.77,27.48999999999998
13176075,12/02/2023,-149.27,-121.78000000000003
13182613,31/01/2023,,384.42
13182613,05/02/2023,220.0,604.4200000000001
13182613,06/02/2023,63.49,667.91
13182613,08/02/2023,-113.46,554.45
13182613,09/02/2023,55.88,610.33
13182613,09/02/2023,-79.45,530.88
13197335,31/01/2023,,625.71
13197335,01/02/2023,98.45,724.1600000000001
13197335,01/02/2023,85.83,809.99
13197335,02/02/2023,100.61,910.6
13197335,02/02/2023,-93.5,817.1
13197335,08/02/2023,79.86,896.96
13197335,09/02/2023,1043.8,1940.76
13197335,10/02/2023,1812.5,3753.26
13197335,11/02/2023,-215.83,3537.43
13267945,31/01/2023,,299.77
13267945,03/02/2023,102.35,402.12
13267945,04/02/2023,1080.2,1482.3200000000002
13267945,07/02/2023,81.75,1564.07
13267945,08/02/2023,154.6,1718.6699999999998
13267945,10/02/2023,71.11,1789.78
13274987,31/01/2023,,902.06
13274987,01/02/2023,-33.51,868.55
13274987,03/02/2023,-53.43,815.1199999999999
13274987,03/02/2023,-111.04,704.0799999999999
13274987,04/02/2023,-93.78,610.3
13274987,05/02/2023,101.16,711.4599999999999
13274987,08/02/2023,1290.2,2001.6599999999999
13274987,12/02/2023,118.61,2120.27
13274987,12/02/2023,-117.48,2002.79
13277127,31/01/2023,,793.22
13277127,03/02/2023,17.26,810.48
13277127,05/02/2023,-17.93,792.5500000000001
13277127,06/02/2023,-1037.3,-244.7499999999999
13277127,08/02/2023,714.2,469.45000000000016
13277127,08/02/2023,251.9,721.3500000000001
13322659,31/01/2023,,690.27
13322659,01/02/2023,-153.9,536.37
13322659,02/02/2023,-145.27,391.09999999999997
13322659,04/02/2023,123.49,514.5899999999999
13322659,05/02/2023,36.77,551.36
13322659,05/02/2023,-53.92,497.43999999999994
13322659,09/02/2023,-85.8,411.64
13322659,09/02/2023,-106.38,305.26
13322659,14/02/2023,-113.46,191.79999999999995
13388069,31/01/2023,,13.45
13388069,07/02/2023,134.99,148.44
13388069,08/02/2023,27.53,175.97
13388069,12/02/2023,-69.99,105.98
13426667,31/01/2023,,70.47
13426667,05/02/2023,-121.7,-51.230000000000004
13426667,08/02/2023,32.44,-18.790000000000006
13426667,12/02/2023,1224.6,1205.81
13426667,13/02/2023,-902.0,303.80999999999995
13459523,31/01/2023,,814.31
13459523,03/02/2023,135.59,949.9
13459523,03/02/2023,-952.0,-2.1000000000000227
13459523,06/02/2023,-171.67,-173.77
13459523,07/02/2023,57.31,-116.46000000000001
13459523,08/02/2023,898.2,781.74
13459523,10/02/2023,166.54,948.28
13459523,10/02/2023,-132.35,815.9300000000001
13459523,13/02/2023,162.92,978.85
13474543,31/01/2023,,438.36
13474543,01/02/2023,120.92,559.28
13474543,05/02/2023,-107.87,451.41
13474543,06/02/2023,87.33,538.74
13474543,09/02/2023,264.6,803.34
13474543,14/02/2023,159.08,962.4200000000001
13474543,14/02/2023,76.83,1039.25
13537427,31/01/2023,,556.98
13537427,01/02/2023,52.56,609.54
13537427,07/02/2023,164.7,774.24
13537427,11/02/2023,246.42,1020.66
13537427,12/02/2023,-172.13,848.53
13551717,31/01/2023,,26.95
13551717,01/02/2023,-1361.0,-1334.05
13551717,05/02/2023,-627.1,-1961.15
13551717,11/02/2023,-42.85,-2004.0
13551717,14/02/2023,-115.32,-2119.32
13558846,31/01/2023,,598.45
13558846,01/02/2023,50.33,648.7800000000001
13558846,01/02/2023,-94.06,554.72
13558846,04/02/2023,148.08,702.8000000000001
13558846,05/02/2023,-148.46,554.34
13558846,09/02/2023,-115.1,439.24000000000007
13558846,13/02/2023,-112.18,327.06000000000006
13563384,31/01/2023,,952.65
13563384,02/02/2023,39.75,992.4
13563384,11/02/2023,54.28,1046.68
13563384,12/02/2023,70.05,1116.73
13563384,14/02/2023,-860.1,256.63
13584908,31/01/2023,,162.0
13584908,02/02/2023,-75.16,86.84
13584908,05/02/2023,-85.05,1.7900000000000063
13584908,10/02/2023,135.21,137.0
13584908,10/02/2023,-81.43,55.57000000000002
13610259,31/01/2023,,587.73
13610259,09/02/2023,33.72,621.45
13610259,10/02/2023,655.8,1277.25
13610259,11/02/2023,91.03,1368.28
13610259,12/02/2023,-100.74,1267.54
13687711,31/01/2023,,757.76
13687711,02/02/2023,-75.11,682.65
13687711,04/02/2023,-135.11,547.54
13687711,11/02/2023,-73.61,473.92999999999995
13687711,13/02/2023,734.3,1208.23
13687711,14/02/2023,-76.83,1131.3999999999999
13713704,31/01/2023,,1.48
13713704,02/02/2023,91.84,93.32000000000001
13713704,04/02/2023,-184.38,-91.05999999999999
13713704,10/02/2023,122.82,31.760000000000005
13713704,10/02/2023,-97.03,-65.27
13713704,11/02/2023,78.2,12.930000000000007
13713704,13/02/2023,-14.09,-1.159999999999993
13788234,31/01/2023,,302.78
13788234,06/02/2023,-100.59,202.18999999999997
13788234,07/02/2023,-140.37,61.819999999999965
13788234,07/02/2023,-163.8,-101.98000000000005
13788234,08/02/2023,-33.64,-135.62000000000006
13788234,10/02/2023,147.03,11.409999999999968
13788234,14/02/2023,112.47,123.87999999999997
13788234,14/02/2023,90.07,213.94999999999996
13945841,31/01/2023,,339.81
13945841,01/02/2023,473.7,813.51
13945841,14/02/2023,43.02,856.53
13965360,31/01/2023,,299.46
13965360,11/02/2023,-1655.3,-1355.84
13997603,31/01/2023,,516.79
13997603,03/02/2023,34.72,551.51
13997603,07/02/2023,788.3,1339.81
13997603,07/02/2023,52.55,1392.36
13997603,10/02/2023,-69.88,1322.48
13997603,10/02/2023,-155.28,1167.1999999999998
14000447,31/01/2023,,443.94
14000447,01/02/2023,97.79,541.73
14000447,06/02/2023,-154.42,387.31
14000447,09/02/2023,-74.98,312.33
14000447,10/02/2023,26.87,339.2
14000447,13/02/2023,147.67,486.87
14000447,13/02/2023,-55.26,431.60999999999996
14014401,31/01/2023,,554.46
14014401,06/02/2023,185.73,740.19
14014401,08/02/2023,40.08,780.27
14014401,09/02/2023,-1549.1,-768.8299999999999
14014401,10/02/2023,73.16,-695.67
14039438,31/01/2023,,94.52
14039438,02/02/2023,248.7,343.21999999999997
14039438,03/02/2023,117.17,460.39
14039438,05/02/2023,35.3,495.68999999999994
14039438,06/02/2023,-155.88,339.80999999999995
14039438,09/02/2023,141.4,481.21
14045416,31/01/2023,,265.63
14045416,01/02/2023,-53.46,212.17
14045416,02/02/2023,152.95,365.12
14045416,03/02/2023,67.35,432.46999999999997
14045416,03/02/2023,-89.03,343.43999999999994
14045416,08/02/2023,-42.88,300.55999999999995
14052052,31/01/2023,,915.74
14052052,05/02/2023,-89.52,826.22
14052052,08/02/2023,-192.5,633.72
14052052,09/02/2023,-512.3,121.42000000000007
14052052,09/02/2023,-666.4,-544.9799999999999
14052052,12/02/2023,117.55,-427.4299999999999
14052052,14/02/2023,-137.73,-565.1599999999999
14086187,31/01/2023,,340.59
14086187,02/02/2023,551.2,891.79
14086187,03/02/2023,166.13,1057.92
14086187,04/02/2023,146.29,1204.21
14086187,05/02/2023,-98.2,1106.01
14086187,06/02/2023,135.77,1241.78
14086187,08/02/2023,58.95,1300.73
14086187,08/02/2023,-42.56,1258.17
14103210,31/01/2023,,369.01
14103210,04/02/2023,-111.88,257.13
14103210,06/02/2023,-1.14,255.99
14103210,06/02/2023,-1144.5,-888.51
14103210,08/02/2023,116.37,-772.14
14103210,09/02/2023,-6.19,-778.33
14103210,11/02/2023,130.19,-648.14
14103210,11/02/2023,-151.17,-799.31
14103210,13/02/2023,1406.7,607.3900000000001
14136082,31/01/2023,,219.84
14136082,01/02/2023,82.18,302.02
14136082,02/02/2023,526.8,828.8199999999999
14136082,03/02/2023,89.93,918.75
14136082,07/02/2023,49.76,968.51
14136082,09/02/2023,125.63,1094.1399999999999
14136082,11/02/2023,-39.58,1054.56
14136082,11/02/2023,-169.33,885.2299999999999
14136082,12/02/2023,351.6,1236.83
14136082,14/02/2023,140.8,1377.6299999999999
14144267,31/01/2023,,97.69
14144267,06/02/2023,44.47,142.16
14144267,08/02/2023,114.12,256.28
14144267,09/02/2023,89.43,345.71000000000004
14183437,31/01/2023,,779.47
14183437,02/02/2023,30.01,809.48
14183437,02/02/2023,-95.08,714.4000000000001
14183437,03/02/2023,99.07,813.47
14183437,10/02/2023,1975.6,2789.0699999999997
14183437,11/02/2023,43.17,2832.24
14183437,11/02/2023,-90.85,2741.39
14183437,14/02/2023,120.06,2861.45
14253152,31/01/2023,,43.85
14253152,03/02/2023,81.28,125.13
14253152,04/02/2023,-111.13,14.0
14253152,06/02/2023,176.53,190.53
14253152,08/02/2023,215.14,405.66999999999996
14253152,09/02/2023,-157.13,248.54
14253152,11/02/2023,-130.43,118.10999999999999
14253152,14/02/2023,100.16,218.26999999999998
14253152,14/02/2023,-963.5,-745.23
14337606,31/01/2023,,561.8
14337606,04/02/2023,-53.8,507.99999999999994
14337606,04/02/2023,-79.62,428.37999999999994
14337606,06/02/2023,-1792.7,-1364.3200000000002
14337606,08/02/2023,-160.99,-1525.3100000000002
14337606,09/02/2023,-158.61,-1683.92
14337606,11/02/2023,175.69,-1508.2300000000002
14337606,11/02/2023,-170.72,-1678.9500000000003
14337606,12/02/2023,-132.03,-1810.9800000000002
14337606,14/02/2023,76.49,-1734.4900000000002
14355869,31/01/2023,,329.16
14355869,01/02/2023,-1052.6,-723.4399999999998
14355869,03/02/2023,123.39,-600.0499999999998
14355869,04/02/2023,-515.6,-1115.6499999999999
14355869,12/02/2023,-19.96,-1135.61
14397662,31/01/2023,,363.51
14397662,04/02/2023,61.88,425.39
14397662,08/02/2023,1800.8,2226.19
14397662,08/02/2023,126.11,2352.2999999999997
14397662,08/02/2023,54.11,2406.41
14397662,08/02/2023,37.69,2444.1
14397662,11/02/2023,-74.51,2369.5899999999997
14421453,31/01/2023,,813.76
14421453,01/02/2023,150.38,964.14
14421453,04/02/2023,44.06,1008.2
14421453,04/02/2023,-183.25,824.95
14421453,06/02/2023,67.0,891.95
14421453,08/02/2023,35.51,927.46
14421453,11/02/2023,-102.02,825.44
14448009,31/01/2023,,958.46
14448009,01/02/2023,-102.39,856.07
14448009,01/02/2023,-107.97,748.1
14448009,02/02/2023,144.05,892.1500000000001
14448009,02/02/2023,122.38,1014.53
14448009,04/02/2023,-1367.4,-352.8700000000001
14448009,08/02/2023,-1779.2,-2132.07
14448009,09/02/2023,-139.36,-2271.4300000000003
14448009,09/02/2023,-1300.7,-3572.13
14448009,14/02/2023,78.98,-3493.15
14448009,14/02/2023,-14.98,-3508.13
14505806,31/01/2023,,689.25
14505806,01/02/2023,974.4,1663.65
14505806,08/02/2023,121.72,1785.37
14505806,09/02/2023,-102.41,1682.96
14505806,11/02/2023,130.43,1813.3899999999999
14505806,11/02/2023,38.37,1851.76
14505806,13/02/2023,-71.51,1780.25
14505806,14/02/2023,956.2,2736.45
14564252,31/01/2023,,263.39
14564252,02/02/2023,-133.0,130.39
14564252,14/02/2023,-158.38,-27.99000000000001
14592080,31/01/2023,,245.22
14592080,02/02/2023,149.36,394.58000000000004
14592080,02/02/2023,-70.88,323.70000000000005
14592080,02/02/2023,-113.73,209.97000000000003
14592080,04/02/2023,-213.8,-3.829999999999984
14592080,05/02/2023,99.57,95.74000000000001
14592080,06/02/2023,-93.76,1.980000000000004
14592080,07/02/2023,50.0,51.980000000000004
14594928,31/01/2023,,470.64
14594928,03/02/2023,-145.32,325.32
14594928,07/02/2023,123.7,449.02
14594928,10/02/2023,75.71,524.73
14594928,12/02/2023,-140.65,384.08
14600288,31/01/2023,,622.77
14600288,02/02/2023,43.55,666.3199999999999
14600288,02/02/2023,-140.31,526.01
14600288,02/02/2023,-147.71,378.29999999999995
14600288,03/02/2023,88.58,466.88
14600288,05/02/2023,110.92,577.8
14600288,08/02/2023,93.19,670.99
14600288,13/02/2023,-138.07,532.92
14600288,14/02/2023,83.11,616.03
14648004,31/01/2023,,236.67
14648004,01/02/2023,92.2,328.87
14648004,01/02/2023,-77.41,251.45999999999998
14648004,04/02/2023,100.53,351.99
14648004,04/02/2023,72.87,424.86
14648004,05/02/2023,-16.24,408.62
14648004,07/02/2023,114.81,523.4300000000001
14648004,07/02/2023,21.02,544.45
14648004,07/02/2023,-111.26,433.19
14648004,08/02/2023,-1330.7,-897.51
14648004,12/02/2023,-1808.9,-2706.41
14648004,13/02/2023,-113.24,-2819.65
14685853,31/01/2023,,45.2
14685853,01/02/2023,-142.37,-97.17
14685853,04/02/2023,109.08,11.909999999999997
14685853,06/02/2023,79.32,91.22999999999999
14685853,07/02/2023,26.93,118.16
14685853,11/02/2023,370.4,488.55999999999995
14723713,31/01/2023,,378.07
14723713,10/02/2023,67.56,445.63
14723713,10/02/2023,-113.36,332.27
14723713,11/02/2023,126.78,459.05
14723713,13/02/2023,149.91,608.96
14749214,31/01/2023,,194.54
14749214,03/02/2023,49.32,243.85999999999999
14749214,07/02/2023,-145.52,98.33999999999997
14749214,12/02/2023,207.81,306.15
14780986,31/01/2023,,180.2
14780986,01/02/2023,105.85,286.04999999999995
14780986,04/02/2023,164.38,450.42999999999995
14780986,06/02/2023,-965.2,-514.7700000000001
14780986,07/02/2023,132.81,-381.9600000000001
14780986,07/02/2023,-168.78,-550.7400000000001
14812157,31/01/2023,,534.54
14812157,01/02/2023,645.5,1180.04
14812157,04/02/2023,-134.48,1045.56
14812157,06/02/2023,-473.7,571.86
14812157,09/02/2023,-117.1,454.76
14812157,14/02/2023,-120.54,334.22
14840078,31/01/2023,,584.16
14840078,01/02/2023,-118.24,465.91999999999996
14840078,05/02/2023,62.37,528.29
14840078,06/02/2023,-188.27,340.02
14840078,07/02/2023,-87.19,252.82999999999996
14840078,09/02/2023,-102.32,150.50999999999996
14840078,10/02/2023,210.07,360.5799999999999
14840078,10/02/2023,-144.1,216.47999999999996
14840078,13/02/2023,-82.99,133.48999999999995
14840078,14/02/2023,75.98,209.46999999999997
14866733,31/01/2023,,249.35
14866733,01/02/2023,-77.78,171.57
14866733,02/02/2023,16.74,188.31
14866733,03/02/2023,68.61,256.91999999999996
14866733,07/02/2023,83.68,340.6
14866733,14/02/2023,-38.4,302.2
14866733,14/02/2023,-93.66,208.54
14897645,31/01/2023,,89.0
14897645,01/02/2023,113.69,202.69
14897645,09/02/2023,-69.51,133.18
14897645,11/02/2023,-51.73,81.44999999999999
14897645,12/02/2023,106.92,188.37
14897645,14/02/2023,143.79,332.15999999999997
14907946,31/01/2023,,845.72
14907946,03/02/2023,66.37,912.09
14907946,07/02/2023,-84.76,827.33
14907946,07/02/2023,-150.1,677.23
14907946,08/02/2023,129.86,807.09
14907946,10/02/2023,11.73,818.82
14907946,12/02/2023,115.04,933.86
14907946,14/02/2023,190.15,1124.01
14907946,14/02/2023,98.03,1222.04
14907946,14/02/2023,-67.7,1154.3400000000001
14907946,14/02/2023,-161.34,993.0
15033812,31/01/2023,,504.58
15044055,31/01/2023,,204.3
15044055,04/02/2023,93.78,298.08000000000004
15044055,06/02/2023,-78.94,219.14000000000001
15044055,09/02/2023,-1434.1,-1214.9599999999998
15044055,10/02/2023,-181.71,-1396.6699999999998
15044055,14/02/2023,161.91,-1234.7599999999998
15044055,14/02/2023,52.78,-1181.9799999999998
15052808,31/01/2023,,786.05
15052808,02/02/2023,936.1,1722.15
15052808,09/02/2023,953.9,2676.05
15052808,09/02/2023,127.23,2803.2799999999997
15052808,14/02/2023,-71.18,2732.1
15052808,14/02/2023,-1288.0,1444.1
15055504,31/01/2023,,339.94
15055504,05/02/2023,-170.82,169.12
15055504,07/02/2023,-106.77,62.35000000000001
15055504,08/02/2023,22.97,85.32000000000001
15055504,11/02/2023,-107.49,-22.169999999999987
15055504,11/02/2023,-126.14,-148.31
15077298,31/01/2023,,507.62
15077298,01/02/2023,-77.55,430.07
15077298,01/02/2023,-81.02,349.05
15077298,04/02/2023,75.48,424.53000000000003
15077298,04/02/2023,-150.76,273.77000000000004
15077298,07/02/2023,-46.51,227.26000000000005
15077298,09/02/2023,88.16,315.4200000000001
15077298,09/02/2023,-56.29,259.13000000000005
15077298,11/02/2023,124.08,383.21000000000004
15100785,31/01/2023,,934.1
15100785,02/02/2023,25.61,959.71
15100785,05/02/2023,54.49,1014.2
15100785,06/02/2023,-114.3,899.9000000000001
15100785,06/02/2023,-149.07,750.83
15100785,07/02/2023,166.29,917.12
15100785,09/02/2023,1038.5,1955.62
15100785,11/02/2023,-178.01,1777.61
15100785,12/02/2023,128.81,1906.4199999999998
15163829,31/01/2023,,458.6
15163829,04/02/2023,120.19,578.79
15163829,07/02/2023,-97.64,481.15000000000003
15163829,08/02/2023,-141.03,340.12
15163829,12/02/2023,-98.23,241.89
15163829,13/02/2023,43.56,285.45
15258886,31/01/2023,,689.34
15258886,01/02/2023,-124.86,564.48
15258886,05/02/2023,-155.76,408.72
15258886,08/02/2023,-103.03,305.69000000000005
15258886,08/02/2023,-134.18,171.51000000000002
15258886,10/02/2023,47.01,218.52
15258886,11/02/2023,1733.6,1952.12
15258886,12/02/2023,-135.05,1817.07
15258886,13/02/2023,-87.58,1729.4899999999998
15265650,31/01/2023,,147.72
15265650,01/02/2023,146.1,293.82
15265650,03/02/2023,-81.73,212.08999999999997
15265650,04/02/2023,-63.54,148.54999999999998
15265650,05/02/2023,-98.03,50.51999999999998
15265650,08/02/2023,-10.58,39.93999999999998
15265650,11/02/2023,-100.86,-60.920000000000016
15265650,11/02/2023,-105.66,-166.58
15265650,12/02/2023,64.01,-102.57000000000001
15265650,13/02/2023,-25.57,-128.14000000000001
15265650,14/02/2023,-118.21,-246.35
15265700,31/01/2023,,829.86
15265700,01/02/2023,19.88,849.74
15265700,02/02/2023,77.04,926.78
15265700,02/02/2023,-83.44,843.34
15265700,08/02/2023,-898.2,-54.860000000000014
15265700,12/02/2023,91.07,36.20999999999998
15290238,31/01/2023,,93.23
15290238,01/02/2023,83.96,177.19
15290238,04/02/2023,-59.13,118.06
15290238,09/02/2023,-119.77,-1.710000000000008
15290238,13/02/2023,-103.44,-105.15
15296624,31/01/2023,,731.68
15296624,01/02/2023,-58.05,673.63
15296624,01/02/2023,-80.86,592.77
15296624,06/02/2023,152.83,745.5999999999999
15296624,09/02/2023,104.33,849.93
15296624,09/02/2023,-141.82,708.1099999999999
15296624,14/02/2023,120.42,828.53
15324178,31/01/2023,,833.62
15324178,05/02/2023,91.78,925.4
15324178,07/02/2023,-82.91,842.49
15324178,08/02/2023,157.76,1000.25
15324178,09/02/2023,-898.1,102.14999999999998
15324178,13/02/2023,-96.04,6.109999999999971
15324178,13/02/2023,-134.6,-128.49
15334737,31/01/2023,,197.12
15334737,01/02/2023,115.14,312.26
15334737,01/02/2023,102.21,414.47
15334737,04/02/2023,91.69,506.15999999999997
15334737,04/02/2023,-91.7,414.46
15334737,06/02/2023,-176.53,237.93
15334737,07/02/2023,63.12,301.05
15334737,12/02/2023,86.27,387.32
15377274,31/01/2023,,902.14
15377274,04/02/2023,-124.14,778.0
15377274,07/02/2023,150.1,928.0999999999999
15377274,07/02/2023,-56.42,871.68
15377274,12/02/2023,102.73,974.41
15377274,14/02/2023,135.14,1109.55
15428008,31/01/2023,,131.02
15428008,07/02/2023,-199.86,-68.84
15428008,09/02/2023,-548.3,-617.14
15428008,12/02/2023,-1077.3,-1694.44
15428008,13/02/2023,-47.89,-1742.33
15428008,14/02/2023,-161.91,-1904.2399999999998
15468532,31/01/2023,,819.87
15468532,03/02/2023,-40.13,779.74
15468532,03/02/2023,-141.04,638.7
15468532,09/02/2023,132.75,771.45
15522788,31/01/2023,,154.26
15522788,01/02/2023,-101.62,52.639999999999986
15522788,02/02/2023,117.73,170.37
15522788,04/02/2023,109.65,280.02
15522788,04/02/2023,81.01,361.03
15522788,05/02/2023,-23.13,337.9
15522788,06/02/2023,-99.27,238.63
15522788,08/02/2023,66.05,304.68
15529292,31/01/2023,,382.95
15529292,01/02/2023,-117.6,265.35
15529292,06/02/2023,76.0,341.35
15529292,12/02/2023,154.74,496.09000000000003
15563919,31/01/2023,,492.34
15563919,01/02/2023,-90.71,401.63
15563919,02/02/2023,46.46,448.09
15563919,04/02/2023,174.55,622.64
15563919,05/02/2023,65.68,688.3199999999999
15563919,06/02/2023,178.82,867.14
15563919,10/02/2023,36.91,904.05
15563919,14/02/2023,1083.0,1987.05
15665459,31/01/2023,,68.94
15665459,02/02/2023,-74.71,-5.769999999999996
15665459,03/02/2023,534.6,528.83
15665459,05/02/2023,67.95,596.7800000000001
15665459,07/02/2023,161.73,758.51
15665459,13/02/2023,-66.23,692.2800000000001
15668160,31/01/2023,,810.02
15668160,05/02/2023,179.02,989.04
15668160,09/02/2023,-156.67,832.37
15668160,13/02/2023,201.95,1034.32
15732629,31/01/2023,,975.81
15732629,02/02/2023,191.44,1167.25
15732629,04/02/2023,-362.7,804.55
15732629,05/02/2023,78.82,883.3699999999999
15732629,08/02/2023,144.78,1028.1499999999999
15732629,08/02/2023,143.15,1171.3
15732629,12/02/2023,76.86,1248.1599999999999
15732629,13/02/2023,-1393.1,-144.94000000000005
15768459,31/01/2023,,997.4
15768459,02/02/2023,-154.06,843.3399999999999
15768459,03/02/2023,-44.0,799.3399999999999
15768459,08/02/2023,120.35,919.6899999999999
15768459,08/02/2023,118.54,1038.23
15768459,13/02/2023,139.76,1177.99
15768459,13/02/2023,-131.61,1046.3799999999999
15779976,31/01/2023,,129.01
15779976,03/02/2023,-120.76,8.249999999999986
15779976,12/02/2023,-127.27,-119.02000000000001
15779976,14/02/2023,-100.83,-219.85000000000002
15779976,14/02/2023,-128.39,-348.24
15793232,31/01/2023,,45.88
15793232,02/02/2023,-120.7,-74.82
15793232,05/02/2023,1580.8,1505.98
15793232,12/02/2023,57.42,1563.4
15793232,14/02/2023,20.41,1583.81
15796180,31/01/2023,,755.58
15796180,07/02/2023,-105.97,649.61
15796180,07/02/2023,-113.23,536.38
15796180,10/02/2023,114.59,650.97
15796180,12/02/2023,133.04,784.01
15801209,31/01/2023,,8.84
15801209,01/02/2023,-695.3,-686.4599999999999
15801209,05/02/2023,-45.42,-731.8799999999999
15801209,08/02/2023,126.03,-605.8499999999999
15801209,13/02/2023,134.72,-471.12999999999994
15801209,13/02/2023,46.32,-424.80999999999995
15801209,13/02/2023,-80.6,-505.40999999999997
15805500,31/01/2023,,230.39
15805500,02/02/2023,170.79,401.17999999999995
15805500,06/02/2023,-175.36,225.81999999999996
15805500,09/02/2023,-71.12,154.69999999999996
15810455,31/01/2023,,81.69
15810455,06/02/2023,110.66,192.35
15810455,08/02/2023,238.9,431.25
15810455,08/02/2023,100.19,531.44
15810455,11/02/2023,165.48,696.92
15810455,11/02/2023,112.23,809.15
15810455,12/02/2023,-145.1,664.05
15810455,13/02/2023,80.87,744.9200000000001
15826579,31/01/2023,,596.77
15826579,01/02/2023,-948.2,-351.43000000000006
15826579,09/02/2023,255.62,-95.81000000000006
15826579,10/02/2023,-1662.6,-1758.4099999999999
15826579,11/02/2023,1137.9,-620.5099999999998
15826579,13/02/2023,128.09,-492.41999999999973
15830962,31/01/2023,,570.89
15830962,03/02/2023,50.42,621.31
15830962,07/02/2023,65.97,687.28
15830962,10/02/2023,-97.09,590.1899999999999
15841031,31/01/2023,,579.98
15841031,05/02/2023,-61.09,518.89
15841031,08/02/2023,124.32,643.21
15841031,14/02/2023,133.19,776.4
15899774,31/01/2023,,773.38
15899774,06/02/2023,151.33,924.71
15899774,08/02/2023,1382.5,2307.21
15899774,09/02/2023,-64.55,2242.66
15914466,31/01/2023,,436.62
15914466,08/02/2023,157.06,593.6800000000001
15914466,09/02/2023,-109.67,484.01
15914466,09/02/2023,-1208.0,-723.99
15914466,11/02/2023,-125.01,-849.0
15918861,31/01/2023,,781.97
15918861,03/02/2023,122.97,904.94
15918861,04/02/2023,-22.38,882.5600000000001
15918861,09/02/2023,-103.16,779.4000000000001
15918861,14/02/2023,125.82,905.22
15922706,31/01/2023,,478.87
15922706,02/02/2023,150.2,629.0699999999999
15922706,04/02/2023,104.07,733.14
15922706,04/02/2023,-44.55,688.59
15922706,06/02/2023,77.22,765.81
15922706,06/02/2023,64.62,830.43
15922706,06/02/2023,-124.41,706.02
15922706,08/02/2023,80.77,786.79
15922706,09/02/2023,88.92,875.71
15922706,11/02/2023,1370.2,2245.91
15922706,14/02/2023,29.41,2275.32
15944303,31/01/2023,,977.44
15944303,05/02/2023,-108.31,869.1300000000001
15944303,06/02/2023,-100.18,768.95
15944303,09/02/2023,181.01,949.96
15944303,12/02/2023,1267.9,2217.86
15944303,13/02/2023,107.16,2325.02
15960008,31/01/2023,,455.42
15960008,07/02/2023,-132.81,322.61
15960008,10/02/2023,-43.52,279.09000000000003
15960008,13/02/2023,-47.03,232.06
15980710,31/01/2023,,955.7
15980710,03/02/2023,158.58,1114.28
15980710,04/02/2023,97.86,1212.14
15980710,11/02/2023,-58.0,1154.14
15980710,13/02/2023,134.36,1288.5
15980710,14/02/2023,79.89,1368.39
16013218,31/01/2023,,322.63
16013218,02/02/2023,83.89,406.52
16013218,06/02/2023,1436.4,1842.92
16013218,06/02/2023,-111.41,1731.51
16013218,10/02/2023,26.43,1757.94
16013218,10/02/2023,-77.1,1680.8400000000001
16013218,12/02/2023,115.11,1795.95
16013218,12/02/2023,-228.38,1567.5700000000002
16026987,31/01/2023,,772.57
16026987,02/02/2023,-96.85,675.72
16026987,03/02/2023,56.34,732.0600000000001
16026987,07/02/2023,101.07,833.1300000000001
16026987,08/02/2023,95.14,928.2700000000001
16026987,13/02/2023,1678.8,2607.07
16030234,31/01/2023,,174.55
16030234,01/02/2023,-92.81,81.74000000000001
16030234,01/02/2023,-189.32,-107.57999999999998
16030234,06/02/2023,-170.43,-278.01
16030234,08/02/2023,129.99,-148.01999999999998
16030234,09/02/2023,-97.62,-245.64
16030234,10/02/2023,-86.54,-332.18
16030234,12/02/2023,-80.58,-412.76
16063411,31/01/2023,,896.73
16063411,13/02/2023,-77.8,818.9300000000001
16063411,14/02/2023,128.86,947.79
16063411,14/02/2023,17.11,964.9
16067516,31/01/2023,,494.33
16067516,06/02/2023,-646.5,-152.17000000000002
16067516,08/02/2023,-1044.7,-1196.8700000000001
16067516,12/02/2023,168.73,-1028.14
16087504,31/01/2023,,56.65
16087504,01/02/2023,144.25,200.9
16087504,03/02/2023,147.01,347.90999999999997
16087504,12/02/2023,-895.2,-547.2900000000001
16087504,13/02/2023,18.85,-528.44
16087504,14/02/2023,-93.61,-622.0500000000001
16093178,31/01/2023,,96.62
16093178,02/02/2023,-136.28,-39.66
16093178,03/02/2023,114.47,74.81
16093178,05/02/2023,57.87,132.68
16093178,11/02/2023,87.08,219.76
16093178,11/02/2023,-159.21,60.54999999999998
16093178,13/02/2023,-118.36,-57.81000000000002
16118153,31/01/2023,,829.58
16118153,03/02/2023,173.01,1002.59
16118153,05/02/2023,-45.9,956.69
16118153,05/02/2023,-49.78,906.9100000000001
16118153,09/02/2023,125.98,1032.89
16118153,09/02/2023,113.36,1146.25
16118153,10/02/2023,-59.44,1086.81
16118153,13/02/2023,1827.6,2914.41
16124993,31/01/2023,,148.14
16124993,05/02/2023,25.75,173.89
16124993,06/02/2023,46.33,220.21999999999997
16124993,06/02/2023,-97.34,122.87999999999998
16124993,08/02/2023,1668.5,1791.3799999999999
16124993,08/02/2023,-167.59,1623.79
16124993,11/02/2023,245.04,1868.83
16124993,11/02/2023,124.32,1993.1499999999999
16124993,12/02/2023,-643.6,1349.5499999999997
16124993,14/02/2023,-104.78,1244.7699999999998
16124993,14/02/2023,-143.07,1101.6999999999998
16152779,31/01/2023,,65.09
16152779,01/02/2023,131.11,196.20000000000002
16152779,01/02/2023,96.26,292.46000000000004
16152779,02/02/2023,-135.95,156.51000000000005
16152779,04/02/2023,173.9,330.4100000000001
16152779,12/02/2023,-117.51,212.90000000000003
16157014,31/01/2023,,858.73
16157014,01/02/2023,99.09,957.82
16157014,03/02/2023,-76.11,881.71
16157014,08/02/2023,103.69,985.4
16157014,11/02/2023,58.0,1043.4
16157014,13/02/2023,-111.36,932.04
16181964,31/01/2023,,979.44
16181964,01/02/2023,-49.69,929.75
16181964,03/02/2023,-121.15,808.6
16181964,06/02/2023,59.73,868.33
16181964,07/02/2023,-80.36,787.97
16181964,13/02/2023,-763.2,24.769999999999982
16191280,31/01/2023,,825.86
16191280,02/02/2023,666.0,1491.8600000000001
16191280,03/02/2023,21.47,1513.33
16191280,07/02/2023,113.55,1626.88
16191280,08/02/2023,138.88,1765.76
16191280,09/02/2023,69.51,1835.27
16191280,10/02/2023,-121.81,1713.46
16191280,12/02/2023,86.65,1800.11
16191280,13/02/2023,-77.77,1722.34
16191280,14/02/2023,173.04,1895.38
16223952,31/01/2023,,222.18
16223952,03/02/2023,197.64,419.82
16223952,05/02/2023,1174.8,1594.62
16223952,08/02/2023,83.5,1678.12
16223952,09/02/2023,168.19,1846.31
16223952,11/02/2023,-94.59,1751.7199999999998
16229373,31/01/2023,,256.89
16229373,01/02/2023,-96.26,160.63
16229373,03/02/2023,-1131.6,-970.9699999999999
16229373,05/02/2023,161.01,-809.9599999999999
16229373,09/02/2023,127.53,-682.43
16229373,13/02/2023,83.84,-598.5899999999999
16229373,13/02/2023,-153.16,-751.7499999999999
16270746,31/01/2023,,904.31
16270746,01/02/2023,49.84,954.15
16270746,07/02/2023,227.16,1181.31
16270746,14/02/2023,110.13,1291.44
16306280,31/01/2023,,921.83
16306280,04/02/2023,139.51,1061.3400000000001
16306280,06/02/2023,136.49,1197.83
16306280,08/02/2023,70.15,1267.98
16306280,13/02/2023,79.84,1347.8200000000002
16306280,14/02/2023,143.03,1490.8500000000001
16312979,31/01/2023,,833.92
16312979,02/02/2023,-57.84,776.0799999999999
16312979,05/02/2023,47.51,823.5899999999999
16312979,06/02/2023,155.04,978.6299999999999
16312979,07/02/2023,-100.4,878.2299999999999
16312979,08/02/2023,2113.3,2991.53
16334793,31/01/2023,,297.75
16334793,02/02/2023,-126.12,171.63
16334793,08/02/2023,-77.8,93.83
16334793,09/02/2023,-88.92,4.909999999999997
16334793,11/02/2023,-1991.3,-1986.3899999999999
16334793,12/02/2023,-81.87,-2068.2599999999998
16453812,31/01/2023,,356.9
16453812,04/02/2023,63.26,420.15999999999997
16453812,09/02/2023,146.33,566.49
16453812,13/02/2023,-159.89,406.6
16453812,14/02/2023,-47.25,359.35
16506904,31/01/2023,,602.17
16506904,01/02/2023,-106.68,495.48999999999995
16506904,03/02/2023,125.04,620.53
16506904,06/02/2023,-22.66,597.87
16506904,07/02/2023,-134.11,463.75999999999993
16506904,09/02/2023,-164.72,299.03999999999996
16506904,12/02/2023,77.47,376.50999999999993
16506904,13/02/2023,-53.69,322.81999999999994
16506904,14/02/2023,-278.4,44.41999999999996
16584745,31/01/2023,,129.46
16584745,01/02/2023,-136.51,-7.049999999999983
16584745,04/02/2023,109.21,102.16000000000001
16584745,05/02/2023,-62.34,39.82000000000001
16584745,06/02/2023,-76.04,-36.22
16584745,09/02/2023,-912.8,-949.02
16584745,10/02/2023,55.02,-894.0
16584745,11/02/2023,-184.5,-1078.5
16584745,12/02/2023,170.0,-908.5
16584745,13/02/2023,-111.37,-1019.87
16628269,31/01/2023,,27.11
16628269,04/02/2023,155.79,182.89999999999998
16628269,04/02/2023,-53.03,129.87
16628269,05/02/2023,88.27,218.14
16628269,05/02/2023,55.52,273.66
16628269,11/02/2023,-79.06,194.6
16628269,12/02/2023,151.34,345.94
16628269,13/02/2023,41.75,387.69
16633794,31/01/2023,,263.05
16633794,02/02/2023,75.84,338.89
16633794,08/02/2023,113.42,452.31
16633794,09/02/2023,89.39,541.7
16633794,10/02/2023,86.39,628.09
16633794,13/02/2023,61.69,689.78
16676577,31/01/2023,,407.24
16676577,01/02/2023,77.41,484.65
16676577,04/02/2023,-77.7,406.95
16676577,06/02/2023,-1436.4,-1029.45
16676577,09/02/2023,-105.57,-1135.02
16676577,10/02/2023,-103.59,-1238.6100000000001
16927652,31/01/2023,,637.58
16927652,01/02/2023,-14.22,623.36
16927652,04/02/2023,153.96,777.32
16927652,05/02/2023,122.62,899.94
16977372,31/01/2023,,675.5
16977372,01/02/2023,-181.11,494.39
16977372,08/02/2023,195.9,690.29
16977372,10/02/2023,-89.47,600.8199999999999
16977372,14/02/2023,302.9,903.72
16984772,31/01/2023,,823.43
16984772,02/02/2023,1351.2,2174.63
16984772,05/02/2023,-76.23,2098.4
16984772,05/02/2023,-113.3,1985.1
16984772,05/02/2023,-179.34,1805.7599999999998
16984772,07/02/2023,151.91,1957.6699999999998
16984772,07/02/2023,62.17,2019.84
16984772,07/02/2023,-93.07,1926.77
16984772,08/02/2023,-209.9,1716.87
16984772,10/02/2023,-93.29,1623.58
17024652,31/01/2023,,918.84
17024652,02/02/2023,101.39,1020.23
17024652,07/02/2023,11.35,1031.58
17024652,09/02/2023,1558.7,2590.2799999999997
17024652,13/02/2023,30.37,2620.65
17039422,31/01/2023,,941.44
17039422,02/02/2023,124.23,1065.67
17039422,03/02/2023,-199.09,866.58
17039422,03/02/2023,-208.56,658.02
17039422,06/02/2023,-1053.5,-395.48
17051223,31/01/2023,,558.16
17051223,08/02/2023,125.79,683.9499999999999
17051223,08/02/2023,-61.41,622.54
17085651,31/01/2023,,945.51
17085651,05/02/2023,119.48,1064.99
17085651,08/02/2023,-81.34,983.65
17085651,11/02/2023,-1168.2,-184.55000000000007
17085651,11/02/2023,-1635.6,-1820.15
17085651,12/02/2023,-159.82,-1979.97
17085651,14/02/2023,-1583.4,-3563.37
17138963,31/01/2023,,131.95
17138963,01/02/2023,-1500.7,-1368.75
17138963,05/02/2023,110.72,-1258.03
17138963,06/02/2023,58.79,-1199.24
17138963,08/02/2023,-35.48,-1234.72
17138963,14/02/2023,63.85,-1170.87
17144855,31/01/2023,,355.14
17144855,01/02/2023,182.36,537.5
17144855,01/02/2023,112.98,650.48
17144855,02/02/2023,-51.28,599.2
17144855,02/02/2023,-96.07,503.13
17144855,03/02/2023,51.41,554.54
17144855,04/02/2023,129.7,684.24
17144855,06/02/2023,-104.58,579.66
17144855,09/02/2023,-140.26,439.40000000000003
17144855,13/02/2023,-59.04,380.36
17144855,13/02/2023,-165.67,214.69000000000005
17191420,31/01/2023,,717.28
17191420,01/02/2023,130.78,848.06
17191420,02/02/2023,-98.15,749.91
17191420,14/02/2023,118.21,868.12
17228160,31/01/2023,,567.87
17228160,01/02/2023,-105.61,462.26
17228160,01/02/2023,-780.9,-318.64
17228160,02/02/2023,1556.9,1238.2600000000002
17228160,02/02/2023,-54.57,1183.6900000000003
17228160,05/02/2023,179.42,1363.1100000000001
17228160,05/02/2023,123.79,1486.9000000000003
17228160,08/02/2023,-35.2,1451.7000000000003
17228160,10/02/2023,-190.65,1261.0500000000002
17228160,11/02/2023,-200.58,1060.4700000000003
17264146,31/01/2023,,345.33
17264146,07/02/2023,171.45,516.78
17264146,10/02/2023,-38.88,477.9
17264146,11/02/2023,-151.65,326.25
17264146,12/02/2023,-76.94,249.30999999999997
17264146,14/02/2023,58.68,307.98999999999995
17264146,14/02/2023,-163.39,144.6
17284705,31/01/2023,,145.59
17284705,01/02/2023,-81.56,64.03
17284705,03/02/2023,-138.68,-74.65
17284705,04/02/2023,-66.05,-140.7
17284705,10/02/2023,-47.4,-188.1
17284705,11/02/2023,157.96,-30.139999999999986
17284705,11/02/2023,62.52,32.38000000000002
17284705,13/02/2023,12.26,44.640000000000015
17301178,31/01/2023,,311.47
17301178,02/02/2023,-120.32,191.15000000000003
17301178,03/02/2023,152.95,344.1
17301178,07/02/2023,106.77,450.87
17301178,07/02/2023,-1147.4,-696.5300000000001
17301178,08/02/2023,55.71,-640.82
17301178,10/02/2023,-24.85,-665.6700000000001
17301178,13/02/2023,-127.43,-793.1000000000001
17434670,31/01/2023,,148.92
17434670,04/02/2023,-99.5,49.41999999999999
17434670,05/02/2023,44.51,93.92999999999998
17434670,07/02/2023,169.25,263.17999999999995
17434670,07/02/2023,80.47,343.65
17434670,07/02/2023,-48.65,295.0
17434670,10/02/2023,-705.9,-410.9
17434670,10/02/2023,-737.2,-1148.1
17434670,11/02/2023,215.83,-932.27
17434670,12/02/2023,139.56,-792.71
17434670,12/02/2023,43.72,-748.99
17434670,14/02/2023,106.21,-642.78
17469776,31/01/2023,,443.18
17469776,05/02/2023,89.23,532.41
17469776,05/02/2023,-94.95,437.46000000000004
17469776,07/02/2023,60.73,498.19
17469776,08/02/2023,-61.39,436.8
17469776,12/02/2023,76.6,513.4
17483941,31/01/2023,,483.81
17483941,01/02/2023,48.78,532.59
17483941,01/02/2023,-110.45,422.14
17483941,01/02/2023,-164.06,258.08
17483941,02/02/2023,102.4,360.48
17483941,03/02/2023,120.86,481.34
17483941,03/02/2023,76.66,558.0
17483941,05/02/2023,-161.01,396.99
17483941,08/02/2023,145.66,542.65
17483941,11/02/2023,9.21,551.86
17533114,31/01/2023,,274.53
17533114,05/02/2023,-94.53,179.99999999999997
17533114,07/02/2023,-35.98,144.01999999999998
17533114,08/02/2023,105.32,249.33999999999997
17533114,13/02/2023,-123.27,126.06999999999998
17533114,14/02/2023,-133.43,-7.360000000000028
17534364,31/01/2023,,758.41
17534364,05/02/2023,-120.48,637.93
17534364,08/02/2023,42.56,680.49
17534364,10/02/2023,-153.84,526.65
17534364,11/02/2023,102.43,629.0799999999999
17534364,14/02/2023,-59.8,569.28
17543122,31/01/2023,,681.64
17543122,04/02/2023,-48.4,633.24
17543122,05/02/2023,-37.98,595.26
17543122,05/02/2023,-135.04,460.22
17543122,05/02/2023,-193.92,266.3
17543122,06/02/2023,-19.45,246.85000000000002
17543122,08/02/2023,118.77,365.62
17543122,10/02/2023,-149.61,216.01
17543122,13/02/2023,183.79,399.79999999999995
17644586,31/01/2023,,222.45
17644586,01/02/2023,92.85,315.29999999999995
17644586,01/02/2023,-148.34,166.95999999999998
17644586,02/02/2023,-122.21,44.749999999999986
17644586,03/02/2023,146.39,191.14
17644586,04/02/2023,109.76,300.9
17644586,09/02/2023,50.02,350.92
17644586,11/02/2023,125.33,476.25
17644586,13/02/2023,110.34,586.59
17648252,31/01/2023,,75.02
17648252,01/02/2023,646.2,721.22
17648252,01/02/2023,-570.3,150.92000000000007
17648252,05/02/2023,124.83,275.75000000000006
17648252,05/02/2023,-18.13,257.62000000000006
17648252,06/02/2023,95.31,352.93000000000006
17648252,06/02/2023,-84.46,268.4700000000001
17648252,13/02/2023,132.3,400.7700000000001
17648252,14/02/2023,553.6,954.3700000000001
17669623,31/01/2023,,163.19
17669623,05/02/2023,142.97,306.15999999999997
17669623,07/02/2023,171.17,477.33
17669623,09/02/2023,-125.94,351.39
17669623,14/02/2023,106.34,457.73
17669623,14/02/2023,-64.22,393.51
17692892,31/01/2023,,457.79
17692892,03/02/2023,22.26,480.05
17692892,03/02/2023,-88.94,391.11
17692892,06/02/2023,-45.55,345.56000000000006
17692892,09/02/2023,174.92,520.48
17722231,31/01/2023,,944.22
17722231,01/02/2023,-67.01,877.21
17722231,02/02/2023,22.39,899.6
17722231,06/02/2023,-462.2,437.40000000000003
17722231,09/02/2023,105.04,542.44
17749893,31/01/2023,,889.45
17749893,01/02/2023,176.41,1065.8600000000001
17749893,01/02/2023,-143.83,922.03
17749893,07/02/2023,-211.2,710.83
17749893,12/02/2023,-28.42,682.4100000000001
17749893,12/02/2023,-1267.9,-585.49
17749893,13/02/2023,90.8,-494.69
17749893,13/02/2023,-88.79,-583.48
17810734,31/01/2023,,348.22
17810734,09/02/2023,-138.8,209.42000000000002
17840180,31/01/2023,,557.56
17840180,01/02/2023,0.96,558.52
17840180,04/02/2023,124.14,682.66
17840180,14/02/2023,-81.15,601.51
17868317,31/01/2023,,706.58
17868317,01/02/2023,-172.78,533.8000000000001
17868317,07/02/2023,-52.36,481.44000000000005
17868317,09/02/2023,72.19,553.63
17868317,13/02/2023,124.33,677.96
17868317,14/02/2023,110.14,788.1
17881363,31/01/2023,,415.27
17881363,02/02/2023,-46.77,368.5
17881363,03/02/2023,-64.03,304.46999999999997
17881363,04/02/2023,22.38,326.84999999999997
17881363,05/02/2023,125.17,452.02
17881363,13/02/2023,-817.7,-365.68000000000006
17925406,31/01/2023,,393.37
17925406,02/02/2023,160.62,553.99
17925406,03/02/2023,-51.41,502.58000000000004
17925406,06/02/2023,109.52,612.1
17925406,06/02/2023,-81.99,530.11
17925406,08/02/2023,87.59,617.7
17925406,10/02/2023,-74.72,542.98
17925406,13/02/2023,112.38,655.36
17925406,14/02/2023,116.9,772.26
17933377,31/01/2023,,189.05
17933377,02/02/2023,95.27,284.32
17933377,07/02/2023,145.52,429.84000000000003
17933377,07/02/2023,24.33,454.17
17933377,08/02/2023,-109.29,344.88
17938672,31/01/2023,,904.99
17938672,01/02/2023,102.95,1007.94
17938672,02/02/2023,-93.88,914.0600000000001
17938672,07/02/2023,-46.29,867.77
17938672,08/02/2023,39.85,907.62
17938672,11/02/2023,129.67,1037.29
17938672,11/02/2023,77.84,1115.13
17939571,31/01/2023,,396.93
17939571,02/02/2023,68.63,465.56
17939571,07/02/2023,149.48,615.04
17939571,07/02/2023,108.09,723.13
17939571,07/02/2023,-53.14,669.99
17939571,09/02/2023,-43.87,626.12
17939571,12/02/2023,78.98,705.1
17939571,12/02/2023,77.02,782.12
17939571,12/02/2023,50.65,832.77
17983851,31/01/2023,,849.24
17983851,01/02/2023,160.4,1009.64
17983851,02/02/2023,794.9,1804.54
17983851,02/02/2023,200.43,2004.97
17983851,04/02/2023,-26.48,1978.49
17983851,06/02/2023,-154.69,1823.8
17983851,07/02/2023,99.73,1923.53
17983851,09/02/2023,-67.11,1856.42
17983851,12/02/2023,89.62,1946.04
17983851,12/02/2023,37.05,1983.09
17983851,12/02/2023,-76.82,1906.27
18046225,31/01/2023,,205.83
18046225,03/02/2023,-96.51,109.32000000000001
18046225,07/02/2023,151.4,260.72
18046225,10/02/2023,63.32,324.04
18052851,31/01/2023,,672.09
18052851,02/02/2023,-177.51,494.58000000000004
18052851,08/02/2023,-115.63,378.95000000000005
18052851,13/02/2023,48.19,427.14000000000004
18052851,14/02/2023,159.03,586.1700000000001
18095448,31/01/2023,,73.28
18095448,03/02/2023,159.69,232.97
18095448,03/02/2023,-164.36,68.60999999999999
18095448,05/02/2023,92.4,161.01
18095448,12/02/2023,797.7,958.71
18095448,12/02/2023,16.68,975.39
18133554,31/01/2023,,733.1
18133554,02/02/2023,-114.29,618.8100000000001
18133554,03/02/2023,-168.82,449.99
18133554,06/02/2023,676.7,1126.69
18133554,06/02/2023,100.05,1226.74
18133554,07/02/2023,1277.4,2504.1400000000003
18133554,07/02/2023,207.86,2712.0
18133554,07/02/2023,109.2,2821.2000000000003
18133554,09/02/2023,176.85,2998.05
18133554,09/02/2023,118.62,3116.67
18133554,10/02/2023,-75.3,3041.3700000000003
18133554,11/02/2023,1104.0,4145.37
18133554,11/02/2023,107.81,4253.18
18133554,14/02/2023,-18.54,4234.64
18179400,31/01/2023,,768.78
18179400,03/02/2023,18.62,787.4
18179400,06/02/2023,-131.6,655.8
18179400,08/02/2023,-197.96,457.84
18179400,11/02/2023,560.2,1018.04
18185362,31/01/2023,,609.36
18185362,02/02/2023,-117.9,491.46000000000004
18185362,04/02/2023,124.08,615.54
18185362,11/02/2023,-10.99,604.55
18185362,12/02/2023,-1955.6,-1351.05
18185362,14/02/2023,91.78,-1259.27
18198770,31/01/2023,,108.23
18198770,02/02/2023,76.14,184.37
18198770,04/02/2023,146.89,331.26
18198770,14/02/2023,-44.96,286.3
18305932,31/01/2023,,834.42
18305932,08/02/2023,-129.7,704.72
18305932,11/02/2023,-120.95,583.77
18305932,14/02/2023,79.12,662.89
18305932,14/02/2023,-18.23,644.66
18308848,31/01/2023,,570.65
18308848,07/02/2023,147.36,718.01
18308848,14/02/2023,-27.68,690.33
18346988,31/01/2023,,450.36
18346988,02/02/2023,-131.15,319.21000000000004
18346988,03/02/2023,-36.94,282.27
18346988,04/02/2023,-436.5,-154.23000000000002
18346988,07/02/2023,-856.5,-1010.73
18346988,14/02/2023,-73.19,-1083.92
18348734,31/01/2023,,579.93
18348734,01/02/2023,-147.58,432.3499999999999
18348734,02/02/2023,-950.2,-517.8500000000001
18348734,06/02/2023,-111.94,-629.7900000000002
18348734,06/02/2023,-152.83,-782.6200000000001
18348734,07/02/2023,-211.77,-994.3900000000001
18348734,08/02/2023,-56.83,-1051.2200000000003
18348734,08/02/2023,-68.73,-1119.9500000000003
18348734,08/02/2023,-1032.4,-2152.3500000000004
18348734,09/02/2023,1045.1,-1107.2500000000005
18348734,09/02/2023,-76.46,-1183.7100000000005
18348734,11/02/2023,148.74,-1034.9700000000005
18348734,11/02/2023,-1669.7,-2704.6700000000005
18348734,13/02/2023,-98.15,-2802.8200000000006
18348734,14/02/2023,2010.0,-792.8200000000006
18447548,31/01/2023,,574.24
18447548,01/02/2023,99.41,673.65
18447548,08/02/2023,-180.39,493.26
18447548,10/02/2023,133.0,626.26
18447548,10/02/2023,-88.61,537.65
18447548,12/02/2023,44.09,581.74
18447548,13/02/2023,75.56,657.3000000000001
18447548,13/02/2023,-104.27,553.03
18447548,13/02/2023,-1370.8,-817.77
18447548,14/02/2023,-101.91,-919.68
18451683,31/01/2023,,501.75
18451683,03/02/2023,157.43,659.1800000000001
18451683,03/02/2023,102.01,761.19
18451683,05/02/2023,112.34,873.53
18451683,05/02/2023,-103.38,770.15
18451683,06/02/2023,-56.08,714.07
18451683,06/02/2023,-159.49,554.58
18451683,10/02/2023,143.3,697.88
18451683,11/02/2023,-65.22,632.6600000000001
18451683,12/02/2023,-985.9,-353.24
18451683,13/02/2023,62.08,-291.16
18517970,31/01/2023,,709.95
18517970,02/02/2023,142.95,852.9000000000001
18517970,03/02/2023,-510.1,342.8
18517970,04/02/2023,127.73,470.53000000000003
18517970,08/02/2023,-31.2,439.33000000000004
18517970,09/02/2023,54.57,493.90000000000003
18517970,10/02/2023,95.98,589.88
18517970,12/02/2023,-92.12,497.76
18517970,14/02/2023,-91.78,405.98
18563743,31/01/2023,,649.46
18563743,04/02/2023,34.82,684.2800000000001
18563743,07/02/2023,-124.7,559.58
18563743,09/02/2023,-36.49,523.09
18563743,11/02/2023,137.26,660.35
18563743,12/02/2023,-58.63,601.72
18563743,12/02/2023,-102.95,498.77
18582171,31/01/2023,,732.99
18582171,03/02/2023,-109.86,623.13
18582171,05/02/2023,122.01,745.14
18582171,06/02/2023,105.34,850.48
18582171,09/02/2023,136.48,986.96
18582171,11/02/2023,72.82,1059.78
18582171,11/02/2023,-147.31,912.47
18582171,13/02/2023,123.86,1036.33
18582171,14/02/2023,45.9,1082.23
18582171,14/02/2023,-85.38,996.85
18584434,31/01/2023,,877.81
18584434,02/02/2023,-103.88,773.93
18584434,03/02/2023,-94.83,679.0999999999999
18584434,05/02/2023,78.62,757.7199999999999
18584434,05/02/2023,-122.62,635.0999999999999
18584434,08/02/2023,-96.34,538.76
18645136,31/01/2023,,554.87
18645136,01/02/2023,120.09,674.96
18645136,03/02/2023,111.0,785.96
18645136,04/02/2023,199.43,985.39
18645136,05/02/2023,-2.25,983.14
18645136,13/02/2023,61.15,1044.29
18645136,14/02/2023,-116.52,927.77
18685463,31/01/2023,,476.02
18685463,09/02/2023,-37.65,438.37
18685463,10/02/2023,73.39,511.76
18685463,14/02/2023,118.69,630.45
18685463,14/02/2023,80.0,710.45
18718399,31/01/2023,,716.22
18718399,04/02/2023,119.96,836.1800000000001
18718399,06/02/2023,374.5,1210.68
18718399,10/02/2023,1800.7,3011.38
18850031,31/01/2023,,191.3
18850031,03/02/2023,100.99,292.29
18850031,05/02/2023,181.42,473.71
18850031,05/02/2023,120.48,594.1899999999999
18850031,07/02/2023,-171.4,422.78999999999996
18850031,11/02/2023,172.5,595.29
18850031,11/02/2023,-34.52,560.77
18850031,13/02/2023,105.74,666.51
18859451,31/01/2023,,441.04
18859451,02/02/2023,-469.3,-28.25999999999999
18859451,06/02/2023,110.47,82.21000000000001
18859451,06/02/2023,-102.2,-19.989999999999995
18859451,13/02/2023,46.16,26.17
18859451,14/02/2023,92.17,118.34
18899132,31/01/2023,,244.46
18899132,05/02/2023,-69.58,174.88
18899132,06/02/2023,97.34,272.22
18899132,08/02/2023,-63.18,209.04000000000002
18928638,31/01/2023,,150.95
18928638,02/02/2023,-162.41,-11.460000000000008
18928638,02/02/2023,-192.77,-204.23000000000002
18928638,10/02/2023,-184.75,-388.98
19001745,31/01/2023,,507.55
19001745,03/02/2023,76.42,583.97
19001745,04/02/2023,55.54,639.51
19001745,10/02/2023,344.3,983.81
19001745,10/02/2023,99.66,1083.47
19001745,11/02/2023,-173.15,910.3199999999999
19001745,13/02/2023,-82.89,827.43
19001745,14/02/2023,102.06,929.49
19001745,14/02/2023,-181.24,748.25
19094015,31/01/2023,,548.65
19094015,01/02/2023,74.43,623.0799999999999
19094015,02/02/2023,-224.1,398.98
19094015,06/02/2023,-186.65,212.32999999999998
19094015,06/02/2023,-1695.0,-1482.67
19094015,12/02/2023,1761.1,278.42999999999984
19094015,13/02/2023,-767.3,-488.8700000000001
19154395,31/01/2023,,274.06
19154395,01/02/2023,456.2,730.26
19154395,01/02/2023,173.96,904.22
19154395,05/02/2023,185.3,1089.52
19154395,05/02/2023,-25.75,1063.77
19154395,06/02/2023,-23.13,1040.64
19160862,31/01/2023,,211.53
19160862,02/02/2023,-110.38,101.15
19160862,11/02/2023,-137.25,-36.099999999999994
19201987,31/01/2023,,624.55
19201987,04/02/2023,-54.37,570.18
19201987,04/02/2023,-107.38,462.79999999999995
19201987,06/02/2023,-140.78,322.02
19201987,09/02/2023,80.63,402.65
19201987,11/02/2023,-62.24,340.40999999999997
19216744,31/01/2023,,123.53
19216744,03/02/2023,79.86,203.39
19220216,31/01/2023,,628.89
19220216,04/02/2023,50.19,679.0799999999999
19220216,04/02/2023,-148.35,530.73
19220216,05/02/2023,108.31,639.04
19220216,05/02/2023,-71.33,567.71
19220216,06/02/2023,833.9,1401.6100000000001
19220216,06/02/2023,-162.13,1239.48
19220216,11/02/2023,-102.26,1137.22
19220216,12/02/2023,51.02,1188.24
19220216,13/02/2023,187.8,1376.04
19220216,14/02/2023,-190.15,1185.89
19242274,31/01/2023,,65.28
19242274,01/02/2023,116.71,181.99
19242274,01/02/2023,-107.29,74.69999999999999
19242274,08/02/2023,-94.16,-19.460000000000008
19242274,09/02/2023,-32.83,-52.290000000000006
19242274,10/02/2023,1324.9,1272.6100000000001
19242274,10/02/2023,-98.85,1173.7600000000002
19283264,31/01/2023,,301.31
19283264,07/02/2023,-85.44,215.87
19283264,07/02/2023,-126.94,88.93
19283264,10/02/2023,103.62,192.55
19283264,10/02/2023,-96.34,96.21000000000001
19283264,12/02/2023,39.42,135.63
19315124,31/01/2023,,447.16
19315124,11/02/2023,64.7,511.86
19315124,11/02/2023,-93.58,418.28000000000003
19315124,14/02/2023,634.0,1052.28
19315124,14/02/2023,-90.11,962.17
19317267,31/01/2023,,51.87
19317267,03/02/2023,-113.25,-61.38
19317267,14/02/2023,1191.7,1130.32
19317267,14/02/2023,33.66,1163.98
19317267,14/02/2023,-198.2,965.78
19334563,31/01/2023,,525.45
19334563,01/02/2023,-774.6,-249.14999999999998
19334563,08/02/2023,130.38,-118.76999999999998
19334563,12/02/2023,41.59,-77.17999999999998
19334563,13/02/2023,-107.17,-184.34999999999997
19334563,14/02/2023,1773.6,1589.25
19387921,31/01/2023,,927.28
19387921,01/02/2023,-86.97,840.31
19387921,02/02/2023,124.34,964.65
19387921,06/02/2023,144.74,1109.3899999999999
19387921,11/02/2023,-58.94,1050.45
19387921,14/02/2023,162.9,1213.35
19387921,14/02/2023,70.52,1283.87
19387921,14/02/2023,-125.82,1158.05
19429964,31/01/2023,,694.43
19429964,04/02/2023,220.77,915.1999999999999
19429964,05/02/2023,200.2,1115.3999999999999
19429964,08/02/2023,-58.6,1056.8
19429964,13/02/2023,202.54,1259.34
19429964,14/02/2023,97.35,1356.69
19432211,31/01/2023,,24.19
19432211,02/02/2023,114.87,139.06
19432211,02/02/2023,-124.78,14.280000000000001
19432211,07/02/2023,-107.2,-92.92
19432211,08/02/2023,76.6,-16.320000000000007
19524427,31/01/2023,,579.16
19524427,03/02/2023,-772.8,-193.64
19524427,06/02/2023,151.44,-42.19999999999999
19524427,09/02/2023,287.8,245.60000000000002
19524427,13/02/2023,148.89,394.49
19530097,31/01/2023,,960.21
19530097,05/02/2023,44.78,1004.99
19530097,06/02/2023,105.81,1110.8
19530097,10/02/2023,79.86,1190.66
19530097,10/02/2023,-100.23,1090.43
19530097,13/02/2023,151.84,1242.27
19559937,31/01/2023,,727.4
19559937,01/02/2023,1500.7,2228.1
19559937,01/02/2023,-86.72,2141.38
19559937,05/02/2023,-114.03,2027.3500000000001
19559937,09/02/2023,-50.41,1976.94
19559937,10/02/2023,64.28,2041.2200000000003
19559937,10/02/2023,-88.53,1952.69
19559937,11/02/2023,-157.4,1795.2900000000002
19559937,12/02/2023,1025.1,2820.3900000000003
19574610,31/01/2023,,104.29
19574610,02/02/2023,91.54,195.83
19574610,04/02/2023,186.59,382.42
19574610,04/02/2023,-133.61,248.81
19574610,05/02/2023,815.7,1064.51
19574610,07/02/2023,-186.15,878.36
19574610,10/02/2023,-28.58,849.78
19574610,11/02/2023,-182.68,667.0999999999999
19574610,13/02/2023,68.69,735.79
19574610,13/02/2023,-62.72,673.0699999999999
19574610,14/02/2023,-77.33,595.74
19647966,31/01/2023,,849.89
19647966,05/02/2023,176.88,1026.77
19647966,08/02/2023,128.8,1155.57
19647966,10/02/2023,106.72,1262.29
19647966,12/02/2023,164.29,1426.58
19647966,14/02/2023,83.33,1509.91
19647966,14/02/2023,-94.55,1415.36
19686460,31/01/2023,,416.7
19686460,01/02/2023,818.4,1235.1
19686460,07/02/2023,115.39,1350.49
19686460,08/02/2023,1379.8,2730.29
19686460,11/02/2023,754.3,3484.59
19686460,14/02/2023,-72.93,3411.66
19705767,31/01/2023,,997.48
19705767,04/02/2023,-134.22,863.26
19705767,08/02/2023,-136.38,726.88
19705767,10/02/2023,101.58,828.46
19705767,11/02/2023,132.19,960.6500000000001
19705767,13/02/2023,46.08,1006.73
19705767,14/02/2023,-7.09,999.64
19789505,31/01/2023,,893.9
19789505,01/02/2023,1041.9,1935.8000000000002
19789505,04/02/2023,44.55,1980.3500000000001
19789505,08/02/2023,118.76,2099.11
19789505,08/02/2023,-14.65,2084.46
19789505,10/02/2023,40.02,2124.48
19789505,11/02/2023,117.67,2242.15
19789505,13/02/2023,-1665.4,576.75
19836996,31/01/2023,,245.14
19836996,02/02/2023,114.29,359.43
19836996,04/02/2023,165.75,525.1800000000001
19836996,06/02/2023,-104.32,420.86
19836996,07/02/2023,-65.16,355.70000000000005
19836996,07/02/2023,-1159.5,-803.8
19876635,31/01/2023,,883.25
19876635,01/02/2023,-81.16,802.09
19876635,01/02/2023,-101.28,700.81
19876635,02/02/2023,-236.79,464.02
19876635,03/02/2023,128.62,592.64
19876635,03/02/2023,-135.59,457.05
19876635,10/02/2023,-128.06,328.99
19876635,11/02/2023,147.81,476.8
19876635,14/02/2023,-135.7,341.1
19920990,31/01/2023,,70.95
19920990,03/02/2023,-145.14,-74.18999999999998
19920990,07/02/2023,-1370.6,-1444.79
19920990,08/02/2023,-90.7,-1535.49
19920990,09/02/2023,53.56,-1481.93
19920990,13/02/2023,871.5,-610.43
19920990,14/02/2023,38.18,-572.25
19931073,31/01/2023,,404.96
19931073,13/02/2023,40.02,444.97999999999996
19956941,31/01/2023,,723.33
19956941,03/02/2023,1121.6,1844.9299999999998
19956941,05/02/2023,-173.68,1671.2499999999998
19956941,08/02/2023,1010.6,2681.85
19956941,08/02/2023,-133.65,2548.2
19956941,09/02/2023,-69.39,2478.81
19956941,14/02/2023,-69.01,2409.7999999999997
19980716,31/01/2023,,432.98
19980716,02/02/2023,1774.7,2207.6800000000003
19980716,02/02/2023,-114.87,2092.81
19980716,03/02/2023,-159.69,1933.1200000000001
19980716,07/02/2023,20.07,1953.19
19980716,09/02/2023,125.68,2078.87
19980716,09/02/2023,114.01,2192.88
19980716,10/02/2023,-682.2,1510.68
19980716,11/02/2023,75.65,1586.3300000000002
20015298,31/01/2023,,953.82
20015298,01/02/2023,158.51,1112.33
20015298,08/02/2023,42.88,1155.21
20015298,08/02/2023,-128.42,1026.79
20015298,11/02/2023,-590.6,436.19000000000005
20015298,13/02/2023,-50.67,385.52000000000004
20067958,31/01/2023,,38.05
20067958,07/02/2023,122.02,160.07
20067958,07/02/2023,85.23,245.3
20067958,08/02/2023,974.3,1219.6
20067958,11/02/2023,102.26,1321.86
20067958,12/02/2023,94.36,1416.2199999999998
20090784,31/01/2023,,482.62
20090784,03/02/2023,12.53,495.15
20090784,04/02/2023,1263.9,1759.0500000000002
20090784,09/02/2023,85.8,1844.8500000000001
20090784,10/02/2023,-8.29,1836.5600000000002
20090784,13/02/2023,710.9,2547.46
20117480,31/01/2023,,70.97
20117480,01/02/2023,-86.68,-15.710000000000008
20117480,06/02/2023,186.65,170.94
20117480,07/02/2023,188.36,359.3
20117480,08/02/2023,-154.2,205.10000000000002
20117480,11/02/2023,75.16,280.26
20129535,31/01/2023,,446.41
20129535,01/02/2023,143.85,590.26
20129535,05/02/2023,172.62,762.88
20129535,06/02/2023,45.01,807.89
20129535,07/02/2023,6.03,813.9200000000001
20129535,10/02/2023,-99.74,714.1800000000001
20129535,11/02/2023,-30.14,684.04
20129535,13/02/2023,113.24,797.28
20176338,31/01/2023,,289.57
20176338,01/02/2023,-100.02,189.55
20176338,04/02/2023,-186.95,2.6000000000000227
20176338,05/02/2023,108.33,110.93000000000002
20176338,05/02/2023,62.88,173.81000000000003
20176338,08/02/2023,96.42,270.23
20176338,09/02/2023,188.14,458.37
20176338,10/02/2023,-121.7,336.67
20242626,31/01/2023,,701.08
20242626,03/02/2023,85.48,786.5600000000001
20242626,09/02/2023,82.05,868.61
20248053,31/01/2023,,565.28
20248053,02/02/2023,-77.43,487.84999999999997
20248053,03/02/2023,127.48,615.3299999999999
20248053,04/02/2023,110.05,725.38
20248053,11/02/2023,-179.27,546.1099999999999
20248053,14/02/2023,-114.98,431.12999999999994
20263437,31/01/2023,,789.09
20263437,04/02/2023,141.31,930.4000000000001
20263437,05/02/2023,-41.33,889.07
20263437,05/02/2023,-99.42,789.6500000000001
20263437,08/02/2023,107.41,897.0600000000001
20263437,12/02/2023,48.67,945.73
20280759,31/01/2023,,838.7
20280759,03/02/2023,-66.37,772.33
20280759,04/02/2023,-110.37,661.96
20280759,12/02/2023,118.8,780.76
20280759,12/02/2023,-66.4,714.36
20280759,12/02/2023,-110.26,604.1
20280759,13/02/2023,110.74,714.84
20287993,31/01/2023,,616.17
20287993,03/02/2023,125.34,741.51
20287993,04/02/2023,614.0,1355.51
20287993,06/02/2023,876.5,2232.01
20287993,07/02/2023,-756.5,1475.51
20287993,09/02/2023,81.5,1557.01
20287993,13/02/2023,203.37,1760.38
20287993,13/02/2023,-91.78,1668.6
20316429,31/01/2023,,697.84
20316429,02/02/2023,-94.92,602.9200000000001
20316429,09/02/2023,-166.7,436.22
20345467,31/01/2023,,852.5
20345467,01/02/2023,-72.35,780.15
20345467,02/02/2023,-100.36,679.79
20345467,05/02/2023,115.08,794.87
20345467,08/02/2023,154.63,949.5
20345467,09/02/2023,-154.98,794.52
20345467,14/02/2023,102.53,897.05
20369153,31/01/2023,,293.78
20369153,01/02/2023,387.9,681.68
20369153,03/02/2023,142.86,824.54
20369153,04/02/2023,-111.47,713.0699999999999
20369153,05/02/2023,-144.17,568.9
20369153,07/02/2023,605.2,1174.1
20369153,07/02/2023,-979.3,194.80000000000007
20369153,11/02/2023,-59.3,135.50000000000006
20369153,11/02/2023,-132.19,3.310000000000059
20369153,11/02/2023,-146.56,-143.24999999999994
20372310,31/01/2023,,366.41
20372310,02/02/2023,-123.8,242.61
20372310,05/02/2023,142.33,384.94000000000005
20372310,05/02/2023,-104.74,280.20000000000005
20372310,10/02/2023,-26.87,253.33000000000007
20372310,10/02/2023,-74.87,178.46000000000004
20372310,10/02/2023,-144.36,34.10000000000002
20372310,11/02/2023,123.03,157.13000000000002
20372310,11/02/2023,-1293.9,-1136.77
20413037,31/01/2023,,235.79
20413037,02/02/2023,98.09,333.88
20413037,02/02/2023,-93.56,240.32
20413037,02/02/2023,-119.55,120.77
20413037,07/02/2023,65.9,186.67000000000002
20413037,11/02/2023,121.47,308.14
20413037,11/02/2023,-48.78,259.36
20413037,14/02/2023,-56.12,203.24
20425065,31/01/2023,,866.77
20425065,02/02/2023,-62.78,803.99
20425065,04/02/2023,-165.75,638.24
20425065,14/02/2023,-2134.6,-1496.36
20464830,31/01/2023,,181.25
20464830,03/02/2023,-166.13,15.120000000000005
20464830,04/02/2023,121.04,136.16000000000003
20464830,08/02/2023,159.45,295.61
20632572,31/01/2023,,286.44
20632572,02/02/2023,-20.11,266.33
20632572,06/02/2023,16.08,282.40999999999997
20632572,12/02/2023,175.32,457.73
20704613,31/01/2023,,71.59
20704613,01/02/2023,97.11,168.7
20704613,06/02/2023,-11.61,157.09
20704613,07/02/2023,93.91,251.0
20704613,08/02/2023,30.57,281.57
20704613,09/02/2023,130.36,411.93
20704613,10/02/2023,-200.96,210.97
20704613,11/02/2023,20.99,231.96
20704613,13/02/2023,-154.81,77.15
20705548,31/01/2023,,184.81
20705548,02/02/2023,2269.2,2454.0099999999998
20705548,03/02/2023,208.56,2662.5699999999997
20705548,04/02/2023,-125.11,2537.4599999999996
20705548,14/02/2023,67.36,2604.8199999999997
20705548,14/02/2023,46.61,2651.43
20705548,14/02/2023,-30.74,2620.6899999999996
20720894,31/01/2023,,243.42
20720894,06/02/2023,462.2,705.62
20720894,06/02/2023,179.82,885.4399999999999
20720894,11/02/2023,-107.81,777.6299999999999
20838578,31/01/2023,,620.7
20838578,09/02/2023,-55.87,564.83
20838578,10/02/2023,-96.87,467.96000000000004
20838578,12/02/2023,56.96,524.9200000000001
20849721,31/01/2023,,740.52
20849721,06/02/2023,70.55,811.0699999999999
20849721,06/02/2023,19.45,830.52
20849721,07/02/2023,197.62,1028.1399999999999
20849721,08/02/2023,-71.98,956.16
20849721,13/02/2023,117.42,1073.58
20851460,31/01/2023,,931.67
20851460,03/02/2023,124.8,1056.47
20851460,10/02/2023,-147.03,909.4399999999999
20878023,31/01/2023,,648.19
20878023,04/02/2023,-149.2,498.99000000000007
20878023,06/02/2023,-103.53,395.46000000000004
20878023,06/02/2023,-125.2,270.26000000000005
20878023,08/02/2023,124.5,394.76000000000005
20878023,08/02/2023,-107.64,287.12000000000006
20878023,10/02/2023,-63.58,223.54000000000008
20878023,13/02/2023,-26.71,196.83000000000007
20908067,31/01/2023,,607.53
20908067,05/02/2023,179.9,787.43
20908067,06/02/2023,-202.05,585.38
20908067,11/02/2023,-119.75,465.63
20908067,14/02/2023,-2138.0,-1672.37
20991411,31/01/2023,,572.64
20991411,06/02/2023,-111.33,461.31
20991411,09/02/2023,41.77,503.08
20991411,10/02/2023,-114.86,388.22
20992354,31/01/2023,,87.26
20992354,01/02/2023,-82.18,5.079999999999998
20992354,03/02/2023,-5.14,-0.060000000000001386
20992354,04/02/2023,129.11,129.05
20992354,08/02/2023,-191.5,-62.44999999999999
20992354,09/02/2023,-35.39,-97.83999999999999
20992354,12/02/2023,52.16,-45.67999999999999
20992354,13/02/2023,157.55,111.87000000000002
20992354,13/02/2023,-99.13,12.740000000000023
21001872,31/01/2023,,31.76
21001872,09/02/2023,12.23,43.99
21001872,10/02/2023,-106.72,-62.73
21001872,12/02/2023,-98.65,-161.38
21001872,14/02/2023,101.69,-59.69
21032760,31/01/2023,,541.33
21032760,01/02/2023,-637.1,-95.76999999999998
21032760,03/02/2023,94.5,-1.2699999999999818
21032760,03/02/2023,-51.58,-52.84999999999998
21032760,04/02/2023,127.8,74.95000000000002
21032760,09/02/2023,78.9,153.85000000000002
21032760,09/02/2023,-993.4,-839.55
21032760,10/02/2023,-932.3,-1771.85
21032760,11/02/2023,33.32,-1738.53
21032760,11/02/2023,-1161.1,-2899.63
21032760,13/02/2023,161.21,-2738.42
21047777,31/01/2023,,699.12
21047777,03/02/2023,40.55,739.67
21047777,04/02/2023,31.07,770.74
21047777,05/02/2023,-128.94,641.8
21047777,06/02/2023,92.39,734.19
21047777,07/02/2023,137.57,871.76
21047777,08/02/2023,163.05,1034.81
21047777,08/02/2023,-14.52,1020.29
21047777,12/02/2023,-90.28,930.01
21142911,31/01/2023,,714.89
21142911,01/02/2023,-103.99,610.9
21142911,02/02/2023,-156.5,454.4
21142911,06/02/2023,80.92,535.3199999999999
21142911,10/02/2023,160.6,695.92
21142911,10/02/2023,-52.02,643.9
21142911,10/02/2023,-86.61,557.29
21293955,31/01/2023,,232.88
21293955,05/02/2023,1110.7,1343.58
21293955,08/02/2023,85.9,1429.4800000000002
21293955,10/02/2023,624.8,2054.28
21314767,31/01/2023,,438.19
21314767,01/02/2023,-33.36,404.83
21314767,01/02/2023,-130.93,273.9
21314767,07/02/2023,-143.04,130.85999999999999
21314767,11/02/2023,-134.72,-3.8600000000000136
21314767,12/02/2023,-103.79,-107.65000000000002
21314767,12/02/2023,-1486.8,-1594.45
21368735,31/01/2023,,281.87
21368735,01/02/2023,-145.77,136.1
21368735,02/02/2023,-786.6,-650.5
21368735,03/02/2023,40.33,-610.17
21368735,04/02/2023,-73.7,-683.87
21368735,05/02/2023,-49.85,-733.72
21368735,06/02/2023,63.43,-670.29
21368735,13/02/2023,118.83,-551.46
21392412,31/01/2023,,708.46
21392412,02/02/2023,117.9,826.36
21392412,02/02/2023,-192.68,633.6800000000001
21392412,04/02/2023,1367.4,2001.0800000000002
21392412,04/02/2023,-101.75,1899.3300000000002
21392412,12/02/2023,122.81,2022.14
21392412,14/02/2023,-120.31,1901.8300000000002
21464772,31/01/2023,,719.8
21464772,04/02/2023,81.91,801.7099999999999
21464772,08/02/2023,52.3,854.01
21464772,12/02/2023,181.41,1035.42
21464772,12/02/2023,125.47,1160.8899999999999
21475060,31/01/2023,,354.98
21475060,06/02/2023,39.83,394.81
21475060,06/02/2023,-431.9,-37.089999999999975
21475060,10/02/2023,-117.25,-154.33999999999997
21475060,12/02/2023,-1061.5,-1215.84
21475060,13/02/2023,158.29,-1057.55
21475060,14/02/2023,25.28,-1032.27
21515934,31/01/2023,,543.38
21515934,01/02/2023,-126.75,416.63
21515934,02/02/2023,599.3,1015.93
21515934,02/02/2023,-212.6,803.3299999999999
21515934,03/02/2023,-70.29,733.04
21515934,11/02/2023,-100.88,632.16
21515934,14/02/2023,77.69,709.8499999999999
21550631,31/01/2023,,84.96
21550631,03/02/2023,-182.35,-97.39
21550631,04/02/2023,119.53,22.14
21550631,08/02/2023,-88.85,-66.71
21550631,11/02/2023,110.41,43.7
21558805,31/01/2023,,586.63
21558805,02/02/2023,68.41,655.04
21558805,05/02/2023,2160.7,2815.74
21558805,07/02/2023,1434.3,4250.04
21558805,10/02/2023,113.82,4363.86
21558805,12/02/2023,934.0,5297.86
21558805,13/02/2023,126.07,5423.929999999999
21558805,13/02/2023,-117.42,5306.509999999999
21601747,31/01/2023,,410.62
21601747,01/02/2023,-58.18,352.44
21601747,06/02/2023,22.99,375.43
21601747,08/02/2023,597.4,972.8299999999999
21601747,10/02/2023,103.91,1076.74
21601747,14/02/2023,-140.0,936.74
21618665,31/01/2023,,291.59
21618665,01/02/2023,-223.94,67.64999999999998
21618665,02/02/2023,89.87,157.51999999999998
21618665,02/02/2023,-175.73,-18.210000000000008
21618665,04/02/2023,101.39,83.17999999999999
21618665,05/02/2023,63.96,147.14
21618665,05/02/2023,-142.33,4.809999999999974
21618665,06/02/2023,184.01,188.81999999999996
21618665,06/02/2023,-65.05,123.76999999999997
21618665,07/02/2023,-171.64,-47.87000000000002
21618665,09/02/2023,96.36,48.48999999999998
21618665,13/02/2023,-104.51,-56.020000000000024
21618665,13/02/2023,-148.17,-204.19
21646418,31/01/2023,,909.55
21646418,04/02/2023,123.43,1032.98
21646418,06/02/2023,-74.78,958.1999999999999
21646418,09/02/2023,64.47,1022.67
21655728,31/01/2023,,761.31
21655728,11/02/2023,56.37,817.68
21655728,11/02/2023,-106.02,711.66
21675999,31/01/2023,,893.27
21675999,01/02/2023,109.32,1002.5899999999999
21675999,04/02/2023,-598.4,404.19000000000005
21675999,09/02/2023,158.66,562.85
21675999,10/02/2023,-32.99,529.86
21675999,11/02/2023,65.4,595.26
21675999,11/02/2023,56.7,651.96
21694967,31/01/2023,,90.13
21694967,02/02/2023,1019.5,1109.63
21694967,02/02/2023,133.67,1243.3
21694967,02/02/2023,-616.7,626.5999999999999
21694967,03/02/2023,-33.4,593.1999999999999
21694967,06/02/2023,-1042.0,-448.80000000000007
21694967,07/02/2023,1808.5,1359.6999999999998
21694967,08/02/2023,-159.45,1200.2499999999998
21694967,09/02/2023,12.69,1212.9399999999998
21705004,31/01/2023,,496.88
21705004,08/02/2023,103.7,600.58
21705004,13/02/2023,124.45,725.03
21705004,13/02/2023,-48.19,676.84
21711501,31/01/2023,,126.63
21711501,01/02/2023,126.36,252.99
21711501,03/02/2023,-1882.4,-1629.41
21711501,04/02/2023,-126.27,-1755.68
21716351,31/01/2023,,800.95
21716351,02/02/2023,111.91,912.86
21716351,05/02/2023,219.27,1132.13
21716351,08/02/2023,33.32,1165.45
21716351,12/02/2023,1499.6,2665.05
21719977,31/01/2023,,758.81
21719977,05/02/2023,138.9,897.7099999999999
21719977,06/02/2023,-155.92,741.79
21719977,06/02/2023,-180.89,560.9
21719977,10/02/2023,739.5,1300.4
21719977,12/02/2023,39.77,1340.17
21719977,13/02/2023,-1121.3,218.87000000000012
21728352,31/01/2023,,733.87
21728352,02/02/2023,-91.84,642.03
21728352,04/02/2023,120.38,762.41
21728352,08/02/2023,-117.08,645.33
21728352,10/02/2023,66.94,712.27
21728352,12/02/2023,151.06,863.3299999999999
21728352,12/02/2023,-103.32,760.01
21728352,13/02/2023,51.57,811.58
21749252,31/01/2023,,646.27
21749252,01/02/2023,50.95,697.22
21749252,02/02/2023,-165.3,531.92
21749252,03/02/2023,126.76,658.68
21749252,07/02/2023,144.5,803.18
21749252,08/02/2023,-110.15,693.03
21749252,10/02/2023,-156.28,536.75
21749252,10/02/2023,-1098.2,-561.45
21749252,13/02/2023,53.28,-508.1700000000001
21750371,31/01/2023,,329.19
21750371,05/02/2023,-88.55,240.64
21750371,06/02/2023,131.96,372.6
21750371,10/02/2023,72.23,444.83000000000004
21816770,31/01/2023,,693.8
21816770,03/02/2023,182.35,876.15
21816770,03/02/2023,141.05,1017.1999999999999
21816770,03/02/2023,-56.86,960.3399999999999
21816770,05/02/2023,74.16,1034.5
21816770,09/02/2023,-144.14,890.3599999999999
21816770,10/02/2023,114.24,1004.5999999999999
21844169,31/01/2023,,463.51
21844169,01/02/2023,-3.04,460.46999999999997
21844169,04/02/2023,-139.28,321.19
21844169,06/02/2023,104.66,425.85
21844169,06/02/2023,-103.37,322.48
21844169,07/02/2023,-89.6,232.88
21844169,08/02/2023,103.37,336.25
21844169,09/02/2023,67.11,403.36
21844169,11/02/2023,-124.08,279.28
21844169,12/02/2023,-108.81,170.47
21844651,31/01/2023,,525.16
21844651,03/02/2023,104.89,630.05
21844651,03/02/2023,-37.02,593.03
21844651,04/02/2023,73.5,666.53
21844651,04/02/2023,45.51,712.04
21844651,13/02/2023,43.53,755.5699999999999
21881168,31/01/2023,,950.62
21881168,04/02/2023,27.77,978.39
21881168,04/02/2023,-78.39,900.0
21881168,04/02/2023,-153.28,746.72
21881168,06/02/2023,31.91,778.63
21881168,06/02/2023,-185.73,592.9
21881168,10/02/2023,121.44,714.34
21881168,10/02/2023,-882.0,-167.65999999999997
21881168,14/02/2023,-78.92,-246.57999999999998
21898016,31/01/2023,,117.42
21898016,09/02/2023,113.15,230.57
21918195,31/01/2023,,510.33
21918195,02/02/2023,-120.93,389.4
21918195,08/02/2023,-105.35,284.04999999999995
21918195,14/02/2023,-150.77,133.27999999999997
21966927,31/01/2023,,511.1
21966927,02/02/2023,88.29,599.39
21966927,05/02/2023,75.94,675.33
21966927,06/02/2023,-27.72,647.61
21966927,10/02/2023,69.88,717.49
22027757,31/01/2023,,438.85
22027757,01/02/2023,-20.11,418.74
22027757,01/02/2023,-102.21,316.53000000000003
22027757,01/02/2023,-215.02,101.51000000000002
22027757,05/02/2023,-505.0,-403.49
22027757,06/02/2023,13.61,-389.88
22035411,31/01/2023,,9.55
22035411,02/02/2023,1028.8,1038.35
22035411,02/02/2023,122.21,1160.56
22035411,02/02/2023,37.84,1198.3999999999999
22035411,06/02/2023,47.53,1245.9299999999998
22035411,07/02/2023,-132.14,1113.79
22035411,09/02/2023,-15.37,1098.4199999999998
22035411,10/02/2023,97.29,1195.7099999999998
22035411,11/02/2023,-85.02,1110.6899999999998
22054113,31/01/2023,,364.66
22054113,01/02/2023,33.36,398.02000000000004
22054113,03/02/2023,-66.09,331.93
22054113,04/02/2023,57.96,389.89000000000004
22054113,09/02/2023,137.79,527.6800000000001
22054113,11/02/2023,43.78,571.46
22054113,11/02/2023,-109.76,461.7
22063978,31/01/2023,,387.01
22063978,01/02/2023,95.21,482.21999999999997
22063978,01/02/2023,-989.3,-507.08
22063978,02/02/2023,50.71,-456.37
22063978,02/02/2023,39.13,-417.24
22063978,10/02/2023,108.81,-308.42999999999995
22099256,31/01/2023,,523.78
22099256,02/02/2023,-131.8,391.97999999999996
22099256,04/02/2023,-87.13,304.84999999999997
22099256,06/02/2023,-127.87,176.97999999999996
22099256,06/02/2023,-1003.2,-826.22
22099256,09/02/2023,85.88,-740.34
22099256,14/02/2023,1401.8,661.4599999999999
22137086,31/01/2023,,410.35
22137086,04/02/2023,2122.7,2533.0499999999997
22137086,05/02/2023,-115.53,2417.5199999999995
22137086,07/02/2023,-32.26,2385.2599999999998
22137086,08/02/2023,83.33,2468.5899999999997
22137086,08/02/2023,-69.06,2399.5299999999997
22137086,08/02/2023,-1368.6,1030.9299999999998
22137086,09/02/2023,-1288.6,-257.6700000000001
22137086,11/02/2023,41.86,-215.81000000000006
22268314,31/01/2023,,153.05
22268314,01/02/2023,-160.38,-7.329999999999984
22268314,05/02/2023,-65.31,-72.63999999999999
22268314,09/02/2023,-155.69,-228.32999999999998
22268314,10/02/2023,13.9,-214.42999999999998
22268314,11/02/2023,-37.8,-252.23
22268314,13/02/2023,-14.32,-266.54999999999995
22292682,31/01/2023,,874.32
22292682,01/02/2023,-130.44,743.8800000000001
22292682,05/02/2023,159.07,902.95
22292682,05/02/2023,-201.75,701.2
22292682,06/02/2023,122.96,824.1600000000001
22292682,07/02/2023,103.74,927.9000000000001
22292682,11/02/2023,23.58,951.48
22292682,12/02/2023,66.05,1017.53
22298371,31/01/2023,,891.16
22298371,01/02/2023,-107.18,783.98
22298371,05/02/2023,-219.27,564.7099999999999
22298371,07/02/2023,86.22,650.93
22298371,12/02/2023,-151.34,499.5899999999999
22341160,31/01/2023,,61.07
22341160,02/02/2023,-699.9,-638.8299999999999
22374612,31/01/2023,,554.31
22374612,03/02/2023,46.33,600.64
22374612,05/02/2023,-1110.7,-510.06000000000006
22374612,07/02/2023,-134.55,-644.6100000000001
22374612,08/02/2023,-189.92,-834.5300000000001
22374612,11/02/2023,1742.7,908.17
22374612,12/02/2023,-91.9,816.27
22374612,14/02/2023,-735.5,80.76999999999998
22391508,31/01/2023,,91.32
22391508,01/02/2023,12.31,103.63
22391508,02/02/2023,94.69,198.32
22391508,07/02/2023,-71.61,126.71
22393008,31/01/2023,,753.5
22393008,07/02/2023,-1806.9,-1053.4
22393008,09/02/2023,1260.0,206.5999999999999
22393008,09/02/2023,-146.1,60.499999999999915
22393008,10/02/2023,1526.7,1587.2
22393008,13/02/2023,-99.8,1487.4
22403299,31/01/2023,,702.95
22403299,03/02/2023,774.8,1477.75
22403299,03/02/2023,-101.53,1376.22
22403299,04/02/2023,90.13,1466.35
22403299,04/02/2023,-95.64,1370.71
22403299,05/02/2023,-57.79,1312.92
22403299,08/02/2023,167.11,1480.03
22403299,09/02/2023,735.1,2215.13
22403299,09/02/2023,142.44,2357.57
22403299,09/02/2023,-88.39,2269.18
22404690,31/01/2023,,726.06
22404690,08/02/2023,-13.32,712.7399999999999
22404690,12/02/2023,934.7,1647.44
22404690,14/02/2023,-126.71,1520.73
22412680,31/01/2023,,637.99
22412680,02/02/2023,-82.9,555.09
22412680,03/02/2023,-84.5,470.59000000000003
22412680,08/02/2023,154.46,625.05
22412680,09/02/2023,119.51,744.5600000000001
22412680,09/02/2023,35.39,779.95
22412680,09/02/2023,-167.25,612.7
22412680,10/02/2023,85.16,697.86
22412680,10/02/2023,77.1,774.96
22412680,14/02/2023,104.53,879.49
22412680,14/02/2023,-38.12,841.37
22412680,14/02/2023,-68.51,772.86
22483300,31/01/2023,,763.23
22483300,05/02/2023,-52.34,710.89
22483300,07/02/2023,-140.12,570.77
22483300,09/02/2023,-112.76,458.01
22483300,10/02/2023,85.13,543.14
22683382,31/01/2023,,987.13
22683382,01/02/2023,-92.35,894.78
22683382,02/02/2023,31.64,926.42
22683382,06/02/2023,-110.76,815.66
22683382,07/02/2023,-104.64,711.02
22683382,09/02/2023,-142.61,568.41
22696687,31/01/2023,,133.52
22696687,03/02/2023,153.0,286.52
22696687,08/02/2023,-79.86,206.66000000000003
22696687,10/02/2023,-62.31,144.35000000000002
22696687,10/02/2023,-89.12,55.230000000000004
22696687,12/02/2023,1061.5,1116.73
22696687,12/02/2023,61.36,1178.09
22696687,12/02/2023,-38.42,1139.67
22696687,14/02/2023,-61.16,1078.51
22730750,31/01/2023,,473.56
22730750,01/02/2023,20.11,493.67
22730750,01/02/2023,13.37,507.04
22730750,04/02/2023,-95.05,411.99
22730750,05/02/2023,128.78,540.77
22730750,07/02/2023,-104.16,436.61
22730750,11/02/2023,132.96,569.57
22730750,12/02/2023,195.95,765.52
22730750,12/02/2023,-198.2,567.32
22799719,31/01/2023,,481.26
22799719,03/02/2023,51.58,532.84
22799719,03/02/2023,-133.85,398.99
22799719,06/02/2023,170.43,569.4200000000001
22799719,06/02/2023,75.9,645.32
22799719,07/02/2023,-44.02,601.3000000000001
22799719,11/02/2023,26.87,628.1700000000001
22799719,12/02/2023,-57.33,570.84
22799719,13/02/2023,38.78,609.62
22799719,13/02/2023,-180.81,428.81
22799719,14/02/2023,53.79,482.6
22830156,31/01/2023,,596.06
22830156,02/02/2023,634.2,1230.26
22830156,04/02/2023,-109.5,1120.76
22830156,10/02/2023,1987.3,3108.06
22830156,12/02/2023,-1153.9,1954.1599999999999
22830156,13/02/2023,-30.92,1923.2399999999998
22830156,14/02/2023,-170.57,1752.6699999999998
22833010,31/01/2023,,645.79
22833010,01/02/2023,-58.0,587.79
22833010,03/02/2023,-132.53,455.26
22833010,04/02/2023,-139.7,315.55999999999995
22833010,06/02/2023,110.76,426.32
22833010,08/02/2023,-163.93,262.39
22846221,31/01/2023,,868.2
22846221,01/02/2023,-179.6,688.6
22846221,02/02/2023,1106.9,1795.5
22846221,06/02/2023,126.83,1922.33
22846221,09/02/2023,12.71,1935.04
22846221,10/02/2023,-144.27,1790.77
22884864,31/01/2023,,521.87
22884864,02/02/2023,108.51,630.38
22884864,05/02/2023,-122.01,508.37
22884864,06/02/2023,-137.14,371.23
22884864,06/02/2023,-182.28,188.95000000000002
22888798,31/01/2023,,326.4
22888798,05/02/2023,39.31,365.71
22888798,06/02/2023,75.81,441.52
22888798,07/02/2023,71.14,512.66
22888798,08/02/2023,107.64,620.3
22888798,08/02/2023,-53.66,566.64
22951653,31/01/2023,,414.64
22951653,01/02/2023,17.61,432.25
22951653,02/02/2023,181.62,613.87
22951653,08/02/2023,-13.16,600.71
22951653,12/02/2023,-14.26,586.45
22951653,12/02/2023,-111.6,474.85
22951653,13/02/2023,84.66,559.51
23030554,31/01/2023,,196.97
23030554,03/02/2023,148.95,345.91999999999996
23030554,06/02/2023,-147.34,198.57999999999998
23030554,10/02/2023,-67.6,130.98
23030554,11/02/2023,-87.57,43.41
23032852,31/01/2023,,475.21
23032852,02/02/2023,832.5,1307.71
23032852,04/02/2023,75.94,1383.65
23032852,07/02/2023,140.72,1524.3700000000001
23032852,09/02/2023,780.7,2305.07
23032852,09/02/2023,-155.34,2149.73
23032852,10/02/2023,-156.63,1993.1000000000001
23045208,31/01/2023,,359.49
23045208,02/02/2023,62.04,421.53000000000003
23045208,02/02/2023,-794.9,-373.36999999999995
23045208,02/02/2023,-1157.4,-1530.77
23045208,13/02/2023,-118.67,-1649.44
23093541,31/01/2023,,326.05
23093541,04/02/2023,-55.7,270.35
23093541,05/02/2023,-96.95,173.4
23093541,05/02/2023,-110.12,63.28
23093541,10/02/2023,86.54,149.82
23124345,31/01/2023,,595.61
23124345,03/02/2023,215.09,810.7
23124345,04/02/2023,126.27,936.97
23124345,12/02/2023,130.79,1067.76
23141588,31/01/2023,,281.28
23141588,02/02/2023,-1824.3,-1543.02
23141588,14/02/2023,-64.58,-1607.6
23231848,31/01/2023,,27.12
23231848,02/02/2023,-112.23,-85.11
23231848,04/02/2023,-89.51,-174.62
23231848,04/02/2023,-292.64,-467.26
23231848,04/02/2023,-1454.9,-1922.16
23231848,06/02/2023,-97.52,-2019.68
23231848,09/02/2023,140.03,-1879.65
23231848,11/02/2023,-95.68,-1975.3300000000002
23231848,12/02/2023,-481.2,-2456.53
23231848,13/02/2023,-134.36,-2590.8900000000003
23231848,14/02/2023,37.37,-2553.52
23269253,31/01/2023,,324.56
23269253,01/02/2023,899.8,1224.36
23269253,07/02/2023,-151.91,1072.4499999999998
23269253,08/02/2023,35.48,1107.9299999999998
23269253,10/02/2023,-72.21,1035.7199999999998
23269253,13/02/2023,-34.3,1001.42
23269253,14/02/2023,-98.34,903.0799999999999
23271383,31/01/2023,,633.3
23271383,03/02/2023,-101.42,531.88
23271383,05/02/2023,174.13,706.01
23271383,06/02/2023,1176.9,1882.91
23271383,07/02/2023,138.63,2021.54
23271383,09/02/2023,157.69,2179.23
23271383,09/02/2023,4.61,2183.84
23271383,09/02/2023,-134.0,2049.84
23271383,11/02/2023,-11.69,2038.15
23271383,14/02/2023,118.38,2156.53
23289647,31/01/2023,,522.8
23289647,03/02/2023,56.86,579.66
23289647,07/02/2023,-87.03,492.62999999999994
23289647,07/02/2023,-125.71,366.91999999999996
23289647,10/02/2023,170.55,537.47
23289647,10/02/2023,-154.12,383.34999999999997
23295106,31/01/2023,,340.16
23295106,01/02/2023,89.15,429.31000000000006
23295106,02/02/2023,103.88,533.19
23295106,04/02/2023,72.72,605.9100000000001
23295106,06/02/2023,-106.03,499.88
23295106,11/02/2023,37.8,537.6800000000001
23295106,13/02/2023,-110.4,427.28000000000003
23295106,14/02/2023,1338.4,1765.68
23310842,31/01/2023,,78.85
23310842,02/02/2023,91.54,170.39
23310842,02/02/2023,-176.64,-6.25
23310842,05/02/2023,12.08,5.83
23310842,05/02/2023,-135.39,-129.55999999999997
23310842,06/02/2023,-90.98,-220.53999999999996
23310842,06/02/2023,-878.3,-1098.84
23310842,09/02/2023,103.84,-994.9999999999999
23310842,12/02/2023,-128.4,-1123.3999999999999
23321929,31/01/2023,,408.3
23321929,04/02/2023,123.51,531.8100000000001
23321929,11/02/2023,-114.34,417.47
23321929,13/02/2023,47.15,464.62
23321929,13/02/2023,-214.61,250.01
23325248,31/01/2023,,49.31
23325248,02/02/2023,-137.59,-88.28
23325248,09/02/2023,-182.37,-270.65
23333877,31/01/2023,,648.46
23333877,01/02/2023,-123.23,525.23
23333877,06/02/2023,103.53,628.76
23333877,06/02/2023,78.08,706.84
23333877,09/02/2023,166.64,873.48
23333877,10/02/2023,386.8,1260.28
23333877,11/02/2023,85.02,1345.3
23333877,12/02/2023,-93.16,1252.14
23333877,14/02/2023,-153.66,1098.48
23369902,31/01/2023,,716.79
23369902,01/02/2023,129.91,846.6999999999999
23369902,05/02/2023,165.04,1011.74
23369902,05/02/2023,118.28,1130.02
23369902,08/02/2023,-124.8,1005.2199999999999
23369902,11/02/2023,-111.88,893.3399999999999
23369902,13/02/2023,144.46,1037.8
23369902,13/02/2023,-183.79,854.01
23415061,31/01/2023,,71.2
23415061,01/02/2023,-102.1,-30.89999999999999
23415061,03/02/2023,90.48,59.58000000000001
23415061,04/02/2023,1702.7,1762.28
23415061,04/02/2023,-123.51,1638.77
23415061,10/02/2023,1220.5,2859.27
23445508,31/01/2023,,373.43
23445508,04/02/2023,54.57,428.0
23445508,07/02/2023,-85.73,342.27
23445508,09/02/2023,-652.0,-309.73
23445508,11/02/2023,-82.15,-391.88
23445508,13/02/2023,169.23,-222.65000000000003
23445508,13/02/2023,23.17,-199.48000000000002
23445508,13/02/2023,-48.38,-247.86000000000004
23479459,31/01/2023,,176.23
23479459,02/02/2023,121.53,297.76
23479459,02/02/2023,-117.71,180.05
23479459,05/02/2023,128.65,308.7
23479459,05/02/2023,-133.57,175.13
23479459,06/02/2023,50.86,225.99
23479459,09/02/2023,43.87,269.86
23490922,31/01/2023,,934.35
23490922,06/02/2023,-76.95,857.4
23490922,06/02/2023,-132.91,724.49
23490922,07/02/2023,78.1,802.59
23490922,10/02/2023,75.99,878.58
23498368,31/01/2023,,474.93
23498368,01/02/2023,101.12,576.05
23498368,06/02/2023,107.32,683.37
23498368,06/02/2023,-159.06,524.31
23498368,07/02/2023,109.39,633.7
23498368,11/02/2023,92.54,726.24
23498368,12/02/2023,98.68,824.9200000000001
23498368,12/02/2023,11.42,836.34
23498368,13/02/2023,-90.8,745.54
23501735,31/01/2023,,562.17
23501735,06/02/2023,107.54,669.7099999999999
23501735,08/02/2023,-150.5,519.21
23501735,09/02/2023,-42.25,476.96
23501735,10/02/2023,-48.91,428.04999999999995
23501735,11/02/2023,-75.76,352.28999999999996
23501735,12/02/2023,142.78,495.07
23501735,12/02/2023,-89.44,405.63
23501735,12/02/2023,-124.17,281.46
23580422,31/01/2023,,716.05
23580422,12/02/2023,-67.25,648.8
23698615,31/01/2023,,316.68
23698615,02/02/2023,89.17,405.85
23698615,05/02/2023,114.48,520.33
23698615,12/02/2023,-98.68,421.65
23736501,31/01/2023,,831.27
23736501,04/02/2023,192.0,1023.27
23736501,04/02/2023,-157.68,865.5899999999999
23736501,07/02/2023,-74.77,790.8199999999999
23736501,09/02/2023,182.37,973.19
23736501,09/02/2023,57.19,1030.38
23736501,09/02/2023,-36.06,994.3199999999999
23736501,10/02/2023,-206.97,787.35
23736501,11/02/2023,-42.47,744.88
23736501,14/02/2023,85.48,830.36
23775829,31/01/2023,,771.57
23775829,02/02/2023,91.57,863.1400000000001
23775829,02/02/2023,65.53,928.6700000000001
23775829,03/02/2023,-28.47,900.2
23775829,03/02/2023,-65.94,834.26
23775829,12/02/2023,-104.51,729.75
23775829,13/02/2023,101.49,831.24
23815822,31/01/2023,,835.0
23815822,03/02/2023,1882.4,2717.4
23815822,03/02/2023,-96.94,2620.46
23815822,05/02/2023,-110.97,2509.4900000000002
23815822,13/02/2023,-17.83,2491.6600000000003
23865100,31/01/2023,,201.44
23865100,02/02/2023,-52.86,148.57999999999998
23865100,05/02/2023,-140.22,8.360000000000014
23865100,06/02/2023,65.05,73.41000000000001
23865100,07/02/2023,86.46,159.87
23865100,08/02/2023,134.88,294.75
23865100,08/02/2023,83.2,377.95
23865100,09/02/2023,64.55,442.5
23865100,13/02/2023,17.92,460.42
23865100,14/02/2023,67.55,527.97
23920423,31/01/2023,,221.15
23920423,03/02/2023,-48.23,172.92000000000002
23920423,03/02/2023,-72.77,100.15
23920423,05/02/2023,96.05,196.2
23920423,05/02/2023,-63.21,132.99
23920423,08/02/2023,38.77,171.76
23920423,08/02/2023,12.95,184.71
23920423,08/02/2023,-161.43,23.28
23920423,11/02/2023,141.71,164.99
23931414,31/01/2023,,126.7
23931414,03/02/2023,-32.07,94.63
23931414,10/02/2023,-123.72,-29.090000000000003
23931414,14/02/2023,101.76,72.67
23932793,31/01/2023,,962.8
23932793,13/02/2023,-510.4,452.4
23932793,14/02/2023,-34.96,417.44
23935849,31/01/2023,,888.11
23935849,11/02/2023,103.93,992.04
23935849,12/02/2023,191.46,1183.5
23935849,14/02/2023,42.9,1226.4
23942646,31/01/2023,,517.93
23942646,01/02/2023,82.42,600.3499999999999
23942646,04/02/2023,-104.07,496.28
23942646,06/02/2023,-102.01,394.27
23942646,07/02/2023,105.09,499.35999999999996
23942646,09/02/2023,57.45,556.81
23959928,31/01/2023,,878.83
23959928,03/02/2023,1569.4,2448.23
23959928,04/02/2023,-3.48,2444.75
23959928,07/02/2023,-69.6,2375.15
23959928,14/02/2023,41.12,2416.27
23962863,31/01/2023,,307.07
23962863,01/02/2023,-599.8,-292.72999999999996
23962863,03/02/2023,-43.61,-336.34
23962863,04/02/2023,-535.8,-872.1399999999999
23962863,05/02/2023,171.75,-700.3899999999999
23962863,07/02/2023,-1676.4,-2376.79
23962863,11/02/2023,84.36,-2292.43
23962863,13/02/2023,123.27,-2169.16
23962863,13/02/2023,-92.64,-2261.8
23971753,31/01/2023,,170.77
23971753,02/02/2023,-169.64,1.1300000000000239
23971753,03/02/2023,110.05,111.18000000000002
23971753,08/02/2023,175.97,287.15000000000003
23971753,08/02/2023,-37.07,250.08
23971753,08/02/2023,-120.67,129.41
23971753,09/02/2023,-142.67,-13.259999999999991
23971753,09/02/2023,-1658.0,-1671.26
23971753,10/02/2023,-48.54,-1719.8
23971753,14/02/2023,123.69,-1596.11
23971753,14/02/2023,-194.38,-1790.49
24010877,31/01/2023,,652.95
24010877,01/02/2023,107.29,760.24
24010877,02/02/2023,-89.17,671.07
24010877,05/02/2023,-154.98,516.09
24010877,10/02/2023,139.65,655.74
24010877,10/02/2023,12.48,668.22
24010877,10/02/2023,-25.31,642.9100000000001
24010877,11/02/2023,122.96,765.8700000000001
24010877,12/02/2023,-110.81,655.0600000000001
24051672,31/01/2023,,429.37
24051672,02/02/2023,-111.58,317.79
24051672,03/02/2023,-122.53,195.26
24051672,03/02/2023,-208.28,-13.019999999999982
24051672,06/02/2023,50.67,37.65000000000002
24051672,06/02/2023,-1069.9,-1032.25
24051672,08/02/2023,122.65,-909.6
24051672,08/02/2023,13.16,-896.4399999999999
24076677,31/01/2023,,494.74
24076677,04/02/2023,142.92,637.66
24076677,04/02/2023,-162.79,474.87
24076677,09/02/2023,59.74,534.61
24076677,12/02/2023,120.78,655.39
24085667,31/01/2023,,249.1
24085667,01/02/2023,78.1,327.2
24085667,03/02/2023,-39.9,287.3
24085667,07/02/2023,97.64,384.94
24085667,11/02/2023,72.76,457.7
24085667,12/02/2023,140.52,598.22
24085667,13/02/2023,-102.35,495.87
24085667,14/02/2023,130.66,626.53
24113784,31/01/2023,,47.67
24113784,03/02/2023,-965.4,-917.73
24113784,04/02/2023,175.99,-741.74
24113784,04/02/2023,-1026.7,-1768.44
24113784,09/02/2023,37.53,-1730.91
24113784,10/02/2023,131.38,-1599.53
24113784,10/02/2023,98.69,-1500.8400000000001
24113784,10/02/2023,-55.38,-1556.22
24113784,11/02/2023,-666.5,-2222.7200000000003
24113784,13/02/2023,77.23,-2145.4900000000002
24113784,13/02/2023,-0.22,-2145.71
24113784,13/02/2023,-76.07,-2221.78
24122572,31/01/2023,,924.02
24122572,03/02/2023,-78.28,845.74
24122572,04/02/2023,362.7,1208.44
24122572,04/02/2023,160.27,1368.71
24122572,06/02/2023,149.41,1518.12
24122572,09/02/2023,-168.03,1350.09
24122572,11/02/2023,86.77,1436.86
24122572,11/02/2023,-141.75,1295.11
24122572,13/02/2023,118.46,1413.57
24122572,13/02/2023,97.77,1511.34
24123707,31/01/2023,,327.69
24123707,02/02/2023,120.26,447.95
24123707,09/02/2023,1386.8,1834.75
24125563,31/01/2023,,908.28
24125563,01/02/2023,98.33,1006.61
24125563,06/02/2023,-73.5,933.11
24125563,10/02/2023,124.46,1057.57
24125563,11/02/2023,89.5,1147.07
24125563,13/02/2023,17.83,1164.8999999999999
24149353,31/01/2023,,487.27
24149353,03/02/2023,108.5,595.77
24149353,06/02/2023,163.65,759.42
24149353,06/02/2023,38.61,798.03
24149353,06/02/2023,-1201.1,-403.06999999999994
24150990,31/01/2023,,365.31
24150990,02/02/2023,111.58,476.89
24150990,04/02/2023,134.81,611.7
24150990,04/02/2023,-47.39,564.31
24150990,05/02/2023,-84.05,480.26
24150990,06/02/2023,82.1,562.36
24150990,13/02/2023,-185.87,376.49
24150990,14/02/2023,91.7,468.19
24178466,31/01/2023,,330.91
24178466,06/02/2023,79.47,410.38
24178466,06/02/2023,-114.81,295.57000000000005
24178466,08/02/2023,-87.59,207.98000000000002
24178466,14/02/2023,-96.17,111.81000000000002
24184530,31/01/2023,,37.87
24184530,02/02/2023,-83.33,-45.46
24184530,08/02/2023,-1360.9,-1406.3600000000001
24184530,11/02/2023,-175.16,-1581.5200000000002
24184530,12/02/2023,143.0,-1438.5200000000002
24198488,31/01/2023,,578.35
24198488,02/02/2023,-168.98,409.37
24198488,05/02/2023,133.57,542.94
24198488,05/02/2023,94.38,637.32
24198488,05/02/2023,83.59,720.9100000000001
24198488,09/02/2023,-86.86,634.0500000000001
24198488,13/02/2023,134.6,768.6500000000001
24250015,31/01/2023,,592.59
24250015,01/02/2023,132.46,725.0500000000001
24250015,10/02/2023,84.84,809.8900000000001
24250015,10/02/2023,-871.2,-61.309999999999945
24250015,11/02/2023,107.86,46.550000000000054
24250015,11/02/2023,-115.25,-68.69999999999995
24250015,12/02/2023,1354.4,1285.7
24285988,31/01/2023,,783.9
24285988,02/02/2023,158.28,942.18
24285988,04/02/2023,-58.09,884.0899999999999
24285988,05/02/2023,963.3,1847.3899999999999
24285988,06/02/2023,99.14,1946.53
24285988,06/02/2023,-149.08,1797.4499999999998
24285988,14/02/2023,-114.54,1682.9099999999999
24285988,14/02/2023,-178.04,1504.87
24298516,31/01/2023,,768.69
24298516,01/02/2023,-74.43,694.26
24298516,03/02/2023,177.23,871.49
24298516,09/02/2023,146.1,1017.59
24298516,09/02/2023,63.75,1081.3400000000001
24299977,31/01/2023,,199.33
24299977,01/02/2023,-13.37,185.96
24299977,01/02/2023,-62.95,123.01000000000002
24299977,01/02/2023,-88.99,34.02000000000001
24299977,01/02/2023,-218.14,-184.11999999999998
24299977,02/02/2023,114.88,-69.23999999999998
24299977,04/02/2023,78.83,9.590000000000018
24299977,06/02/2023,-177.63,-168.03999999999996
24299977,08/02/2023,-88.44,-256.47999999999996
24299977,10/02/2023,-139.51,-395.98999999999995
24299977,11/02/2023,-102.84,-498.8299999999999
24299977,13/02/2023,118.4,-380.42999999999995
24299977,13/02/2023,-168.68,-549.1099999999999
24308337,31/01/2023,,764.57
24308337,02/02/2023,-79.25,685.32
24308337,03/02/2023,-123.6,561.72
24308337,03/02/2023,-886.6,-324.88
24308337,07/02/2023,-1653.3,-1978.1799999999998
24308337,09/02/2023,148.45,-1829.73
24308337,11/02/2023,148.81,-1680.92
24308337,12/02/2023,-146.05,-1826.97
24308337,13/02/2023,959.6,-867.3700000000001
24370240,31/01/2023,,608.64
24370240,01/02/2023,-45.7,562.9399999999999
24370240,02/02/2023,113.03,675.97
24370240,06/02/2023,-137.34,538.63
24370240,07/02/2023,-39.54,499.09
24370240,08/02/2023,1245.5,1744.59
24370240,09/02/2023,88.73,1833.32
24370240,13/02/2023,153.62,1986.94
24370240,13/02/2023,136.9,2123.84
24370240,14/02/2023,63.74,2187.58
24382889,31/01/2023,,14.23
24382889,04/02/2023,68.76,82.99000000000001
24382889,06/02/2023,69.68,152.67000000000002
24382889,12/02/2023,68.37,221.04000000000002
24382889,13/02/2023,-46.32,174.72000000000003
24406166,31/01/2023,,746.97
24406166,09/02/2023,132.48,879.45
24406166,09/02/2023,96.52,975.97
24406166,10/02/2023,149.61,1125.58
24406166,11/02/2023,-103.18,1022.4000000000001
24434457,31/01/2023,,385.3
24434457,03/02/2023,2128.4,2513.7000000000003
24434457,10/02/2023,-129.11,2384.59
24462859,31/01/2023,,646.0
24462859,03/02/2023,91.66,737.66
24462859,04/02/2023,100.94,838.6
24462859,06/02/2023,43.35,881.95
24462859,07/02/2023,-120.64,761.31
24462859,08/02/2023,136.38,897.69
24462859,09/02/2023,-1855.5,-957.81
24462859,12/02/2023,-20.21,-978.02
24510213,31/01/2023,,142.59
24510213,10/02/2023,-133.0,9.590000000000003
24510213,14/02/2023,56.12,65.71000000000001
24513968,31/01/2023,,306.35
24513968,01/02/2023,1277.2,1583.5500000000002
24513968,03/02/2023,-110.56,1472.99
24513968,07/02/2023,-111.37,1361.62
24513968,13/02/2023,80.72,1442.34
24516638,31/01/2023,,426.16
24516638,04/02/2023,-80.86,345.3
24516638,09/02/2023,121.34,466.64000000000004
24516638,11/02/2023,-26.95,439.69000000000005
24516638,14/02/2023,124.79,564.48
24516638,14/02/2023,117.24,681.72
24519138,31/01/2023,,58.15
24519138,01/02/2023,-123.96,-65.81
24519138,04/02/2023,119.74,53.93000000000001
24519138,06/02/2023,-742.3,-688.3699999999999
24519138,10/02/2023,39.7,-648.6699999999998
24519138,11/02/2023,887.8,239.1300000000001
24519138,13/02/2023,166.98,406.1100000000001
24519138,13/02/2023,-52.77,353.3400000000001
24519138,13/02/2023,-139.83,213.51000000000008
24519138,14/02/2023,126.36,339.87000000000006
24519138,14/02/2023,-156.38,183.49000000000007
24529850,31/01/2023,,800.79
24529850,03/02/2023,105.07,905.8599999999999
24529850,07/02/2023,-103.43,802.43
24529850,08/02/2023,135.88,938.31
24529850,08/02/2023,-2283.2,-1344.8899999999999
24529850,09/02/2023,-62.59,-1407.4799999999998
24529850,09/02/2023,-103.19,-1510.6699999999998
24529850,09/02/2023,-136.3,-1646.9699999999998
24529850,09/02/2023,-196.64,-1843.61
24529850,11/02/2023,-122.71,-1966.32
24529850,14/02/2023,665.3,-1301.02
24529850,14/02/2023,-79.12,-1380.1399999999999
24531428,31/01/2023,,565.21
24531428,03/02/2023,-80.5,484.71000000000004
24531428,11/02/2023,49.15,533.86
24531428,12/02/2023,-89.04,444.82000000000005
24533829,31/01/2023,,190.8
24533829,01/02/2023,118.62,309.42
24533829,02/02/2023,-180.4,129.02
24533829,09/02/2023,-105.21,23.810000000000016
24533829,11/02/2023,-56.69,-32.87999999999998
24533829,14/02/2023,-52.36,-85.23999999999998
24533935,31/01/2023,,808.99
24533935,02/02/2023,-13.68,795.3100000000001
24533935,06/02/2023,59.42,854.73
24533935,06/02/2023,-114.86,739.87
24533935,07/02/2023,118.19,858.06
24533935,11/02/2023,95.27,953.33
24533935,12/02/2023,-37.35,915.98
24533935,14/02/2023,139.74,1055.72
24533935,14/02/2023,85.15,1140.87
24539679,31/01/2023,,768.68
24539679,02/02/2023,950.2,1718.88
24539679,02/02/2023,-22.39,1696.49
24539679,05/02/2023,58.5,1754.99
24539679,07/02/2023,1151.1,2906.09
24539679,09/02/2023,-127.72,2778.37
24539679,10/02/2023,-114.72,2663.65
24539679,11/02/2023,-35.03,2628.62
24539679,14/02/2023,104.91,2733.5299999999997
24539679,14/02/2023,-68.67,2664.86
24539679,14/02/2023,-125.94,2538.92
24577383,31/01/2023,,911.96
24577383,02/02/2023,88.1,1000.0600000000001
24577383,08/02/2023,-152.99,847.07
24577383,11/02/2023,120.57,967.64
24577383,11/02/2023,49.94,1017.58
24577383,14/02/2023,131.53,1149.1100000000001
24577383,14/02/2023,-1191.7,-42.590000000000146
24638469,31/01/2023,,968.27
24638469,01/02/2023,-209.89,758.38
24638469,11/02/2023,-127.49,630.89
24669065,31/01/2023,,574.3
24669065,09/02/2023,87.21,661.51
24669065,11/02/2023,-65.05,596.4599999999999
24669065,11/02/2023,-74.61,521.8499999999999
24669065,14/02/2023,-162.09,359.75999999999993
24715803,31/01/2023,,684.75
24715803,06/02/2023,131.6,816.35
24715803,10/02/2023,88.61,904.96
24715803,10/02/2023,-85.88,819.08
24715803,13/02/2023,-117.96,701.12
24715803,14/02/2023,-80.46,620.66
24725325,31/01/2023,,567.17
24725325,04/02/2023,-27.77,539.4
24725325,06/02/2023,-78.29,461.10999999999996
24725325,06/02/2023,-143.3,317.80999999999995
24725325,08/02/2023,-150.55,167.25999999999993
24725325,09/02/2023,129.85,297.1099999999999
24725325,12/02/2023,-11.42,285.68999999999994
24725325,12/02/2023,-139.56,146.12999999999994
24796881,31/01/2023,,943.93
24796881,06/02/2023,111.33,1055.26
24796881,08/02/2023,89.09,1144.35
24796881,09/02/2023,125.13,1269.48
24796881,10/02/2023,-89.61,1179.87
24796881,14/02/2023,142.18,1322.05
24796881,14/02/2023,122.9,1444.95
24796881,14/02/2023,-52.73,1392.22
24826358,31/01/2023,,923.46
24826358,06/02/2023,-113.2,810.26
24826358,08/02/2023,123.43,933.69
24826358,08/02/2023,-151.47,782.22
24826358,09/02/2023,-107.86,674.36
24826358,09/02/2023,-170.19,504.17
24826358,10/02/2023,355.2,859.37
24826358,14/02/2023,72.61,931.98
24849103,31/01/2023,,381.36
24849103,01/02/2023,-83.41,297.95000000000005
24849103,02/02/2023,-104.28,193.67000000000002
24849103,05/02/2023,-174.13,19.54000000000002
24849103,10/02/2023,143.73,163.27
24849103,11/02/2023,-185.47,-22.19999999999999
24849103,12/02/2023,-77.02,-99.21999999999998
24849103,13/02/2023,125.61,26.390000000000015
24849103,13/02/2023,-142.2,-115.80999999999997
24849103,14/02/2023,18.23,-97.57999999999997
24859951,31/01/2023,,950.69
24859951,08/02/2023,-204.91,745.7800000000001
24859951,09/02/2023,-58.69,687.09
24859951,13/02/2023,-74.74,612.35
24860683,31/01/2023,,982.97
24860683,01/02/2023,-114.22,868.75
24860683,06/02/2023,163.9,1032.65
24860683,06/02/2023,-8.35,1024.3
24860683,08/02/2023,-941.0,83.30000000000007
24860683,09/02/2023,108.36,191.66000000000008
24860683,10/02/2023,92.9,284.56000000000006
24860683,10/02/2023,83.94,368.50000000000006
24976861,31/01/2023,,982.53
24976861,01/02/2023,91.95,1074.48
24976861,02/02/2023,190.68,1265.1599999999999
24976861,04/02/2023,-64.92,1200.24
24976861,04/02/2023,-133.05,1067.19
24976861,06/02/2023,110.9,1178.09
24976861,06/02/2023,104.1,1282.19
24976861,10/02/2023,145.54,1427.73
24976861,11/02/2023,105.42,1533.1499999999999
24976861,14/02/2023,34.07,1567.22
24999129,31/01/2023,,750.61
24999129,03/02/2023,-179.75,570.86
24999129,05/02/2023,173.68,744.54
24999129,09/02/2023,-38.13,706.41
24999129,09/02/2023,-75.79,630.62
24999129,13/02/2023,70.3,700.92
24999129,13/02/2023,-731.4,-30.480000000000018
25004339,31/01/2023,,120.44
25004339,03/02/2023,79.25,199.69
25004339,03/02/2023,-131.18,68.50999999999999
25004339,05/02/2023,102.38,170.89
25004339,05/02/2023,56.51,227.39999999999998
25004339,07/02/2023,92.13,319.53
25004339,14/02/2023,79.28,398.80999999999995
25004339,14/02/2023,-89.42,309.39
25006771,31/01/2023,,600.16
25006771,01/02/2023,2027.7,2627.86
25006771,01/02/2023,143.83,2771.69
25006771,01/02/2023,-94.29,2677.4
25006771,03/02/2023,119.1,2796.5
25006771,04/02/2023,105.81,2902.31
25006771,04/02/2023,95.64,2997.95
25006771,12/02/2023,2147.9,5145.85
25033680,31/01/2023,,639.47
25033680,01/02/2023,-615.8,23.670000000000073
25033680,02/02/2023,82.11,105.78000000000007
25033680,02/02/2023,-412.3,-306.5199999999999
25033680,07/02/2023,-78.73,-385.24999999999994
25033680,08/02/2023,-169.4,-554.6499999999999
25033680,09/02/2023,-120.08,-674.7299999999999
25033680,10/02/2023,142.57,-532.1599999999999
25099734,31/01/2023,,872.31
25099734,02/02/2023,-177.88,694.43
25099734,03/02/2023,-117.86,576.5699999999999
25099734,03/02/2023,-124.18,452.38999999999993
25099734,04/02/2023,-39.71,412.67999999999995
25099734,05/02/2023,193.92,606.5999999999999
25099734,09/02/2023,-155.22,451.37999999999994
25099734,14/02/2023,-38.18,413.19999999999993
25110012,31/01/2023,,300.03
25110012,01/02/2023,103.35,403.38
25110012,06/02/2023,-104.85,298.53
25110012,08/02/2023,-129.86,168.66999999999996
25110012,09/02/2023,6.19,174.85999999999996
25110012,09/02/2023,-118.7,56.159999999999954
25110012,13/02/2023,-53.93,2.2299999999999542
25110012,13/02/2023,-104.02,-101.79000000000005
25133996,31/01/2023,,419.22
25133996,04/02/2023,130.57,549.79
25133996,04/02/2023,-103.33,446.46000000000004
25133996,07/02/2023,-174.77,271.69
25133996,08/02/2023,-34.38,237.31
25133996,11/02/2023,107.4,344.71000000000004
25133996,12/02/2023,-68.8,275.91
25133996,14/02/2023,-42.13,233.78
25146667,31/01/2023,,534.11
25146667,01/02/2023,-830.7,-296.59000000000003
25146667,10/02/2023,99.46,-197.13000000000005
25146667,11/02/2023,41.23,-155.90000000000003
25146667,12/02/2023,105.79,-50.11000000000004
25146667,13/02/2023,229.21,179.09999999999997
25146667,14/02/2023,129.18,308.28
25146667,14/02/2023,0.73,309.01
25146667,14/02/2023,-201.77,107.23999999999995
25240031,31/01/2023,,520.29
25240031,02/02/2023,140.31,660.5999999999999
25240031,03/02/2023,125.77,786.37
25240031,08/02/2023,-57.72,728.65
25240031,09/02/2023,-175.48,553.17
25269707,31/01/2023,,770.38
25269707,04/02/2023,110.37,880.75
25269707,04/02/2023,-88.89,791.86
25269707,04/02/2023,-131.28,660.5799999999999
25269707,08/02/2023,67.93,728.51
25269707,13/02/2023,97.59,826.1
25281513,31/01/2023,,618.78
25281513,02/02/2023,78.21,696.99
25281513,05/02/2023,-99.57,597.42
25310962,31/01/2023,,376.9
25310962,01/02/2023,98.74,475.64
25310962,02/02/2023,-58.7,416.93999999999994
25310962,05/02/2023,-134.95,281.99
25310962,06/02/2023,-222.12,59.869999999999976
25318205,31/01/2023,,582.9
25318205,03/02/2023,-140.51,442.39
25318205,07/02/2023,-97.67,344.71999999999997
25318205,07/02/2023,-161.73,182.99
25318205,10/02/2023,90.09,273.08000000000004
25318205,13/02/2023,105.4,378.48
25406407,31/01/2023,,394.05
25406407,01/02/2023,56.06,450.11
25406407,03/02/2023,-158.72,291.39
25406407,05/02/2023,-226.81,64.58000000000001
25406407,06/02/2023,140.67,205.25
25406407,07/02/2023,120.62,325.87
25406407,09/02/2023,165.96,491.83000000000004
25406407,10/02/2023,-29.92,461.91
25406407,10/02/2023,-174.95,286.96000000000004
25406407,11/02/2023,66.62,353.58000000000004
25406407,11/02/2023,-218.81,134.77000000000004
25412464,31/01/2023,,203.46
25412464,02/02/2023,107.62,311.08000000000004
25412464,03/02/2023,-87.6,223.48000000000002
25412464,04/02/2023,191.64,415.12
25412464,04/02/2023,82.87,497.99
25412464,05/02/2023,-90.59,407.4
25412464,07/02/2023,96.86,504.26
25412464,09/02/2023,-38.42,465.84000000000003
25412464,13/02/2023,-106.97,358.87
25439304,31/01/2023,,890.08
25439304,01/02/2023,-126.4,763.6800000000001
25439304,05/02/2023,-159.54,604.1400000000001
25504032,31/01/2023,,838.81
25504032,02/02/2023,-89.88,748.93
25504032,02/02/2023,-147.42,601.51
25504032,06/02/2023,-133.47,468.03999999999996
25510430,31/01/2023,,110.66
25510430,03/02/2023,159.23,269.89
25510430,04/02/2023,-74.75,195.14
25510430,06/02/2023,1359.0,1554.1399999999999
25510430,06/02/2023,-79.47,1474.6699999999998
25510430,09/02/2023,145.58,1620.25
25510430,09/02/2023,-87.21,1533.04
25510430,09/02/2023,-143.27,1389.77
25510430,10/02/2023,92.86,1482.6299999999999
25510430,11/02/2023,59.3,1541.9299999999998
25522226,31/01/2023,,428.21
25522226,02/02/2023,92.61,520.8199999999999
25522226,04/02/2023,1410.9,1931.72
25522226,06/02/2023,-161.37,1770.35
25522226,07/02/2023,70.76,1841.1100000000001
25522226,10/02/2023,111.11,1952.22
25522226,11/02/2023,158.64,2110.86
25522226,11/02/2023,99.57,2210.43
25584693,31/01/2023,,793.42
25584693,06/02/2023,308.7,1102.12
25584693,06/02/2023,96.19,1198.31
25584693,07/02/2023,142.6,1340.9099999999999
25584693,08/02/2023,693.4,2034.31
25584693,09/02/2023,-184.91,1849.3999999999999
25584693,13/02/2023,193.1,2042.5
25584693,13/02/2023,145.19,2187.69
25584693,13/02/2023,-98.45,2089.24
25584693,14/02/2023,117.12,2206.36
25596483,31/01/2023,,595.87
25596483,02/02/2023,-160.62,435.25
25596483,05/02/2023,80.23,515.48
25596483,07/02/2023,171.64,687.12
25596483,10/02/2023,105.35,792.47
25628234,31/01/2023,,808.37
25628234,02/02/2023,57.66,866.03
25628234,02/02/2023,-92.36,773.67
25628234,07/02/2023,43.31,816.98
25628234,09/02/2023,68.25,885.23
25628234,09/02/2023,-159.54,725.69
25628234,12/02/2023,140.22,865.91
25628234,12/02/2023,67.6,933.51
25636885,31/01/2023,,755.58
25636885,02/02/2023,412.3,1167.88
25636885,02/02/2023,20.11,1187.99
25636885,08/02/2023,93.01,1281.0
25636885,08/02/2023,92.86,1373.8600000000001
25636885,10/02/2023,151.75,1525.6100000000001
25636885,10/02/2023,-1048.2,477.4100000000001
25636885,12/02/2023,-77.54,399.87000000000006
25636885,13/02/2023,-140.3,259.57000000000005
25677428,31/01/2023,,307.44
25677428,03/02/2023,-56.35,251.09
25677428,07/02/2023,114.28,365.37
25677428,12/02/2023,-1601.3,-1235.9299999999998
25678043,31/01/2023,,49.06
25678043,06/02/2023,-71.4,-22.340000000000003
25678043,06/02/2023,-133.66,-156.0
25678043,08/02/2023,2283.2,2127.2
25678043,10/02/2023,-34.35,2092.85
25678043,11/02/2023,-110.5,1982.35
25678043,12/02/2023,-180.46,1801.8899999999999
25678043,13/02/2023,-384.8,1417.0899999999997
25698177,31/01/2023,,923.38
25698177,03/02/2023,131.18,1054.56
25698177,04/02/2023,81.16,1135.72
25698177,04/02/2023,55.58,1191.3
25698177,04/02/2023,-124.06,1067.24
25698177,06/02/2023,1524.9,2592.1400000000003
25698177,08/02/2023,150.64,2742.78
25698177,09/02/2023,892.4,3635.1800000000003
25698177,11/02/2023,-182.11,3453.07
25698177,12/02/2023,791.8,4244.87
25698177,12/02/2023,124.17,4369.04
25710768,31/01/2023,,968.16
25737886,31/01/2023,,410.76
25737886,04/02/2023,121.97,532.73
25737886,05/02/2023,196.0,728.73
25737886,10/02/2023,196.24,924.97
25737886,11/02/2023,143.94,1068.91
25737886,11/02/2023,65.05,1133.96
25737886,11/02/2023,-122.96,1011.0
25737886,12/02/2023,107.09,1118.09
25737886,12/02/2023,-78.26,1039.83
25737886,14/02/2023,119.1,1158.93
25746852,31/01/2023,,320.7
25746852,01/02/2023,-86.44,234.26
25746852,04/02/2023,-91.22,143.04
25746852,08/02/2023,49.64,192.68
25746852,10/02/2023,-1524.4,-1331.72
25746852,12/02/2023,156.13,-1175.5900000000001
25746852,13/02/2023,77.91,-1097.68
25746852,14/02/2023,-1485.7,-2583.38
25768265,31/01/2023,,702.22
25768265,02/02/2023,-1902.2,-1199.98
25768265,06/02/2023,121.72,-1078.26
25768265,06/02/2023,-1502.6,-2580.8599999999997
25768265,08/02/2023,72.17,-2508.69
25768265,09/02/2023,113.82,-2394.87
25768265,10/02/2023,-82.0,-2476.87
25768265,14/02/2023,-145.06,-2621.93
25779398,31/01/2023,,967.13
25779398,02/02/2023,-134.24,832.89
25779398,04/02/2023,66.32,899.21
25779398,05/02/2023,-100.05,799.16
25779398,11/02/2023,1104.5,1903.6599999999999
25779398,11/02/2023,-161.33,1742.33
25787771,31/01/2023,,494.02
25787771,02/02/2023,127.28,621.3
25787771,06/02/2023,154.47,775.77
25787771,06/02/2023,143.42,919.1899999999999
25787771,07/02/2023,64.41,983.5999999999999
25787771,07/02/2023,48.04,1031.6399999999999
25787771,07/02/2023,-742.8,288.84000000000003
25787771,08/02/2023,-117.36,171.48000000000002
25787771,09/02/2023,74.98,246.46000000000004
25787771,10/02/2023,1662.6,1909.06
25787771,10/02/2023,150.3,2059.36
25787771,10/02/2023,-128.96,1930.3999999999999
25787771,11/02/2023,126.14,2056.54
25787771,13/02/2023,154.81,2211.35
25787771,13/02/2023,61.53,2272.88
25807378,31/01/2023,,25.32
25807378,04/02/2023,-120.85,-95.53
25807378,10/02/2023,51.27,-44.26
25893329,31/01/2023,,211.58
25893329,08/02/2023,-218.9,-7.319999999999993
25893329,12/02/2023,-176.03,-183.35
25931435,31/01/2023,,127.08
25931435,01/02/2023,-69.52,57.56
25931435,07/02/2023,199.86,257.42
25931435,08/02/2023,-111.03,146.39000000000001
25939481,31/01/2023,,502.59
25939481,01/02/2023,106.3,608.89
25939481,05/02/2023,-101.46,507.42999999999995
25939481,10/02/2023,52.02,559.4499999999999
25941557,31/01/2023,,656.34
25941557,01/02/2023,-61.87,594.47
25941557,01/02/2023,-818.4,-223.92999999999995
25941557,02/02/2023,34.56,-189.36999999999995
25941557,03/02/2023,-96.63,-285.99999999999994
25941557,05/02/2023,-37.99,-323.98999999999995
25941557,06/02/2023,-100.34,-424.3299999999999
25941557,08/02/2023,-130.43,-554.76
25941557,10/02/2023,175.95,-378.80999999999995
25941557,10/02/2023,69.68,-309.13
25941557,12/02/2023,1601.3,1292.17
25941557,13/02/2023,149.9,1442.07
26008806,31/01/2023,,553.23
26008806,02/02/2023,205.49,758.72
26008806,03/02/2023,105.92,864.64
26008806,05/02/2023,121.03,985.6700000000001
26008806,05/02/2023,-168.21,817.46
26008806,06/02/2023,72.35,889.8100000000001
26023976,31/01/2023,,681.17
26023976,03/02/2023,90.66,771.8299999999999
26023976,06/02/2023,885.9,1657.73
26070761,31/01/2023,,641.67
26070761,07/02/2023,1076.8,1718.4699999999998
26070761,11/02/2023,93.32,1811.79
26070761,13/02/2023,105.17,1916.96
26070761,14/02/2023,-103.89,1813.07
26087369,31/01/2023,,653.2
26087369,01/02/2023,-47.33,605.87
26087369,02/02/2023,-130.93,474.94000000000005
26087369,10/02/2023,-67.07,407.87000000000006
26087369,14/02/2023,-72.4,335.47
26101648,31/01/2023,,9.84
26101648,03/02/2023,76.87,86.71000000000001
26101648,04/02/2023,97.94,184.65
26102798,31/01/2023,,104.08
26102798,03/02/2023,-144.82,-40.739999999999995
26102798,04/02/2023,-182.66,-223.39999999999998
26102798,05/02/2023,-113.1,-336.5
26102798,07/02/2023,-162.11,-498.61
26102798,09/02/2023,-108.34,-606.95
26102798,10/02/2023,-158.38,-765.33
26102798,12/02/2023,108.99,-656.34
26102798,14/02/2023,-58.63,-714.97
26102798,14/02/2023,-63.34,-778.3100000000001
26102798,14/02/2023,-156.56,-934.87
26109213,31/01/2023,,698.97
26109213,02/02/2023,-1586.6,-887.6299999999999
26109213,05/02/2023,1315.1,427.47
26109213,05/02/2023,-26.93,400.54
26109213,06/02/2023,55.84,456.38000000000005
26109213,06/02/2023,-73.4,382.98
26109213,08/02/2023,104.18,487.16
26109213,09/02/2023,109.32,596.48
26109213,09/02/2023,-105.79,490.69
26109213,12/02/2023,81.37,572.0600000000001
26109213,13/02/2023,-193.1,378.96000000000004
26115121,31/01/2023,,466.67
26115121,03/02/2023,144.61,611.28
26115121,03/02/2023,-84.79,526.49
26115121,14/02/2023,97.12,623.61
26118463,31/01/2023,,981.0
26118463,01/02/2023,127.46,1108.46
26118463,03/02/2023,-104.95,1003.51
26118463,12/02/2023,-96.4,907.11
26248782,31/01/2023,,70.58
26248782,02/02/2023,-130.23,-59.64999999999999
26248782,06/02/2023,71.52,11.870000000000005
26248782,11/02/2023,-28.34,-16.469999999999995
26248782,13/02/2023,-138.97,-155.44
26375186,31/01/2023,,804.02
26375186,06/02/2023,168.93,972.95
26375186,06/02/2023,97.54,1070.49
26375186,06/02/2023,46.31,1116.8
26375186,06/02/2023,-154.75,962.05
26375186,07/02/2023,125.96,1088.01
26375186,08/02/2023,167.59,1255.6
26375186,10/02/2023,-73.99,1181.6100000000001
26375186,11/02/2023,-135.38,1046.23
26375186,14/02/2023,1650.9,2697.13
26432558,31/01/2023,,465.32
26432558,01/02/2023,189.07,654.39
26432558,01/02/2023,28.95,683.34
26432558,01/02/2023,27.36,710.6999999999999
26432558,01/02/2023,-32.75,677.95
26432558,03/02/2023,169.95,847.9
26432558,04/02/2023,-139.51,708.39
26432558,06/02/2023,1543.0,2251.39
26432558,06/02/2023,25.86,2277.25
26432558,07/02/2023,-1121.9,1155.3499999999997
26506201,31/01/2023,,592.7
26506201,05/02/2023,159.54,752.24
26506201,05/02/2023,-43.28,708.96
26506201,07/02/2023,135.69,844.6500000000001
26506201,09/02/2023,8.38,853.0300000000001
26506201,11/02/2023,-1215.8,-362.76999999999987
26522255,31/01/2023,,283.67
26522255,02/02/2023,-56.84,226.83
26522255,08/02/2023,-1127.1,-900.2699999999999
26522255,13/02/2023,-1085.6,-1985.87
26522255,14/02/2023,-120.06,-2105.93
26522255,14/02/2023,-129.25,-2235.18
26528251,31/01/2023,,539.97
26528251,11/02/2023,-108.59,431.38
26528251,13/02/2023,-155.36,276.02
26528251,14/02/2023,102.55,378.57
26632358,31/01/2023,,384.64
26632358,01/02/2023,182.19,566.8299999999999
26632358,01/02/2023,180.83,747.66
26632358,02/02/2023,61.7,809.36
26632358,07/02/2023,1029.9,1839.2600000000002
26632358,09/02/2023,82.99,1922.2500000000002
26632358,11/02/2023,-24.9,1897.3500000000001
26632358,13/02/2023,1487.7,3385.05
26643616,31/01/2023,,260.1
26643616,01/02/2023,90.79,350.89000000000004
26643616,01/02/2023,-137.72,213.17000000000002
26643616,05/02/2023,-160.91,52.26000000000002
26643616,09/02/2023,74.6,126.86000000000001
26643616,11/02/2023,170.89,297.75
26643616,12/02/2023,-121.86,175.89
26643616,14/02/2023,129.29,305.18
26669001,31/01/2023,,70.04
26669001,03/02/2023,56.31,126.35000000000001
26669001,03/02/2023,21.03,147.38
26669001,11/02/2023,-142.29,5.090000000000032
26669001,11/02/2023,-1318.1,-1313.0099999999998
26669001,14/02/2023,-94.21,-1407.2199999999998
26669001,14/02/2023,-634.0,-2041.2199999999998
26675311,31/01/2023,,989.13
26675311,02/02/2023,-114.88,874.25
26675311,07/02/2023,-15.66,858.59
26675311,09/02/2023,27.53,886.12
26675311,09/02/2023,-155.29,730.83
26675311,11/02/2023,-22.62,708.21
26675311,11/02/2023,-41.86,666.35
26675311,11/02/2023,-181.25,485.1
26675311,13/02/2023,-124.33,360.77000000000004
26675311,14/02/2023,-64.87,295.90000000000003
26751921,31/01/2023,,800.07
26751921,14/02/2023,132.36,932.4300000000001
26751921,14/02/2023,127.34,1059.77
26791907,31/01/2023,,266.27
26791907,01/02/2023,-126.46,139.81
26791907,09/02/2023,-624.2,-484.39000000000004
26791907,12/02/2023,79.75,-404.64000000000004
26791907,13/02/2023,-181.54,-586.1800000000001
26793058,31/01/2023,,384.98
26793058,03/02/2023,44.59,429.57000000000005
26793058,05/02/2023,20.17,449.74
26793058,06/02/2023,687.1,1136.8400000000001
26793058,08/02/2023,-70.15,1066.69
26863880,31/01/2023,,818.47
26863880,05/02/2023,-88.7,729.77
26863880,05/02/2023,-115.12,614.65
26863880,07/02/2023,-102.54,512.11
26863880,08/02/2023,946.2,1458.31
26863880,09/02/2023,-107.47,1350.8400000000001
26863880,14/02/2023,101.53,1452.3700000000001
26863880,14/02/2023,76.32,1528.69
26874415,31/01/2023,,19.62
26874415,02/02/2023,-2269.2,-2249.58
26874415,03/02/2023,-111.84,-2361.42
26874415,04/02/2023,523.6,-1837.82
26874415,04/02/2023,86.74,-1751.08
26874415,05/02/2023,121.41,-1629.6699999999998
26874415,05/02/2023,95.35,-1534.32
26874415,08/02/2023,-52.99,-1587.31
26874415,11/02/2023,99.56,-1487.75
26884718,31/01/2023,,573.65
26884718,01/02/2023,114.47,688.12
26884718,02/02/2023,482.7,1170.82
26884718,03/02/2023,-20.42,1150.3999999999999
26884718,03/02/2023,-118.63,1031.77
26884718,04/02/2023,150.38,1182.1499999999999
26884718,08/02/2023,149.83,1331.98
26884718,10/02/2023,-47.01,1284.97
26884718,11/02/2023,146.56,1431.53
26888158,31/01/2023,,473.02
26888158,02/02/2023,70.88,543.9
26888158,02/02/2023,-15.77,528.13
26888158,05/02/2023,-1022.3,-494.16999999999996
26888158,12/02/2023,179.93,-314.23999999999995
26893181,31/01/2023,,957.43
26893181,01/02/2023,116.66,1074.09
26893181,01/02/2023,-65.9,1008.1899999999999
26893181,01/02/2023,-169.18,839.01
26893181,03/02/2023,-613.0,226.01
26893181,10/02/2023,89.11,315.12
26906533,31/01/2023,,312.58
26906533,05/02/2023,104.74,417.32
26906533,05/02/2023,-58.5,358.82
26906533,07/02/2023,-34.65,324.16999999999996
26906533,08/02/2023,13.32,337.49
26906533,10/02/2023,-75.71,261.78
26906533,12/02/2023,89.48,351.26
26906533,14/02/2023,50.82,402.08
26907311,31/01/2023,,842.69
26907311,05/02/2023,103.21,945.9000000000001
26907311,05/02/2023,-1195.0,-249.0999999999999
26907311,07/02/2023,125.73,-123.3699999999999
26907311,07/02/2023,-93.19,-216.5599999999999
26907311,09/02/2023,-160.54,-377.0999999999999
26907311,10/02/2023,61.2,-315.8999999999999
26907311,13/02/2023,74.01,-241.8899999999999
26953669,31/01/2023,,813.21
26953669,01/02/2023,81.22,894.4300000000001
26953669,02/02/2023,528.9,1423.33
26953669,03/02/2023,-100.42,1322.91
26953669,09/02/2023,75.79,1398.7
26953669,11/02/2023,137.86,1536.56
26958171,31/01/2023,,837.04
26958171,02/02/2023,-116.1,720.9399999999999
26958171,05/02/2023,9.05,729.99
26958171,07/02/2023,-114.74,615.25
26958171,11/02/2023,19.24,634.49
26958171,11/02/2023,-23.0,611.49
26964507,31/01/2023,,358.72
26979446,31/01/2023,,149.65
26979446,01/02/2023,18.27,167.92000000000002
26979446,03/02/2023,214.53,382.45000000000005
26979446,07/02/2023,133.96,516.4100000000001
26979446,11/02/2023,-34.89,481.52000000000004
26979446,14/02/2023,-70.4,411.12
26985042,31/01/2023,,248.7
26985042,02/02/2023,-116.25,132.45
26985042,03/02/2023,228.59,361.03999999999996
26985042,03/02/2023,-104.82,256.22
26985042,09/02/2023,142.67,398.89
26985042,12/02/2023,-54.1,344.78999999999996
26985042,14/02/2023,124.19,468.98
27010847,31/01/2023,,272.04
27010847,01/02/2023,-249.75,22.29000000000002
27010847,02/02/2023,126.94,149.23000000000002
27010847,02/02/2023,20.72,169.95000000000002
27010847,02/02/2023,-131.53,38.420000000000016
27010847,02/02/2023,-182.71,-144.29
27010847,05/02/2023,-298.3,-442.59000000000003
27010847,07/02/2023,856.5,413.90999999999997
27010847,07/02/2023,100.4,514.31
27010847,08/02/2023,135.91,650.22
27010847,13/02/2023,-163.33,486.89
27010847,14/02/2023,133.67,620.56
27010847,14/02/2023,-97.12,523.4399999999999
27108454,31/01/2023,,423.96
27108454,02/02/2023,106.6,530.56
27108454,03/02/2023,15.35,545.91
27108454,08/02/2023,98.0,643.91
27108454,09/02/2023,1324.2,1968.1100000000001
27108454,14/02/2023,69.99,2038.1
27117946,31/01/2023,,342.03
27117946,05/02/2023,20.31,362.34
27117946,07/02/2023,-135.32,227.01999999999998
27117946,08/02/2023,137.97,364.99
27117946,13/02/2023,-91.43,273.55999999999995
27170424,31/01/2023,,211.66
27170424,04/02/2023,-150.79,60.870000000000005
27170424,09/02/2023,-111.55,-50.67999999999999
27170424,10/02/2023,140.57,89.89
27170424,10/02/2023,-835.9,-746.01
27193025,31/01/2023,,187.57
27193025,01/02/2023,54.7,242.26999999999998
27193025,03/02/2023,19.83,262.1
27193025,04/02/2023,-104.24,157.86
27193025,05/02/2023,118.39,276.25
27193025,06/02/2023,-155.37,120.88
27193025,07/02/2023,-166.29,-45.41
27193025,08/02/2023,67.49,22.08
27193025,10/02/2023,47.75,69.83
27193025,10/02/2023,44.74,114.57
27193025,11/02/2023,56.69,171.26
27193025,13/02/2023,25.57,196.82999999999998
27193470,31/01/2023,,479.57
27193470,02/02/2023,-68.41,411.15999999999997
27193470,03/02/2023,-82.41,328.75
27193470,04/02/2023,105.89,434.64
27193470,06/02/2023,1486.9,1921.54
27193470,06/02/2023,-78.77,1842.77
27193470,07/02/2023,480.0,2322.77
27193470,07/02/2023,-116.86,2205.91
27193470,08/02/2023,-117.53,2088.38
27193470,08/02/2023,-139.22,1949.1599999999999
27193470,09/02/2023,-118.46,1830.7
27193470,12/02/2023,-142.98,1687.72
27203821,31/01/2023,,256.57
27203821,03/02/2023,-866.1,-609.53
27203821,07/02/2023,1679.8,1070.2699999999998
27203821,07/02/2023,152.23,1222.4999999999998
27203821,09/02/2023,-177.2,1045.2999999999997
27264533,31/01/2023,,254.28
27264533,03/02/2023,95.29,349.57
27264533,07/02/2023,64.08,413.65
27264533,08/02/2023,85.29,498.94
27305999,31/01/2023,,17.22
27305999,03/02/2023,-117.17,-99.95
27305999,03/02/2023,-185.02,-284.97
27334998,31/01/2023,,817.28
27334998,05/02/2023,100.57,917.8499999999999
27334998,05/02/2023,-1.11,916.74
27334998,06/02/2023,99.03,1015.77
27334998,07/02/2023,-170.65,845.1199999999999
27334998,08/02/2023,-130.38,714.74
27356852,31/01/2023,,414.82
27356852,01/02/2023,160.76,575.5799999999999
27356852,01/02/2023,128.78,704.36
27356852,03/02/2023,-99.42,604.9399999999999
27356852,04/02/2023,381.6,986.54
27356852,04/02/2023,-57.96,928.58
27356852,05/02/2023,-116.94,811.64
27356852,10/02/2023,1271.5,2083.14
27356852,12/02/2023,-41.2,2041.9399999999998
27356852,12/02/2023,-118.8,1923.1399999999999
27357010,31/01/2023,,579.29
27357010,02/02/2023,-120.26,459.03
27357010,06/02/2023,90.59,549.62
27357010,06/02/2023,-90.59,459.03
27357010,09/02/2023,101.24,560.27
27357010,13/02/2023,48.01,608.28
27357010,14/02/2023,-122.47,485.80999999999995
27382109,31/01/2023,,174.95
27382109,01/02/2023,63.48,238.42999999999998
27382109,05/02/2023,-858.4,-619.97
27382109,07/02/2023,-45.83,-665.8000000000001
27382109,07/02/2023,-60.4,-726.2
27382109,07/02/2023,-136.09,-862.29
27382109,13/02/2023,1188.4,326.1100000000001
27382109,14/02/2023,-188.72,137.39000000000013
27388260,31/01/2023,,39.64
27388260,04/02/2023,137.7,177.33999999999997
27388260,07/02/2023,135.14,312.47999999999996
27388260,07/02/2023,-107.54,204.93999999999994
27388260,08/02/2023,-107.42,97.51999999999995
27388260,09/02/2023,30.61,128.12999999999994
27388260,11/02/2023,-6.54,121.58999999999995
27388260,12/02/2023,109.89,231.47999999999996
27388260,12/02/2023,49.38,280.85999999999996
27388260,14/02/2023,123.36,404.2199999999999
27389680,31/01/2023,,815.68
27389680,02/02/2023,327.6,1143.28
27389680,05/02/2023,18.13,1161.41
27389680,08/02/2023,-57.93,1103.48
27389680,08/02/2023,-156.86,946.6199999999999
27389680,14/02/2023,-82.48,864.14
27415805,31/01/2023,,902.28
27415805,02/02/2023,-94.5,807.78
27415805,03/02/2023,43.72,851.5
27415805,06/02/2023,-1107.9,-256.4000000000001
27415805,07/02/2023,36.73,-219.6700000000001
27415805,09/02/2023,125.11,-94.56000000000009
27415805,09/02/2023,-30.61,-125.17000000000009
27415805,11/02/2023,-172.32,-297.49000000000007
27430568,31/01/2023,,450.45
27430568,01/02/2023,-100.12,350.33
27430568,01/02/2023,-186.45,163.88
27430568,02/02/2023,-832.5,-668.62
27430568,03/02/2023,173.67,-494.95000000000005
27430568,03/02/2023,-107.8,-602.75
27430568,06/02/2023,91.5,-511.25
27430568,09/02/2023,230.97,-280.28000000000003
27430568,10/02/2023,86.27,-194.01000000000005
27430568,11/02/2023,-84.59,-278.6
27430568,11/02/2023,-90.65,-369.25000000000006
27430568,12/02/2023,-1025.1,-1394.35
27580272,31/01/2023,,352.81
27580272,03/02/2023,115.75,468.56
27580272,07/02/2023,91.56,560.12
27580272,09/02/2023,-64.46,495.66
27582893,31/01/2023,,639.21
27582893,02/02/2023,-98.09,541.12
27582893,03/02/2023,-129.73,411.39000000000004
27582893,03/02/2023,-146.33,265.06000000000006
27582893,05/02/2023,-105.33,159.73000000000002
27582893,14/02/2023,-66.56,93.17000000000003
27585212,31/01/2023,,150.57
27585212,03/02/2023,-101.07,49.5
27585212,08/02/2023,76.59,126.09
27589482,31/01/2023,,494.03
27589482,01/02/2023,129.54,623.5699999999999
27589482,04/02/2023,-24.15,599.42
27589482,06/02/2023,102.35,701.77
27589482,09/02/2023,-129.57,572.1999999999999
27589482,13/02/2023,14.56,586.76
27589482,13/02/2023,-81.27,505.48999999999995
27596004,31/01/2023,,505.73
27596004,01/02/2023,989.3,1495.03
27596004,01/02/2023,172.77,1667.8
27596004,01/02/2023,36.3,1704.1
27596004,06/02/2023,193.24,1897.34
27596004,09/02/2023,-88.16,1809.18
27596004,12/02/2023,-1255.7,553.48
27596004,14/02/2023,0.43,553.91
27596004,14/02/2023,-259.3,294.61
27600956,31/01/2023,,84.39
27600956,04/02/2023,33.69,118.08
27600956,05/02/2023,-104.27,13.810000000000002
27600956,08/02/2023,105.35,119.16
27600956,10/02/2023,109.1,228.26
27600956,12/02/2023,197.29,425.54999999999995
27600956,12/02/2023,16.56,442.10999999999996
27600956,12/02/2023,-1268.1,-825.99
27600956,14/02/2023,135.36,-690.63
27625709,31/01/2023,,616.45
27625709,01/02/2023,-77.61,538.84
27625709,04/02/2023,-32.88,505.96000000000004
27625709,10/02/2023,-4.42,501.54
27625709,11/02/2023,131.8,633.34
27625709,14/02/2023,128.39,761.73
27625709,14/02/2023,-153.23,608.5
27628187,31/01/2023,,344.63
27628187,02/02/2023,-109.57,235.06
27628187,02/02/2023,-148.04,87.02000000000001
27628187,03/02/2023,-127.48,-40.459999999999994
27628187,07/02/2023,87.52,47.06
27713909,31/01/2023,,199.77
27713909,02/02/2023,79.25,279.02
27713909,06/02/2023,7.07,286.09000000000003
27713909,09/02/2023,1160.0,1446.0900000000001
27806002,31/01/2023,,565.08
27806002,07/02/2023,27.75,592.83
27806002,08/02/2023,233.36,826.19
27806002,14/02/2023,-479.9,346.2900000000001
27821800,31/01/2023,,322.23
27821800,06/02/2023,-394.5,-72.26999999999998
27821800,10/02/2023,-76.32,-148.58999999999997
27821800,13/02/2023,58.62,-89.96999999999997
27821800,14/02/2023,151.02,61.05000000000004
27845045,31/01/2023,,136.91
27845045,01/02/2023,80.9,217.81
27845045,08/02/2023,117.08,334.89
27845045,14/02/2023,-130.09,204.8
27870202,31/01/2023,,286.17
27870202,03/02/2023,111.04,397.21000000000004
27870202,07/02/2023,1613.2,2010.41
27870202,08/02/2023,13.55,2023.96
27870202,11/02/2023,-17.89,2006.0700000000002
27870202,14/02/2023,99.23,2105.3
27985160,31/01/2023,,446.21
27985160,02/02/2023,-744.2,-297.99000000000007
27985160,08/02/2023,-132.6,-430.59000000000003
27985160,09/02/2023,107.22,-323.37000000000006
28053942,31/01/2023,,70.94
28053942,01/02/2023,-1821.2,-1750.26
28053942,02/02/2023,-132.84,-1883.1
28053942,05/02/2023,-119.28,-2002.38
28053942,05/02/2023,-841.2,-2843.58
28053942,06/02/2023,-75.16,-2918.7400000000002
28063272,31/01/2023,,252.41
28063272,04/02/2023,155.57,407.98
28063272,06/02/2023,202.05,610.03
28063272,07/02/2023,194.01,804.04
28063272,08/02/2023,967.3,1771.34
28063272,08/02/2023,-125.91,1645.4299999999998
28063272,09/02/2023,-105.86,1539.57
28063272,10/02/2023,149.81,1689.3799999999999
28063272,10/02/2023,-82.97,1606.4099999999999
28063272,10/02/2023,-165.63,1440.78
28063272,14/02/2023,-58.88,1381.8999999999999
28142099,31/01/2023,,420.86
28142099,10/02/2023,-1134.6,-713.7399999999999
28222331,31/01/2023,,137.74
28222331,01/02/2023,140.1,277.84000000000003
28222331,01/02/2023,102.76,380.6
28222331,04/02/2023,30.36,410.96000000000004
28222331,04/02/2023,-67.93,343.03
28222331,07/02/2023,49.81,392.84000000000003
28240243,31/01/2023,,850.7
28240243,01/02/2023,-122.07,728.6300000000001
28240243,08/02/2023,-93.01,635.62
28240243,13/02/2023,-175.32,460.30000000000007
28247818,31/01/2023,,150.24
28247818,01/02/2023,75.52,225.76
28247818,05/02/2023,65.92,291.68
28247818,07/02/2023,126.45,418.13
28247818,07/02/2023,102.9,521.03
28247818,09/02/2023,77.58,598.61
28247818,10/02/2023,-107.08,491.53000000000003
28247818,11/02/2023,65.22,556.75
28247818,11/02/2023,29.76,586.51
28247818,12/02/2023,119.93,706.44
28247818,12/02/2023,-67.6,638.84
28247818,12/02/2023,-127.0,511.84000000000003
28251857,31/01/2023,,431.6
28251857,01/02/2023,85.99,517.59
28251857,02/02/2023,1501.3,2018.8899999999999
28251857,02/02/2023,-90.38,1928.5100000000002
28251857,05/02/2023,0.49,1929.0
28251857,05/02/2023,-117.78,1811.22
28251857,06/02/2023,180.89,1992.1100000000001
28251857,10/02/2023,20.93,2013.04
28251857,10/02/2023,-104.53,1908.51
28254911,31/01/2023,,697.78
28254911,03/02/2023,-16.2,681.5799999999999
28254911,04/02/2023,888.9,1570.48
28254911,06/02/2023,165.67,1736.1499999999999
28254911,06/02/2023,-131.6,1604.55
28254911,07/02/2023,-139.63,1464.9199999999998
28254911,08/02/2023,90.88,1555.8
28254911,09/02/2023,68.62,1624.4199999999998
28254911,11/02/2023,633.2,2257.62
28254911,11/02/2023,-89.22,2168.4
28254911,11/02/2023,-122.35,2046.05
28254911,12/02/2023,92.53,2138.58
28254911,12/02/2023,-147.01,1991.57
28254911,14/02/2023,-118.38,1873.1899999999998
28362321,31/01/2023,,849.34
28362321,03/02/2023,-77.07,772.27
28362321,05/02/2023,76.11,848.38
28362321,07/02/2023,59.08,907.46
28362321,08/02/2023,44.34,951.8000000000001
28362321,10/02/2023,849.7,1801.5
28362321,10/02/2023,17.18,1818.68
28362321,10/02/2023,-69.69,1748.9900000000002
28362321,12/02/2023,-614.4,1134.5900000000001
28380949,31/01/2023,,937.24
28380949,01/02/2023,-131.58,805.66
28380949,04/02/2023,-58.38,747.28
28380949,04/02/2023,-1412.5,-665.22
28380949,05/02/2023,-141.36,-806.58
28380949,07/02/2023,17.39,-789.19
28380949,11/02/2023,573.2,-215.99
28429440,31/01/2023,,538.15
28429440,01/02/2023,-57.95,480.2
28429440,03/02/2023,-85.06,395.14
28429440,05/02/2023,-471.4,-76.25999999999999
28429440,07/02/2023,-86.22,-162.48
28429440,10/02/2023,59.31,-103.16999999999999
28429440,11/02/2023,-1096.1,-1199.27
28429440,12/02/2023,180.17,-1019.1
28548067,31/01/2023,,499.29
28548067,03/02/2023,32.08,531.37
28548067,05/02/2023,100.87,632.24
28548067,12/02/2023,36.02,668.26
28553155,31/01/2023,,147.09
28553155,01/02/2023,-131.36,15.72999999999999
28553155,03/02/2023,-106.67,-90.94000000000001
28553155,05/02/2023,134.95,44.00999999999998
28553155,08/02/2023,124.98,168.98999999999998
28553155,09/02/2023,102.41,271.4
28553155,10/02/2023,-76.15,195.24999999999997
28553155,13/02/2023,-14.56,180.68999999999997
28553155,14/02/2023,112.72,293.40999999999997
28572979,31/01/2023,,156.38
28572979,02/02/2023,130.23,286.61
28572979,02/02/2023,-190.92,95.69
28572979,04/02/2023,1026.7,1122.39
28572979,06/02/2023,-210.36,912.0300000000001
28572979,09/02/2023,-48.05,863.9800000000001
28572979,11/02/2023,-168.92,695.0600000000002
28572979,12/02/2023,66.4,761.4600000000002
28595197,31/01/2023,,897.68
28595197,02/02/2023,68.18,965.8599999999999
28595197,03/02/2023,108.32,1074.1799999999998
28595197,04/02/2023,-809.4,264.78
28595197,06/02/2023,-34.09,230.68999999999997
28595197,07/02/2023,-993.9,-763.21
28595197,09/02/2023,-1606.6,-2369.81
28606808,31/01/2023,,1.71
28606808,02/02/2023,-41.88,-40.17
28606808,07/02/2023,-59.08,-99.25
28606808,07/02/2023,-71.01,-170.26
28606808,08/02/2023,957.8,787.54
28606808,09/02/2023,-139.7,647.8399999999999
28629966,31/01/2023,,60.86
28629966,02/02/2023,52.11,112.97
28629966,03/02/2023,-55.02,57.949999999999996
28629966,04/02/2023,72.49,130.44
28629966,04/02/2023,8.63,139.07
28629966,05/02/2023,108.31,247.38
28629966,07/02/2023,-186.23,61.14999999999998
28629966,09/02/2023,103.88,165.02999999999997
28629966,11/02/2023,-59.3,105.72999999999998
28629966,12/02/2023,98.2,203.92999999999998
28629966,13/02/2023,126.46,330.39
28629966,13/02/2023,-148.89,181.5
28640713,31/01/2023,,204.33
28640713,01/02/2023,-53.43,150.9
28640713,03/02/2023,-111.46,39.440000000000026
28640713,05/02/2023,-128.65,-89.20999999999998
28640713,06/02/2023,157.18,67.97000000000003
28640713,06/02/2023,93.75,161.72000000000003
28640713,06/02/2023,27.94,189.66000000000003
28640713,06/02/2023,-97.36,92.30000000000003
28640713,07/02/2023,9.52,101.82000000000002
28640713,09/02/2023,-86.0,15.820000000000022
28640713,13/02/2023,-117.35,-101.52999999999997
28652960,31/01/2023,,140.6
28652960,04/02/2023,134.34,274.94
28652960,04/02/2023,129.92,404.86
28652960,06/02/2023,-91.86,313.0
28652960,09/02/2023,214.76,527.76
28652960,09/02/2023,-116.34,411.41999999999996
28652960,10/02/2023,197.72,609.14
28652960,10/02/2023,-30.02,579.12
28652960,11/02/2023,130.89,710.01
28652960,12/02/2023,66.67,776.68
28652960,13/02/2023,96.41,873.0899999999999
28652960,13/02/2023,-89.23,783.8599999999999
28659160,31/01/2023,,115.6
28659160,01/02/2023,-172.77,-57.170000000000016
28659160,02/02/2023,-327.6,-384.77000000000004
28659160,06/02/2023,-134.68,-519.45
28659160,07/02/2023,98.93,-420.52000000000004
28680375,31/01/2023,,337.2
28680375,02/02/2023,84.65,421.85
28680375,13/02/2023,-25.85,396.0
28680375,13/02/2023,-152.92,243.08
28680375,14/02/2023,-106.21,136.87
28696496,31/01/2023,,150.57
28696496,02/02/2023,58.23,208.79999999999998
28696496,08/02/2023,-120.55,88.25
28696496,09/02/2023,82.54,170.79000000000002
28696496,13/02/2023,-93.53,77.26
28696496,13/02/2023,-123.86,-46.599999999999994
28696496,14/02/2023,148.05,101.45000000000002
28738041,31/01/2023,,907.31
28738041,02/02/2023,-48.35,858.9599999999999
28738041,07/02/2023,1806.9,2665.86
28738041,09/02/2023,96.94,2762.8
28738041,11/02/2023,190.18,2952.98
28738041,12/02/2023,-66.05,2886.9300000000003
28738041,13/02/2023,-56.68,2830.25
28738041,14/02/2023,-69.79,2760.46
28743137,31/01/2023,,781.13
28743137,02/02/2023,-118.55,662.58
28743137,13/02/2023,111.36,773.94
28743137,13/02/2023,-64.85,709.09
28745450,31/01/2023,,157.38
28745450,01/02/2023,163.82,321.2
28745450,06/02/2023,-77.81,243.39
28745450,09/02/2023,113.5,356.89
28745450,09/02/2023,47.96,404.84999999999997
28745450,12/02/2023,-180.44,224.41
28754062,31/01/2023,,16.41
28781155,31/01/2023,,555.55
28781155,02/02/2023,99.34,654.89
28781155,06/02/2023,105.25,760.14
28781155,10/02/2023,-67.41,692.73
28781155,11/02/2023,34.81,727.54
28781155,11/02/2023,-109.94,617.5999999999999
28811285,31/01/2023,,813.63
28811285,03/02/2023,-227.05,586.5799999999999
28811285,04/02/2023,-86.15,500.42999999999995
28811285,08/02/2023,-110.78,389.65
28811285,12/02/2023,1534.6,1924.25
28819175,31/01/2023,,414.48
28819175,01/02/2023,-44.29,370.19
28819175,02/02/2023,20.57,390.76
28819175,03/02/2023,63.29,454.05
28819175,06/02/2023,-178.95,275.1
28819175,09/02/2023,-91.82,183.28000000000003
28819175,09/02/2023,-363.8,-180.51999999999998
28819175,11/02/2023,-155.49,-336.01
28822117,31/01/2023,,204.79
28822117,01/02/2023,-98.74,106.05
28822117,05/02/2023,1022.3,1128.35
28822117,07/02/2023,-43.86,1084.49
28909144,31/01/2023,,263.97
28909144,04/02/2023,32.88,296.85
28909144,04/02/2023,32.51,329.36
28909144,05/02/2023,-66.8,262.56000000000006
28909144,08/02/2023,165.79,428.35
28909144,14/02/2023,-30.0,398.35
28911002,31/01/2023,,858.06
28911002,01/02/2023,1139.7,1997.76
28911002,02/02/2023,-137.03,1860.73
28911002,06/02/2023,-122.69,1738.04
28911002,11/02/2023,50.13,1788.17
28911002,11/02/2023,-75.03,1713.1399999999999
28969443,31/01/2023,,12.77
28969443,07/02/2023,-485.9,-473.13
28969443,08/02/2023,-79.06,-552.19
28969443,09/02/2023,29.71,-522.48
28969443,14/02/2023,-111.2,-633.6800000000001
28976546,31/01/2023,,454.25
28976546,01/02/2023,-128.83,325.41999999999996
28976546,05/02/2023,59.2,384.62
28976546,06/02/2023,-71.54,313.08
28976546,09/02/2023,-48.6,264.47999999999996
29000698,31/01/2023,,954.02
29000698,06/02/2023,-97.54,856.48
29000698,07/02/2023,44.98,901.4599999999999
29000698,11/02/2023,16.59,918.05
29000698,12/02/2023,191.61,1109.66
29017229,31/01/2023,,950.07
29017229,02/02/2023,95.2,1045.27
29017229,03/02/2023,179.54,1224.81
29017229,03/02/2023,-183.44,1041.3700000000001
29017229,04/02/2023,1246.9,2288.2700000000004
29017229,06/02/2023,-189.84,2098.4300000000003
29017229,14/02/2023,71.88,2170.3100000000004
29039134,31/01/2023,,218.26
29039134,05/02/2023,115.1,333.36
29039134,08/02/2023,245.8,579.16
29039134,11/02/2023,82.76,661.92
29039134,12/02/2023,1411.1,2073.02
29039134,12/02/2023,97.82,2170.84
29039134,14/02/2023,558.8,2729.64
29039134,14/02/2023,104.64,2834.2799999999997
29043142,31/01/2023,,210.89
29043142,09/02/2023,-110.51,100.37999999999998
29043142,11/02/2023,-114.61,-14.230000000000018
29043142,12/02/2023,67.25,53.01999999999998
29043142,12/02/2023,-141.01,-87.99000000000001
29052260,31/01/2023,,639.05
29052260,03/02/2023,132.95,772.0
29052260,05/02/2023,89.52,861.52
29052260,10/02/2023,117.25,978.77
29061354,31/01/2023,,180.47
29061354,05/02/2023,2.25,182.72
29061354,07/02/2023,92.81,275.53
29061354,11/02/2023,667.1,942.63
29061354,11/02/2023,-54.28,888.35
29074095,31/01/2023,,512.38
29074095,01/02/2023,86.91,599.29
29074095,02/02/2023,-924.0,-324.71000000000004
29074095,07/02/2023,-164.85,-489.56000000000006
29074095,11/02/2023,-87.14,-576.7
29074095,12/02/2023,-110.14,-686.84
29074095,13/02/2023,184.92,-501.9200000000001
29074095,13/02/2023,-65.54,-567.46
29222005,31/01/2023,,0.34
29222005,03/02/2023,98.53,98.87
29222005,05/02/2023,-109.63,-10.759999999999991
29222005,05/02/2023,-119.42,-130.18
29222005,07/02/2023,80.36,-49.81999999999999
29222005,12/02/2023,94.0,44.18000000000001
29238925,31/01/2023,,574.82
29238925,04/02/2023,2.44,577.2600000000001
29238925,09/02/2023,47.07,624.33
29238925,11/02/2023,-887.8,-263.4699999999999
29238925,14/02/2023,-956.2,-1219.67
29288598,31/01/2023,,386.76
29288598,03/02/2023,201.14,587.9
29288598,04/02/2023,-84.15,503.75
29288598,06/02/2023,74.62,578.37
29288598,07/02/2023,109.13,687.5
29288598,08/02/2023,265.04,952.54
29288598,11/02/2023,-142.47,810.0699999999999
29288598,13/02/2023,-137.35,672.72
29288598,14/02/2023,1295.6,1968.32
29288598,14/02/2023,143.6,2111.92
29303323,31/01/2023,,525.6
29303323,02/02/2023,-103.75,421.85
29303323,02/02/2023,-143.82,278.03000000000003
29303323,03/02/2023,136.61,414.64000000000004
29303323,04/02/2023,136.51,551.1500000000001
29303323,09/02/2023,1301.5,1852.65
29303323,09/02/2023,-142.5,1710.15
29303323,13/02/2023,185.87,1896.02
29303323,13/02/2023,126.86,2022.88
29358670,31/01/2023,,874.94
29358670,01/02/2023,92.86,967.8000000000001
29358670,06/02/2023,173.92,1141.72
29358670,08/02/2023,-50.38,1091.34
29358670,08/02/2023,-120.57,970.77
29358670,09/02/2023,105.57,1076.3400000000001
29358670,09/02/2023,-83.38,992.96
29358670,11/02/2023,121.51,1114.47
29358670,11/02/2023,86.69,1201.16
29358670,12/02/2023,-1183.8,17.360000000000127
29358670,13/02/2023,-56.85,-39.489999999999874
29422349,31/01/2023,,623.61
29422349,08/02/2023,91.11,714.72
29422349,10/02/2023,144.27,858.99
29422349,13/02/2023,-145.83,713.16
29464742,31/01/2023,,557.11
29464742,02/02/2023,86.31,643.4200000000001
29464742,07/02/2023,211.77,855.19
29464742,08/02/2023,-92.83,762.36
29464742,14/02/2023,-147.24,615.12
29473763,31/01/2023,,724.82
29473763,05/02/2023,-80.66,644.1600000000001
29473763,08/02/2023,144.06,788.22
29473763,14/02/2023,-141.21,647.01
29489865,31/01/2023,,854.53
29489865,03/02/2023,-109.66,744.87
29489865,06/02/2023,114.3,859.17
29489865,10/02/2023,-169.47,689.7
29489865,11/02/2023,29.25,718.95
29489865,11/02/2023,-82.38,636.5699999999999
29489865,14/02/2023,122.97,759.54
29523226,31/01/2023,,807.56
29523226,01/02/2023,102.6,910.16
29523226,03/02/2023,68.85,979.01
29523226,03/02/2023,-48.79,930.2199999999999
29523226,05/02/2023,191.47,1121.69
29523226,05/02/2023,-73.99,1047.7
29523226,05/02/2023,-90.06,957.64
29523226,06/02/2023,58.71,1016.3499999999999
29523226,06/02/2023,-134.96,881.3899999999999
29523226,08/02/2023,-83.33,798.06
29523226,09/02/2023,254.92,1052.98
29523226,10/02/2023,-83.94,969.04
29523226,13/02/2023,63.08,1032.12
29523226,13/02/2023,25.85,1057.9699999999998
29527534,31/01/2023,,355.57
29527534,03/02/2023,-122.97,232.6
29527534,04/02/2023,99.39,331.99
29527534,10/02/2023,-148.63,183.36
29527534,11/02/2023,86.28,269.64
29608056,31/01/2023,,248.43
29608056,03/02/2023,61.91,310.34000000000003
29608056,03/02/2023,-105.92,204.42000000000002
29608056,06/02/2023,86.9,291.32
29608056,06/02/2023,-115.19,176.13
29608056,07/02/2023,-1610.4,-1434.27
29608056,11/02/2023,-131.8,-1566.07
29608056,12/02/2023,134.36,-1431.71
29608056,12/02/2023,126.97,-1304.74
29608056,12/02/2023,96.87,-1207.87
29608056,12/02/2023,51.66,-1156.21
29631870,31/01/2023,,694.99
29631870,02/02/2023,1138.0,1832.99
29631870,02/02/2023,78.61,1911.6
29631870,04/02/2023,68.54,1980.14
29631870,04/02/2023,-74.21,1905.93
29631870,12/02/2023,113.45,2019.38
29631870,14/02/2023,-90.07,1929.31
29638033,31/01/2023,,537.95
29638033,01/02/2023,-129.52,408.43000000000006
29638033,01/02/2023,-1775.6,-1367.1699999999998
29638033,02/02/2023,-1890.0,-3257.17
29638033,03/02/2023,-103.79,-3360.96
29638033,08/02/2023,-40.08,-3401.04
29638033,11/02/2023,-89.5,-3490.54
29638033,12/02/2023,122.32,-3368.22
29638033,14/02/2023,-134.42,-3502.64
29639626,31/01/2023,,985.7
29639626,04/02/2023,-112.65,873.0500000000001
29639626,05/02/2023,135.88,1008.9300000000001
29639626,06/02/2023,-58.79,950.14
29639626,10/02/2023,103.67,1053.81
29639626,10/02/2023,-15.25,1038.56
29639626,13/02/2023,41.85,1080.41
29639626,13/02/2023,-163.71,916.7
29705419,31/01/2023,,799.07
29705419,02/02/2023,89.88,888.95
29705419,03/02/2023,62.89,951.84
29705419,03/02/2023,-749.7,202.14
29705419,06/02/2023,149.08,351.22
29705419,08/02/2023,133.54,484.76
29705419,09/02/2023,-99.59,385.16999999999996
29705419,13/02/2023,-105.96,279.21
29878790,31/01/2023,,360.74
29878790,13/02/2023,-94.19,266.55
29887258,31/01/2023,,392.91
29887258,05/02/2023,103.8,496.71000000000004
29887258,08/02/2023,-17.63,479.08000000000004
29887258,13/02/2023,-157.09,321.99
29887258,14/02/2023,175.07,497.06
29887258,14/02/2023,122.47,619.53
29920698,31/01/2023,,922.07
29920698,02/02/2023,-108.09,813.98
29920698,04/02/2023,47.33,861.3100000000001
29920698,04/02/2023,45.53,906.84
29920698,05/02/2023,-1475.4,-568.5600000000001
29920698,08/02/2023,77.84,-490.72
29920698,13/02/2023,86.2,-404.52000000000004
29958061,31/01/2023,,17.43
29958061,01/02/2023,93.28,110.71000000000001
29958061,02/02/2023,103.39,214.10000000000002
29958061,02/02/2023,-28.3,185.8
29958061,03/02/2023,167.61,353.41
29958061,04/02/2023,115.56,468.97
29958061,07/02/2023,183.11,652.08
29958061,08/02/2023,-104.32,547.76
29958061,12/02/2023,614.4,1162.16
30030650,31/01/2023,,414.27
30030650,06/02/2023,96.15,510.41999999999996
30030650,07/02/2023,-99.74,410.68
30030650,08/02/2023,140.45,551.13
30030650,08/02/2023,79.57,630.7
30030650,13/02/2023,-23.8,606.9
30058030,31/01/2023,,39.21
30058030,02/02/2023,-68.18,-28.970000000000006
30058030,03/02/2023,106.54,77.57
30058030,12/02/2023,89.64,167.21
30058030,12/02/2023,37.7,204.91000000000003
30058030,14/02/2023,69.27,274.18
30058030,14/02/2023,-823.0,-548.8199999999999
30093672,31/01/2023,,939.77
30093672,04/02/2023,121.83,1061.6
30093672,05/02/2023,62.74,1124.34
30093672,06/02/2023,34.09,1158.43
30093672,06/02/2023,-79.32,1079.11
30093672,08/02/2023,-1002.0,77.11000000000001
30093672,09/02/2023,7.12,84.23000000000002
30093672,10/02/2023,-142.07,-57.839999999999975
30093672,11/02/2023,108.41,50.57000000000002
30093672,12/02/2023,-129.0,-78.42999999999998
30110747,31/01/2023,,949.76
30110747,01/02/2023,98.39,1048.15
30110747,03/02/2023,-158.58,889.5699999999999
30110747,03/02/2023,-225.89,663.6800000000001
30110747,06/02/2023,70.1,733.78
30110747,07/02/2023,69.34,803.12
30110747,10/02/2023,-37.83,765.29
30110747,13/02/2023,143.14,908.4300000000001
30112323,31/01/2023,,519.73
30112323,01/02/2023,99.68,619.4100000000001
30112323,01/02/2023,38.91,658.32
30112323,01/02/2023,-12.31,646.01
30112323,04/02/2023,-136.46,509.55
30112323,07/02/2023,-27.47,482.08000000000004
30112323,08/02/2023,-1379.8,-897.7199999999999
30112323,09/02/2023,1504.7,606.9800000000001
30112323,14/02/2023,-117.3,489.6800000000001
30196319,31/01/2023,,721.4
30196319,01/02/2023,-32.39,689.01
30196319,06/02/2023,125.2,814.21
30196319,09/02/2023,-118.21,696.0
30196319,10/02/2023,-95.98,600.02
30227774,31/01/2023,,546.85
30227774,01/02/2023,-99.3,447.55
30227774,05/02/2023,46.86,494.41
30227774,09/02/2023,89.75,584.1600000000001
30227774,11/02/2023,-146.03,438.13
30235398,31/01/2023,,973.95
30235398,02/02/2023,54.94,1028.89
30235398,02/02/2023,-122.38,906.51
30235398,13/02/2023,-63.08,843.4300000000001
30237685,31/01/2023,,751.93
30237685,06/02/2023,-189.18,562.75
30237685,10/02/2023,831.4,1394.1499999999999
30237685,12/02/2023,95.25,1489.3999999999999
30279114,31/01/2023,,951.13
30279114,01/02/2023,144.31,1095.44
30279114,02/02/2023,-231.9,863.54
30279114,08/02/2023,-66.97,796.5699999999999
30279114,09/02/2023,-210.8,585.77
30312615,31/01/2023,,659.36
30312615,05/02/2023,-1852.7,-1193.3400000000001
30312615,06/02/2023,77.23,-1116.11
30312615,07/02/2023,-116.04,-1232.1499999999999
30312615,12/02/2023,443.1,-789.05
30312615,12/02/2023,-158.57,-947.6199999999999
30312615,13/02/2023,-136.9,-1084.52
30324819,31/01/2023,,823.45
30324819,02/02/2023,469.3,1292.75
30324819,03/02/2023,157.15,1449.9
30324819,05/02/2023,-130.7,1319.2
30324819,05/02/2023,-141.51,1177.69
30340808,31/01/2023,,895.41
30340808,03/02/2023,-123.39,772.02
30340808,06/02/2023,-64.83,707.1899999999999
30340808,07/02/2023,-121.9,585.29
30340808,14/02/2023,-1660.2,-1074.91
30372316,31/01/2023,,189.39
30372316,02/02/2023,-179.4,9.98999999999998
30372316,08/02/2023,151.99,161.98
30372316,08/02/2023,-78.98,82.99999999999999
30372316,09/02/2023,1216.6,1299.6
30372316,09/02/2023,-953.9,345.69999999999993
30372316,11/02/2023,40.81,386.50999999999993
30372316,13/02/2023,-102.23,284.2799999999999
30372316,14/02/2023,-0.43,283.8499999999999
30374840,31/01/2023,,564.42
30374840,03/02/2023,-96.42,467.99999999999994
30374840,03/02/2023,-1278.2,-810.2
30374840,07/02/2023,204.81,-605.3900000000001
30374840,07/02/2023,143.62,-461.77000000000004
30374840,08/02/2023,107.7,-354.07000000000005
30374840,08/02/2023,-38.13,-392.20000000000005
30374840,10/02/2023,-1585.0,-1977.2
30396291,31/01/2023,,803.37
30396291,03/02/2023,199.09,1002.46
30396291,03/02/2023,-610.8,391.6600000000001
30396291,06/02/2023,-99.42,292.24000000000007
30396291,06/02/2023,-100.05,192.19000000000008
30409599,31/01/2023,,117.47
30409599,03/02/2023,174.62,292.09000000000003
30409599,05/02/2023,51.26,343.35
30409599,07/02/2023,180.63,523.98
30409599,08/02/2023,109.72,633.7
30409599,10/02/2023,-28.25,605.45
30409599,14/02/2023,867.5,1472.95
30428666,31/01/2023,,393.33
30428666,04/02/2023,-150.02,243.30999999999997
30428666,05/02/2023,-29.05,214.25999999999996
30428666,07/02/2023,-66.67,147.58999999999997
30428666,11/02/2023,40.71,188.29999999999998
30484027,31/01/2023,,272.71
30484027,01/02/2023,127.65,400.36
30484027,03/02/2023,-116.69,283.66999999999996
30484027,05/02/2023,78.67,362.34
30484027,09/02/2023,-10.45,351.89
30484027,12/02/2023,-76.6,275.28999999999996
30484027,12/02/2023,-127.83,147.45999999999998
30511779,31/01/2023,,772.02
30511779,02/02/2023,179.94,951.96
30511779,07/02/2023,71.18,1023.14
30511779,08/02/2023,106.87,1130.01
30511779,10/02/2023,67.41,1197.42
30511779,11/02/2023,114.77,1312.19
30511779,11/02/2023,58.01,1370.2
30518350,31/01/2023,,490.85
30518350,06/02/2023,1498.3,1989.15
30518350,11/02/2023,-19.24,1969.9099999999999
30557885,31/01/2023,,615.82
30557885,05/02/2023,-678.7,-62.879999999999995
30565855,31/01/2023,,982.05
30565855,05/02/2023,1292.8,2274.85
30565855,09/02/2023,-51.68,2223.17
30565855,11/02/2023,-121.33,2101.84
30565855,13/02/2023,70.54,2172.38
30565855,14/02/2023,483.2,2655.58
30623117,31/01/2023,,266.92
30623117,04/02/2023,-125.73,141.19
30623117,09/02/2023,-1169.4,-1028.21
30623117,11/02/2023,-38.74,-1066.95
30623117,11/02/2023,-111.11,-1178.06
30623117,14/02/2023,154.58,-1023.48
30623117,14/02/2023,77.33,-946.15
30623117,14/02/2023,-159.03,-1105.18
30647433,31/01/2023,,632.2
30647433,02/02/2023,-224.91,407.2900000000001
30647433,03/02/2023,-474.7,-67.40999999999997
30647433,04/02/2023,-15.32,-82.72999999999996
30647433,05/02/2023,-100.81,-183.53999999999996
30647433,07/02/2023,80.19,-103.34999999999997
30647433,07/02/2023,-39.09,-142.43999999999997
30647433,10/02/2023,104.39,-38.04999999999997
30657838,31/01/2023,,468.82
30657838,01/02/2023,2239.3,2708.1200000000003
30657838,01/02/2023,-91.95,2616.1700000000005
30657838,03/02/2023,-139.16,2477.01
30657838,04/02/2023,124.06,2601.07
30657838,05/02/2023,539.8,3140.8700000000003
30657838,05/02/2023,-161.8,2979.07
30657838,06/02/2023,90.98,3070.05
30657838,06/02/2023,-52.94,3017.11
30657838,08/02/2023,84.11,3101.2200000000003
30657838,09/02/2023,69.33,3170.55
30657838,11/02/2023,152.76,3323.3100000000004
30671754,31/01/2023,,621.9
30671754,04/02/2023,-133.3,488.59999999999997
30671754,07/02/2023,5.07,493.66999999999996
30672740,31/01/2023,,355.33
30672740,02/02/2023,187.4,542.73
30672740,06/02/2023,126.49,669.22
30672740,07/02/2023,46.51,715.73
30672740,11/02/2023,1949.6,2665.33
30672740,13/02/2023,-106.6,2558.73
30688447,31/01/2023,,555.31
30688447,03/02/2023,-137.98,417.3299999999999
30688447,05/02/2023,-160.67,256.65999999999997
30688447,06/02/2023,81.99,338.65
30688447,10/02/2023,-162.32,176.32999999999998
30688447,14/02/2023,-101.76,74.56999999999998
30718836,31/01/2023,,360.78
30718836,01/02/2023,186.89,547.67
30718836,01/02/2023,-76.9,470.77
30718836,03/02/2023,-133.1,337.66999999999996
30718836,04/02/2023,58.09,395.76
30718836,06/02/2023,-110.26,285.49999999999994
30718836,07/02/2023,-16.27,269.22999999999996
30718836,08/02/2023,-1127.4,-858.1700000000001
30718836,09/02/2023,51.68,-806.4900000000001
30718836,11/02/2023,64.55,-741.94
30718836,13/02/2023,-75.16,-817.1000000000001
30723991,31/01/2023,,310.02
30723991,02/02/2023,86.69,396.71
30723991,03/02/2023,138.68,535.39
30723991,07/02/2023,-95.78,439.61
30758515,31/01/2023,,35.74
30758515,01/02/2023,102.39,138.13
30758515,02/02/2023,61.09,199.22000000000003
30758515,13/02/2023,183.43,382.65000000000003
30760024,31/01/2023,,766.43
30760024,02/02/2023,-77.14,689.29
30760024,03/02/2023,-38.61,650.68
30760024,09/02/2023,83.26,733.9399999999999
30791105,31/01/2023,,272.5
30791105,02/02/2023,192.77,465.27
30791105,04/02/2023,-113.62,351.65
30791105,06/02/2023,102.01,453.66
30791105,06/02/2023,-112.33,341.33000000000004
30791105,10/02/2023,179.95,521.28
30791105,11/02/2023,107.01,628.29
30929422,31/01/2023,,161.53
30929422,01/02/2023,-120.93,40.599999999999994
30929422,01/02/2023,-159.64,-119.03999999999999
30929422,07/02/2023,82.91,-36.129999999999995
30929422,08/02/2023,-23.59,-59.72
30929422,08/02/2023,-113.42,-173.14
30929422,11/02/2023,-38.37,-211.51
30929422,12/02/2023,-76.48,-287.99
30929422,13/02/2023,-113.91,-401.9
30970897,31/01/2023,,57.17
30970897,01/02/2023,-141.6,-84.42999999999999
30970897,03/02/2023,-110.54,-194.97
30970897,03/02/2023,-115.62,-310.59000000000003
30970897,04/02/2023,-116.66,-427.25
30970897,05/02/2023,201.75,-225.5
30970897,07/02/2023,-141.27,-366.77
30970897,09/02/2023,-113.36,-480.13
30970897,09/02/2023,-157.3,-637.4300000000001
30970897,12/02/2023,27.9,-609.53
30970897,13/02/2023,100.5,-509.03
30977834,31/01/2023,,203.99
30977834,02/02/2023,175.73,379.72
30977834,04/02/2023,686.5,1066.22
30977834,04/02/2023,-175.99,890.23
30977834,05/02/2023,-35.3,854.9300000000001
30977834,07/02/2023,-86.46,768.47
30977834,07/02/2023,-87.82,680.6500000000001
30977834,10/02/2023,67.29,747.94
30977834,12/02/2023,45.23,793.1700000000001
30979429,31/01/2023,,414.1
30979429,01/02/2023,-70.34,343.76
30979429,02/02/2023,-865.4,-521.64
30979429,03/02/2023,866.1,344.46000000000004
30979429,05/02/2023,104.27,448.73
30979429,09/02/2023,-160.06,288.67
30979429,11/02/2023,35.07,323.74
30979429,12/02/2023,-78.65,245.09
30990911,31/01/2023,,997.59
30990911,02/02/2023,-144.05,853.54
30990911,04/02/2023,170.56,1024.1
30990911,04/02/2023,-173.9,850.2
30990911,07/02/2023,-124.86,725.34
30990911,08/02/2023,132.2,857.54
30990911,11/02/2023,-106.4,751.14
31026801,31/01/2023,,85.36
31026801,01/02/2023,52.99,138.35
31026801,06/02/2023,-99.14,39.21000000000001
31026801,07/02/2023,-102.26,-63.05
31026801,08/02/2023,-47.58,-110.63
31026801,11/02/2023,-62.33,-172.95999999999998
31131351,31/01/2023,,278.94
31131351,04/02/2023,786.1,1065.04
31131351,04/02/2023,262.0,1327.04
31131351,04/02/2023,98.42,1425.46
31131351,06/02/2023,29.95,1455.41
31131351,06/02/2023,-1124.1,331.3100000000002
31131351,08/02/2023,104.01,435.32000000000016
31131351,09/02/2023,-158.52,276.8000000000002
31131351,12/02/2023,-224.14,52.660000000000196
31150830,31/01/2023,,36.16
31150830,01/02/2023,-161.85,-125.69
31150830,02/02/2023,128.71,3.0200000000000102
31150830,02/02/2023,126.12,129.14000000000001
31150830,05/02/2023,-61.68,67.46000000000001
31150830,06/02/2023,52.31,119.77000000000001
31150830,07/02/2023,-435.8,-316.03
31150830,09/02/2023,-55.88,-371.91
31150830,09/02/2023,-70.29,-442.20000000000005
31150830,11/02/2023,-84.45,-526.6500000000001
31158381,31/01/2023,,514.96
31158381,01/02/2023,223.94,738.9000000000001
31158381,01/02/2023,139.18,878.08
31158381,07/02/2023,80.94,959.02
31158381,08/02/2023,-132.45,826.57
31158381,13/02/2023,-131.36,695.21
31183587,31/01/2023,,725.0
31183587,02/02/2023,-36.32,688.68
31183587,03/02/2023,-19.31,669.37
31183587,05/02/2023,1152.5,1821.87
31183587,08/02/2023,-952.0,869.8699999999999
31183587,12/02/2023,221.72,1091.59
31183587,12/02/2023,112.63,1204.2199999999998
31183587,13/02/2023,-76.49,1127.7299999999998
31183587,13/02/2023,-117.77,1009.9599999999999
31187024,31/01/2023,,950.41
31187024,02/02/2023,-105.52,844.89
31187024,03/02/2023,-49.39,795.5
31187024,04/02/2023,-125.25,670.25
31187024,06/02/2023,154.42,824.67
31187024,08/02/2023,71.81,896.48
31187024,08/02/2023,-537.9,358.5799999999999
31187024,10/02/2023,782.2,1140.78
31187024,10/02/2023,-163.18,977.5999999999999
31263913,31/01/2023,,267.5
31263913,01/02/2023,-48.78,218.72
31263913,02/02/2023,-133.38,85.34
31263913,06/02/2023,84.46,169.8
31319183,31/01/2023,,407.92
31319183,06/02/2023,-95.11,312.81
31319183,08/02/2023,58.82,371.63
31319183,09/02/2023,-151.22,220.41000000000003
31319183,10/02/2023,60.41,280.82000000000005
31319183,12/02/2023,104.9,385.72
31319183,12/02/2023,-63.33,322.39000000000004
31319183,13/02/2023,126.66,449.05
31335654,31/01/2023,,217.33
31335654,02/02/2023,125.99,343.32
31335654,07/02/2023,146.82,490.14
31335654,10/02/2023,88.62,578.76
31335654,10/02/2023,87.63,666.39
31335654,12/02/2023,1192.7,1859.0900000000001
31367758,31/01/2023,,536.16
31367758,01/02/2023,89.01,625.17
31367758,08/02/2023,96.58,721.75
31367758,10/02/2023,835.9,1557.65
31367758,13/02/2023,107.55,1665.2
31392168,31/01/2023,,615.42
31392168,05/02/2023,-177.67,437.75
31392168,08/02/2023,170.98,608.73
31392168,10/02/2023,143.84,752.5699999999999
31392168,13/02/2023,44.2,796.77
31525756,31/01/2023,,363.68
31525756,01/02/2023,81.02,444.7
31525756,07/02/2023,146.76,591.46
31525756,12/02/2023,-128.32,463.14
31525756,13/02/2023,-41.85,421.28999999999996
31525756,13/02/2023,-75.56,345.73
31537778,31/01/2023,,335.19
31537778,01/02/2023,-36.43,298.76
31537778,14/02/2023,118.75,417.51
31541158,31/01/2023,,215.94
31541158,07/02/2023,-107.79,108.14999999999999
31541158,09/02/2023,120.47,228.62
31541158,09/02/2023,73.6,302.21999999999997
31541158,13/02/2023,-110.17,192.04999999999998
31557275,31/01/2023,,362.05
31557275,02/02/2023,-162.35,199.70000000000002
31557275,05/02/2023,-63.32,136.38000000000002
31557275,09/02/2023,86.86,223.24
31557275,11/02/2023,-166.3,56.94
31557275,14/02/2023,59.81,116.75
31589468,31/01/2023,,713.44
31589468,01/02/2023,-78.07,635.3700000000001
31589468,01/02/2023,-807.2,-171.82999999999993
31589468,03/02/2023,117.46,-54.36999999999993
31589468,10/02/2023,142.13,87.76000000000006
31589468,14/02/2023,-77.69,10.070000000000064
31594938,31/01/2023,,486.88
31594938,02/02/2023,-72.9,413.98
31594938,02/02/2023,-206.91,207.07
31594938,03/02/2023,49.54,256.61
31594938,05/02/2023,230.5,487.11
31594938,06/02/2023,-77.22,409.89
31594938,06/02/2023,-131.96,277.92999999999995
31594938,10/02/2023,-47.87,230.05999999999997
31594938,14/02/2023,-90.86,139.2
31595213,31/01/2023,,418.35
31595213,02/02/2023,184.44,602.79
31595213,03/02/2023,-110.43,492.36
31595213,04/02/2023,128.21,620.57
31595213,10/02/2023,80.77,701.34
31595213,12/02/2023,-122.61,578.73
31595213,14/02/2023,172.38,751.11
31661113,31/01/2023,,309.32
31661113,02/02/2023,68.17,377.49
31661113,10/02/2023,102.92,480.40999999999997
31661113,10/02/2023,11.31,491.71999999999997
31661113,13/02/2023,16.59,508.31
31670977,31/01/2023,,385.42
31670977,02/02/2023,-1520.8,-1135.3799999999999
31670977,04/02/2023,133.3,-1002.0799999999999
31670977,08/02/2023,10.05,-992.0299999999999
31670977,14/02/2023,-87.61,-1079.6399999999999
31680976,31/01/2023,,327.79
31680976,01/02/2023,-82.09,245.70000000000002
31680976,05/02/2023,-65.73,179.97000000000003
31680976,06/02/2023,470.6,650.57
31680976,08/02/2023,362.6,1013.1700000000001
31680976,10/02/2023,-69.68,943.49
31680976,10/02/2023,-115.98,827.5100000000001
31680976,11/02/2023,-1125.0,-297.4899999999999
31680976,14/02/2023,149.9,-147.5899999999999
31689747,31/01/2023,,907.21
31689747,01/02/2023,104.57,1011.78
31689747,02/02/2023,-177.5,834.28
31689747,04/02/2023,89.19,923.47
31689747,04/02/2023,19.13,942.6
31689747,04/02/2023,-41.77,900.83
31689747,06/02/2023,-101.84,798.99
31689747,07/02/2023,-107.26,691.73
31689747,09/02/2023,171.71,863.44
31693244,31/01/2023,,311.41
31693244,02/02/2023,-145.85,165.56000000000003
31693244,03/02/2023,49.16,214.72000000000003
31693244,08/02/2023,-96.95,117.77000000000002
31693244,08/02/2023,-710.3,-592.53
31693244,10/02/2023,81.43,-511.09999999999997
31693244,13/02/2023,-126.46,-637.56
31693244,13/02/2023,-155.44,-793.0
31693244,14/02/2023,-73.36,-866.3599999999999
31759645,31/01/2023,,43.92
31759645,01/02/2023,162.02,205.94
31759645,02/02/2023,-482.7,-276.75999999999993
31759645,04/02/2023,-104.15,-380.90999999999997
31759645,06/02/2023,123.09,-257.81999999999994
31759645,06/02/2023,57.88,-199.93999999999994
31759645,07/02/2023,-169.21,-369.15
31759645,08/02/2023,79.06,-290.0899999999999
31759645,08/02/2023,-163.97,-454.05999999999995
31759645,09/02/2023,-33.72,-487.78
31759645,09/02/2023,-110.83,-598.6099999999999
31759645,10/02/2023,-150.77,-749.3799999999999
31770323,31/01/2023,,666.66
31770323,07/02/2023,-74.35,592.31
31770323,07/02/2023,-1002.5,-410.19000000000005
31770323,11/02/2023,60.05,-350.14000000000004
31770323,12/02/2023,147.45,-202.69000000000005
31770323,12/02/2023,73.94,-128.75000000000006
31770323,13/02/2023,109.06,-19.690000000000055
31770323,13/02/2023,-181.51,-201.20000000000005
31774984,31/01/2023,,964.57
31774984,01/02/2023,127.57,1092.14
31774984,04/02/2023,121.49,1213.63
31774984,08/02/2023,164.7,1378.33
31774984,09/02/2023,127.38,1505.71
31774984,09/02/2023,-139.86,1365.85
31774984,11/02/2023,139.2,1505.05
31826534,31/01/2023,,541.64
31826534,02/02/2023,-95.44,446.2
31826534,07/02/2023,155.12,601.3199999999999
31826534,10/02/2023,-104.86,496.46
31826534,11/02/2023,-85.0,411.46
31826534,14/02/2023,615.6,1027.06
31830289,31/01/2023,,816.55
31830289,01/02/2023,44.29,860.8399999999999
31830289,06/02/2023,-154.47,706.3699999999999
31830289,14/02/2023,201.77,908.14
31873155,31/01/2023,,351.03
31873155,02/02/2023,27.44,378.46999999999997
31873155,02/02/2023,-123.2,255.26999999999998
31873155,04/02/2023,214.78,470.04999999999995
31873155,06/02/2023,-107.54,362.50999999999993
31873155,08/02/2023,-176.94,185.56999999999994
31873155,11/02/2023,111.88,297.44999999999993
31873155,12/02/2023,-9.9,287.54999999999995
31957459,31/01/2023,,758.69
31957459,01/02/2023,98.52,857.21
31957459,03/02/2023,89.23,946.44
31957459,03/02/2023,67.03,1013.47
31957459,03/02/2023,-113.46,900.0100000000001
31957459,06/02/2023,-104.66,795.35
31957459,08/02/2023,10.58,805.9300000000001
31957459,08/02/2023,-92.54,713.3900000000001
31957459,10/02/2023,-97.29,616.1
31978646,31/01/2023,,393.51
31978646,05/02/2023,-172.62,220.89
31978646,06/02/2023,189.18,410.07
31978646,09/02/2023,-50.02,360.05
31978646,10/02/2023,89.99,450.03999999999996
31978646,11/02/2023,112.56,562.6
32019304,31/01/2023,,961.49
32019304,01/02/2023,156.79,1118.28
32019304,01/02/2023,-200.4,917.88
32019304,02/02/2023,109.57,1027.45
32019304,08/02/2023,83.96,1111.41
32019304,10/02/2023,32.99,1144.4
32019304,11/02/2023,-109.66,1034.74
32019304,13/02/2023,98.9,1133.6399999999999
32084810,31/01/2023,,610.7
32084810,02/02/2023,-167.22,443.48
32084810,03/02/2023,-124.8,318.68000000000006
32084810,05/02/2023,-23.02,295.66
32084810,06/02/2023,-16.67,278.99000000000007
32084810,08/02/2023,-67.6,211.39000000000004
32084810,12/02/2023,-67.02,144.37000000000006
32092491,31/01/2023,,51.82
32092491,01/02/2023,126.01,177.83
32092491,02/02/2023,101.15,278.98
32092491,03/02/2023,48.48,327.46
32092491,07/02/2023,186.23,513.69
32092491,09/02/2023,65.15,578.84
32092491,10/02/2023,400.1,978.94
32092491,14/02/2023,-137.92,841.0200000000001
32092491,14/02/2023,-349.1,491.9200000000001
32092491,14/02/2023,-1401.8,-909.8799999999999
32109414,31/01/2023,,967.31
32109414,01/02/2023,116.27,1083.58
32109414,05/02/2023,-119.48,964.0999999999999
32109414,12/02/2023,62.68,1026.78
32109414,13/02/2023,-109.06,917.7199999999999
32131123,31/01/2023,,758.69
32131123,04/02/2023,16.51,775.2
32131123,10/02/2023,-96.17,679.0300000000001
32131123,11/02/2023,-132.94,546.09
32192958,31/01/2023,,209.37
32192958,02/02/2023,157.41,366.78
32192958,05/02/2023,1625.6,1992.3799999999999
32192958,05/02/2023,-139.75,1852.6299999999999
32192958,07/02/2023,43.86,1896.4899999999998
32192958,11/02/2023,148.04,2044.5299999999997
32192958,13/02/2023,-52.19,1992.34
32192958,13/02/2023,-1132.5,859.8399999999999
32221529,31/01/2023,,887.75
32221529,06/02/2023,120.6,1008.35
32221529,06/02/2023,114.11,1122.46
32221529,07/02/2023,120.64,1243.1
32221529,08/02/2023,-48.19,1194.91
32221529,10/02/2023,108.57,1303.48
32221529,11/02/2023,45.67,1349.15
32221529,13/02/2023,102.23,1451.38
32221529,13/02/2023,-70.3,1381.08
32221652,31/01/2023,,36.96
32221652,01/02/2023,-1089.6,-1052.6399999999999
32221652,01/02/2023,-1820.3,-2872.9399999999996
32221652,06/02/2023,32.37,-2840.5699999999997
32221652,06/02/2023,-92.29,-2932.8599999999997
32221652,07/02/2023,591.2,-2341.66
32221652,08/02/2023,-178.49,-2520.1499999999996
32261620,31/01/2023,,55.43
32261620,01/02/2023,787.2,842.63
32261620,02/02/2023,179.4,1022.03
32261620,02/02/2023,91.97,1114.0
32261620,03/02/2023,126.64,1240.64
32261620,11/02/2023,143.78,1384.42
32261620,13/02/2023,-151.84,1232.58
32261620,13/02/2023,-157.9,1074.68
32275676,31/01/2023,,889.61
32275676,03/02/2023,70.29,959.9
32275676,07/02/2023,-173.35,786.55
32275676,09/02/2023,119.17,905.72
32275676,14/02/2023,70.03,975.75
32308270,31/01/2023,,976.53
32308270,03/02/2023,139.16,1115.69
32308270,05/02/2023,-62.56,1053.1299999999999
32308270,09/02/2023,11.67,1064.8
32308270,09/02/2023,-1060.0,4.7999999999999545
32312381,31/01/2023,,742.85
32312381,01/02/2023,-96.77,646.08
32312381,11/02/2023,134.09,780.1700000000001
32312410,31/01/2023,,817.47
32312410,04/02/2023,-89.58,727.89
32370392,31/01/2023,,369.09
32370392,04/02/2023,67.93,437.02
32370392,05/02/2023,167.18,604.2
32370392,06/02/2023,64.83,669.03
32370392,10/02/2023,-133.46,535.5699999999999
32370392,12/02/2023,-71.93,463.64
32386770,31/01/2023,,639.45
32386770,01/02/2023,-56.55,582.9000000000001
32386770,02/02/2023,101.46,684.36
32386770,03/02/2023,716.6,1400.96
32386770,03/02/2023,-3.65,1397.31
32386770,05/02/2023,1131.8,2529.1099999999997
32386770,06/02/2023,72.25,2601.3599999999997
32386770,07/02/2023,118.34,2719.7
32386770,07/02/2023,-51.11,2668.5899999999997
32386770,11/02/2023,178.01,2846.6
32386770,14/02/2023,134.52,2981.12
32390015,31/01/2023,,529.35
32390015,02/02/2023,-147.44,381.91
32390015,04/02/2023,-117.79,264.12
32390015,07/02/2023,-83.34,180.78000000000003
32390015,08/02/2023,-96.43,84.35000000000001
32390015,09/02/2023,157.13,241.48000000000002
32390015,12/02/2023,88.41,329.89
32390015,13/02/2023,-80.09,249.8
32390015,13/02/2023,-173.36,76.44
32390015,14/02/2023,137.37,213.81
32400822,31/01/2023,,987.34
32400822,08/02/2023,-1808.4,-821.0600000000001
32400822,12/02/2023,183.41,-637.6500000000001
32400822,14/02/2023,-136.49,-774.1400000000001
32408166,31/01/2023,,261.63
32408166,01/02/2023,-65.12,196.51
32408166,01/02/2023,-670.1,-473.59000000000003
32408166,02/02/2023,62.78,-410.81000000000006
32408166,05/02/2023,81.05,-329.76000000000005
32408166,05/02/2023,-113.82,-443.58000000000004
32408166,06/02/2023,-122.96,-566.54
32408166,11/02/2023,173.97,-392.57000000000005
32408166,13/02/2023,82.89,-309.68
32424424,31/01/2023,,848.04
32424424,06/02/2023,1751.6,2599.64
32424424,07/02/2023,155.69,2755.33
32424424,08/02/2023,-53.13,2702.2
32424424,08/02/2023,-106.62,2595.58
32424424,12/02/2023,-160.33,2435.25
32424424,13/02/2023,91.78,2527.0299999999997
32474004,31/01/2023,,509.41
32474004,05/02/2023,-78.96,430.45000000000005
32474004,06/02/2023,-116.91,313.54
32474004,08/02/2023,4.84,318.38000000000005
32474004,09/02/2023,106.38,424.76000000000005
32476086,31/01/2023,,67.66
32476086,06/02/2023,55.3,122.96
32476086,09/02/2023,115.75,238.70999999999998
32476086,10/02/2023,137.56,376.27
32476086,12/02/2023,127.6,503.87
32476086,14/02/2023,908.4,1412.27
32597705,31/01/2023,,869.89
32597705,03/02/2023,-125.04,744.85
32597705,03/02/2023,-172.24,572.6099999999999
32597705,06/02/2023,-76.6,496.01
32597705,08/02/2023,175.42,671.43
32597705,12/02/2023,-90.34,581.0899999999999
32597705,13/02/2023,-111.43,469.65999999999997
32641357,31/01/2023,,12.39
32641357,03/02/2023,-16.93,-4.539999999999999
32641357,04/02/2023,119.25,114.71000000000001
32641357,04/02/2023,-94.62,20.090000000000003
32641357,08/02/2023,-693.0,-672.91
32641357,09/02/2023,-46.37,-719.28
32679915,31/01/2023,,841.31
32679915,02/02/2023,-161.91,679.4
32679915,03/02/2023,-109.86,569.54
32679915,06/02/2023,154.3,723.8399999999999
32737909,31/01/2023,,744.1
32737909,01/02/2023,99.52,843.62
32737909,02/02/2023,140.27,983.8900000000001
32737909,03/02/2023,37.02,1020.9100000000001
32737909,04/02/2023,53.51,1074.42
32737909,07/02/2023,-57.25,1017.1700000000001
32737909,09/02/2023,112.93,1130.1000000000001
32737909,10/02/2023,57.63,1187.73
32737909,13/02/2023,-375.1,812.6300000000001
32803222,31/01/2023,,827.92
32803222,01/02/2023,-80.92,747.0
32803222,10/02/2023,63.87,810.87
32803222,11/02/2023,142.41,953.28
32803222,12/02/2023,9.9,963.18
32803222,13/02/2023,96.06,1059.24
32803222,14/02/2023,56.66,1115.8999999999999
32824719,31/01/2023,,502.37
32824719,01/02/2023,-9.8,492.57
32824719,10/02/2023,179.1,671.67
32824719,11/02/2023,-110.41,561.26
32888555,31/01/2023,,781.33
32888555,03/02/2023,76.11,857.44
32888555,05/02/2023,-74.16,783.2800000000001
32888555,06/02/2023,1161.4,1944.6800000000003
32888555,06/02/2023,-96.15,1848.5300000000002
32888555,09/02/2023,-179.26,1669.2700000000002
32888555,11/02/2023,-42.9,1626.3700000000003
32888555,12/02/2023,169.36,1795.7300000000002
32888555,14/02/2023,207.36,2003.0900000000004
32930305,31/01/2023,,49.71
32930305,05/02/2023,151.29,201.0
32930305,08/02/2023,-209.73,-8.72999999999999
32930305,11/02/2023,73.61,64.88000000000001
32930305,12/02/2023,-183.73,-118.84999999999998
32934183,31/01/2023,,917.81
32934183,03/02/2023,-886.3,31.50999999999999
32934183,07/02/2023,-65.97,-34.46000000000001
32934183,11/02/2023,55.38,20.919999999999995
32973728,31/01/2023,,321.03
32973728,06/02/2023,54.71,375.73999999999995
32973728,08/02/2023,-104.18,271.55999999999995
32973728,13/02/2023,131.36,402.91999999999996
32991596,31/01/2023,,755.92
32991596,01/02/2023,166.48,922.4
32991596,05/02/2023,65.54,987.9399999999999
32991596,07/02/2023,162.11,1150.05
32991596,09/02/2023,118.82,1268.87
32991596,11/02/2023,1851.4,3120.27
32991596,11/02/2023,-147.54,2972.73
32991596,11/02/2023,-158.64,2814.09
33014501,31/01/2023,,454.35
33014501,03/02/2023,-68.85,385.5
33014501,03/02/2023,-84.12,301.38
33014501,04/02/2023,129.64,431.02
33014501,04/02/2023,85.27,516.29
33014501,05/02/2023,-80.26,436.03
33014501,09/02/2023,77.66,513.69
33014501,13/02/2023,152.83,666.52
33014501,13/02/2023,-135.78,530.74
33112628,31/01/2023,,879.2
33112628,02/02/2023,196.6,1075.8
33112628,04/02/2023,245.23,1321.03
33112628,05/02/2023,133.1,1454.13
33112628,06/02/2023,-75.81,1378.32
33112628,10/02/2023,99.53,1477.85
33112628,11/02/2023,-123.24,1354.6100000000001
33112628,12/02/2023,84.07,1438.68
33112628,13/02/2023,117.35,1556.03
33116647,31/01/2023,,391.76
33116647,04/02/2023,68.44,460.2
33116647,05/02/2023,-60.9,399.3
33116647,06/02/2023,-136.49,262.80999999999995
33116647,06/02/2023,-1095.4,-832.5900000000001
33116647,09/02/2023,78.1,-754.4900000000001
33116647,09/02/2023,-58.09,-812.5800000000002
33116647,13/02/2023,31.07,-781.5100000000001
33116647,14/02/2023,-60.92,-842.4300000000002
33159039,31/01/2023,,100.51
33159039,01/02/2023,-240.2,-139.69
33159039,05/02/2023,-126.51,-266.2
33159039,05/02/2023,-143.3,-409.5
33159039,12/02/2023,-94.36,-503.86
33168725,31/01/2023,,211.44
33168725,01/02/2023,88.65,300.09000000000003
33168725,03/02/2023,-110.05,190.04000000000002
33168725,04/02/2023,-262.0,-71.95999999999998
33168725,10/02/2023,-99.53,-171.48999999999998
33168725,14/02/2023,-123.42,-294.90999999999997
33173974,31/01/2023,,94.47
33173974,02/02/2023,88.57,183.04
33173974,04/02/2023,51.84,234.88
33173974,05/02/2023,-106.32,128.56
33173974,06/02/2023,-98.92,29.64
33173974,07/02/2023,134.59,164.23000000000002
33173974,08/02/2023,-160.1,4.1299999999999955
33173974,10/02/2023,162.36,166.49
33173974,13/02/2023,69.55,236.04000000000002
33173974,13/02/2023,-201.95,34.09000000000003
33202593,31/01/2023,,329.25
33202593,09/02/2023,-191.29,137.96
33240853,31/01/2023,,985.46
33240853,01/02/2023,-120.69,864.77
33240853,07/02/2023,1429.1,2293.87
33240853,09/02/2023,-938.3,1355.57
33240853,11/02/2023,1318.1,2673.67
33240853,13/02/2023,86.25,2759.92
33240853,14/02/2023,-77.21,2682.71
33259781,31/01/2023,,923.18
33259781,01/02/2023,-93.43,829.75
33259781,05/02/2023,65.57,895.3199999999999
33259781,07/02/2023,66.88,962.1999999999999
33259781,08/02/2023,-149.64,812.56
33259781,09/02/2023,912.8,1725.36
33259781,10/02/2023,-150.39,1574.9699999999998
33259781,12/02/2023,841.7,2416.67
33259781,12/02/2023,93.57,2510.24
33259781,14/02/2023,66.29,2576.5299999999997
33259781,14/02/2023,-87.23,2489.3
33270307,31/01/2023,,38.51
33270307,02/02/2023,-120.61,-82.1
33270307,04/02/2023,32.62,-49.48000000000001
33270307,06/02/2023,-116.99,-166.47
33270307,12/02/2023,110.81,-55.66000000000001
33270307,14/02/2023,1376.0,1320.34
33348876,31/01/2023,,267.33
33348876,02/02/2023,-40.94,226.39
33348876,05/02/2023,60.35,286.74
33348876,07/02/2023,111.26,398.0
33348876,07/02/2023,99.21,497.21
33348876,08/02/2023,-217.58,279.63
33348876,09/02/2023,-153.45,126.18
33351056,31/01/2023,,597.06
33351056,02/02/2023,-142.28,454.78
33351056,03/02/2023,769.3,1224.08
33351056,03/02/2023,208.28,1432.36
33351056,03/02/2023,179.13,1611.49
33351056,07/02/2023,90.26,1701.75
33351056,10/02/2023,-89.98,1611.77
33351056,13/02/2023,84.2,1695.97
33381880,31/01/2023,,682.27
33381880,04/02/2023,58.31,740.5799999999999
33381880,04/02/2023,-97.06,643.52
33381880,07/02/2023,75.46,718.98
33381880,08/02/2023,-168.29,550.69
33381880,11/02/2023,-172.57,378.12
33381880,12/02/2023,131.34,509.46000000000004
33381880,14/02/2023,73.4,582.86
33403100,31/01/2023,,270.23
33403100,11/02/2023,-110.28,159.95000000000002
33414190,31/01/2023,,204.38
33414190,04/02/2023,63.54,267.92
33414190,07/02/2023,-29.79,238.13
33414190,11/02/2023,60.37,298.5
33414190,13/02/2023,-150.38,148.12
33424425,31/01/2023,,23.18
33424425,01/02/2023,-54.7,-31.520000000000003
33424425,02/02/2023,108.46,76.94
33424425,04/02/2023,578.6,655.54
33424425,04/02/2023,45.45,700.9900000000001
33424425,07/02/2023,-39.59,661.4000000000001
33424425,13/02/2023,76.04,737.44
33470885,31/01/2023,,531.96
33470885,02/02/2023,181.56,713.52
33470885,03/02/2023,-75.66,637.86
33470885,03/02/2023,-107.9,529.96
33470885,05/02/2023,-70.44,459.52000000000004
33470885,07/02/2023,1676.4,2135.92
33470885,12/02/2023,-1071.4,1064.52
33470885,13/02/2023,61.95,1126.47
33470885,14/02/2023,145.06,1271.53
33505838,31/01/2023,,76.39
33505838,05/02/2023,54.53,130.92000000000002
33505838,06/02/2023,135.81,266.73
33505838,07/02/2023,-73.26,193.47000000000003
33505838,07/02/2023,-77.96,115.51000000000002
33505838,08/02/2023,87.34,202.85000000000002
33505838,14/02/2023,-93.12,109.73000000000002
33527603,31/01/2023,,413.42
33527603,10/02/2023,-123.66,289.76
33527603,10/02/2023,-504.8,-215.03999999999996
33527603,11/02/2023,-95.27,-310.30999999999995
33527603,12/02/2023,94.05,-216.25999999999996
33527603,13/02/2023,1154.7,938.44
33527759,31/01/2023,,245.55
33527759,06/02/2023,-100.9,144.65
33527759,11/02/2023,-792.4,-647.75
33561341,31/01/2023,,749.16
33561341,01/02/2023,102.31,851.47
33561341,05/02/2023,17.25,868.72
33561341,09/02/2023,114.45,983.17
33632099,31/01/2023,,943.81
33632099,04/02/2023,-1398.7,-454.8900000000001
33632099,05/02/2023,-34.76,-489.6500000000001
33632099,10/02/2023,88.72,-400.93000000000006
33632099,10/02/2023,-83.51,-484.4400000000001
33632099,11/02/2023,1991.3,1506.86
33632099,12/02/2023,1955.6,3462.46
33632099,13/02/2023,54.59,3517.0499999999997
33632099,13/02/2023,-1370.1,2146.95
33632099,14/02/2023,-57.83,2089.12
33634912,31/01/2023,,888.99
33634912,02/02/2023,-49.76,839.23
33634912,04/02/2023,26.48,865.71
33634912,04/02/2023,-109.08,756.63
33634912,06/02/2023,11.61,768.24
33634912,10/02/2023,-141.06,627.1800000000001
33634912,13/02/2023,61.34,688.52
33634912,13/02/2023,-118.83,569.69
33634912,13/02/2023,-151.76,417.93
33634912,14/02/2023,-163.34,254.59
33749113,31/01/2023,,590.37
33749113,03/02/2023,-144.98,445.39
33749113,05/02/2023,-102.17,343.22
33749113,07/02/2023,-122.02,221.20000000000002
33749113,12/02/2023,126.93,348.13
33749113,12/02/2023,-122.81,225.32000000000002
33749812,31/01/2023,,121.02
33749812,02/02/2023,50.83,171.85
33749812,03/02/2023,-78.92,92.92999999999999
33749812,04/02/2023,-39.76,53.169999999999995
33749812,04/02/2023,-957.5,-904.33
33749812,05/02/2023,110.07,-794.26
33749812,06/02/2023,100.8,-693.46
33750944,31/01/2023,,100.44
33750944,05/02/2023,-138.66,-38.22
33750944,14/02/2023,120.83,82.61
33771855,31/01/2023,,886.78
33771855,01/02/2023,153.65,1040.43
33771855,01/02/2023,-527.1,513.3299999999999
33771855,05/02/2023,-230.5,282.8299999999999
33771855,09/02/2023,26.32,309.1499999999999
33771855,11/02/2023,-203.67,105.47999999999993
33771855,13/02/2023,45.56,151.03999999999994
33806253,31/01/2023,,847.44
33806253,01/02/2023,151.18,998.6200000000001
33806253,05/02/2023,-144.63,853.99
33806253,06/02/2023,-110.47,743.5200000000001
33806253,09/02/2023,-87.02,656.5000000000001
33806253,10/02/2023,139.76,796.26
33832864,31/01/2023,,46.85
33832864,02/02/2023,-109.28,-62.43
33832864,03/02/2023,-128.62,-191.05
33832864,06/02/2023,-1743.5,-1934.55
33832864,13/02/2023,123.05,-1811.5
33906740,31/01/2023,,820.46
33906740,01/02/2023,-67.52,752.94
33906740,02/02/2023,-701.1,51.84000000000003
33906740,04/02/2023,-46.49,5.35000000000003
33906740,04/02/2023,-62.69,-57.33999999999997
33906740,10/02/2023,-747.3,-804.6399999999999
33906740,11/02/2023,105.46,-699.1799999999998
33906740,12/02/2023,-24.74,-723.9199999999998
33906740,14/02/2023,147.38,-576.5399999999998
33914941,31/01/2023,,665.9
33914941,01/02/2023,-160.48,505.41999999999996
33914941,03/02/2023,-105.07,400.35
33914941,05/02/2023,-142.97,257.38
33914941,06/02/2023,-54.05,203.32999999999998
33915504,31/01/2023,,742.98
33915504,07/02/2023,134.62,877.6
33915504,10/02/2023,-712.2,165.39999999999998
33915504,11/02/2023,1136.3,1301.6999999999998
33915504,11/02/2023,-78.32,1223.38
33915504,12/02/2023,-108.16,1115.22
33915504,13/02/2023,124.44,1239.66
33915504,14/02/2023,-50.82,1188.8400000000001
33915504,14/02/2023,-2237.0,-1048.1599999999999
33967237,31/01/2023,,324.8
33967237,01/02/2023,142.15,466.95000000000005
33967237,03/02/2023,152.86,619.8100000000001
33967237,04/02/2023,108.21,728.02
33967237,04/02/2023,-87.08,640.94
33967237,07/02/2023,53.6,694.5400000000001
33967237,13/02/2023,-65.9,628.64
33967237,14/02/2023,-66.68,561.96
34017695,31/01/2023,,672.46
34017695,01/02/2023,79.2,751.6600000000001
34017695,04/02/2023,-73.93,677.73
34017695,05/02/2023,-36.56,641.1700000000001
34017695,07/02/2023,-218.5,422.67
34017695,08/02/2023,-67.49,355.18
34017695,13/02/2023,148.43,503.61
34017695,13/02/2023,-144.46,359.15
34017695,13/02/2023,-1756.0,-1396.85
34017695,14/02/2023,150.24,-1246.61
34017695,14/02/2023,-2002.7,-3249.31
34027487,31/01/2023,,54.87
34027487,02/02/2023,-56.02,-1.1500000000000057
34027487,07/02/2023,-192.3,-193.45000000000002
34027487,10/02/2023,123.94,-69.51000000000002
34027487,11/02/2023,-43.17,-112.68000000000002
34027487,12/02/2023,57.16,-55.520000000000024
34027487,13/02/2023,144.25,88.72999999999998
34027487,14/02/2023,101.1,189.82999999999998
34112514,31/01/2023,,974.1
34112514,12/02/2023,-123.24,850.86
34128127,31/01/2023,,275.83
34128127,01/02/2023,88.1,363.92999999999995
34128127,05/02/2023,841.2,1205.13
34128127,05/02/2023,136.6,1341.73
34128127,10/02/2023,15.25,1356.98
34128127,11/02/2023,-45.02,1311.96
34158235,31/01/2023,,50.76
34158235,02/02/2023,95.52,146.28
34158235,03/02/2023,-85.48,60.79999999999998
34158235,05/02/2023,65.82,126.61999999999998
34158235,06/02/2023,132.93,259.54999999999995
34158235,07/02/2023,-43.24,216.30999999999997
34158235,08/02/2023,-80.16,136.14999999999998
34158235,10/02/2023,-81.26,54.88999999999997
34158235,13/02/2023,-156.49,-101.60000000000004
34158235,14/02/2023,-159.08,-260.68000000000006
34158235,14/02/2023,-439.8,-700.48
34190086,31/01/2023,,890.87
34190086,01/02/2023,65.9,956.77
34190086,08/02/2023,-144.06,812.71
34190086,13/02/2023,69.63,882.34
34190086,13/02/2023,-73.96,808.38
34190086,14/02/2023,25.45,833.83
34252525,31/01/2023,,107.18
34252525,02/02/2023,-95.27,11.91000000000001
34252525,04/02/2023,113.49,125.4
34252525,04/02/2023,-244.13,-118.72999999999999
34252525,07/02/2023,82.79,-35.93999999999998
34252525,08/02/2023,-85.07,-121.00999999999998
34252525,13/02/2023,1503.4,1382.39
34264499,31/01/2023,,864.86
34264499,08/02/2023,105.97,970.83
34264499,09/02/2023,898.1,1868.93
34264499,09/02/2023,135.68,2004.6100000000001
34264499,09/02/2023,25.95,2030.5600000000002
34264499,12/02/2023,-77.9,1952.66
34264499,13/02/2023,76.07,2028.73
34264499,14/02/2023,72.4,2101.13
34275044,31/01/2023,,532.29
34275044,07/02/2023,79.84,612.13
34275044,08/02/2023,144.26,756.39
34275044,10/02/2023,91.66,848.05
34275044,11/02/2023,109.94,957.99
34275044,13/02/2023,-156.89,801.0999999999999
34284479,31/01/2023,,74.46
34284479,04/02/2023,-25.74,48.72
34284479,05/02/2023,155.64,204.35999999999999
34284479,08/02/2023,-66.05,138.31
34284479,08/02/2023,-203.1,-64.79000000000002
34284479,10/02/2023,63.76,-1.0300000000000225
34284479,12/02/2023,122.48,121.44999999999999
34336001,31/01/2023,,396.75
34336001,01/02/2023,-48.39,348.36
34336001,06/02/2023,133.66,482.02
34336001,08/02/2023,186.34,668.36
34336001,12/02/2023,-71.39,596.97
34336001,14/02/2023,72.93,669.9
34336001,14/02/2023,-89.16,580.74
34351752,31/01/2023,,30.31
34351752,02/02/2023,-12.65,17.659999999999997
34351752,02/02/2023,-27.52,-9.86
34351752,05/02/2023,-227.66,-237.51999999999998
34374766,31/01/2023,,916.09
34374766,01/02/2023,131.53,1047.6200000000001
34374766,03/02/2023,749.7,1797.3200000000002
34374766,06/02/2023,-138.24,1659.08
34374766,08/02/2023,968.8,2627.88
34374766,08/02/2023,-233.36,2394.52
34374766,10/02/2023,-68.91,2325.61
34374766,14/02/2023,13.43,2339.04
34400277,31/01/2023,,207.59
34400277,01/02/2023,-1393.7,-1186.1100000000001
34400277,03/02/2023,68.13,-1117.98
34400277,04/02/2023,150.45,-967.5300000000002
34400277,04/02/2023,76.66,-890.8700000000001
34400277,05/02/2023,6.72,-884.1500000000001
34400277,06/02/2023,688.5,-195.6500000000001
34400277,10/02/2023,-54.78,-250.4300000000001
34400277,14/02/2023,113.52,-136.91000000000008
34400277,14/02/2023,-86.17,-223.0800000000001
34403979,31/01/2023,,101.14
34403979,01/02/2023,181.06,282.2
34403979,02/02/2023,-98.37,183.82999999999998
34403979,04/02/2023,77.37,261.2
34403979,07/02/2023,-210.28,50.91999999999999
34403979,11/02/2023,42.47,93.38999999999999
34403979,12/02/2023,-1201.1,-1107.71
34403979,14/02/2023,85.41,-1022.3000000000001
34461285,31/01/2023,,149.82
34461285,04/02/2023,83.73,233.55
34461285,06/02/2023,121.6,355.15
34461285,10/02/2023,-109.1,246.05
34461285,11/02/2023,143.15,389.2
34461285,11/02/2023,-128.1,261.1
34461285,13/02/2023,82.99,344.09
34482885,31/01/2023,,359.84
34482885,05/02/2023,-161.46,198.37999999999997
34482885,08/02/2023,358.9,557.28
34482885,08/02/2023,-175.42,381.86
34482885,11/02/2023,1161.1,1542.96
34482885,14/02/2023,-90.48,1452.48
34650969,31/01/2023,,177.82
34650969,05/02/2023,-116.94,60.879999999999995
34650969,06/02/2023,-995.2,-934.32
34650969,08/02/2023,69.02,-865.3000000000001
34650969,10/02/2023,-63.76,-929.0600000000001
34681193,31/01/2023,,183.13
34681193,01/02/2023,-216.49,-33.360000000000014
34681193,04/02/2023,67.01,33.64999999999999
34681193,06/02/2023,133.12,166.76999999999998
34681193,07/02/2023,-124.56,42.20999999999998
34681193,09/02/2023,73.98,116.18999999999998
34681193,13/02/2023,-115.5,0.6899999999999835
34866268,31/01/2023,,516.92
34866268,03/02/2023,-178.47,338.44999999999993
34866268,12/02/2023,1261.7,1600.15
34867145,31/01/2023,,212.16
34867145,02/02/2023,-211.27,0.8899999999999864
34867145,05/02/2023,-135.59,-134.70000000000002
34867145,10/02/2023,-41.65,-176.35000000000002
34902863,31/01/2023,,31.36
34902863,01/02/2023,-89.22,-57.86
34902863,04/02/2023,-68.54,-126.4
34902863,06/02/2023,85.44,-40.96000000000001
34902863,07/02/2023,140.1,99.13999999999999
34902863,11/02/2023,191.93,291.07
34908905,31/01/2023,,887.49
34908905,04/02/2023,-102.31,785.1800000000001
34908905,05/02/2023,17.69,802.87
34908905,07/02/2023,-46.81,756.06
34908905,08/02/2023,-155.62,600.44
34908905,09/02/2023,134.21,734.65
34908905,09/02/2023,-134.87,599.78
34908905,13/02/2023,-124.37,475.40999999999997
34921262,31/01/2023,,971.82
34921262,05/02/2023,-1917.1,-945.2799999999999
34921262,07/02/2023,71.52,-873.7599999999999
34921262,08/02/2023,-101.87,-975.6299999999999
34921262,10/02/2023,-84.84,-1060.4699999999998
34921262,13/02/2023,49.05,-1011.4199999999998
34921262,14/02/2023,-48.39,-1059.81
34960760,31/01/2023,,981.79
34960760,02/02/2023,-190.9,790.89
34960760,09/02/2023,-95.76,695.13
34960760,10/02/2023,89.12,784.25
34960760,12/02/2023,160.14,944.3899999999999
35038984,31/01/2023,,566.36
35038984,07/02/2023,107.2,673.5600000000001
35038984,07/02/2023,-176.01,497.55
35038984,09/02/2023,94.29,591.84
35038984,11/02/2023,-99.57,492.27000000000004
35051369,31/01/2023,,637.18
35051369,01/02/2023,-43.65,593.53
35051369,02/02/2023,112.35,705.8799999999999
35051369,04/02/2023,-198.37,507.50999999999993
35051369,11/02/2023,-49.94,457.56999999999994
35082945,31/01/2023,,713.95
35082945,07/02/2023,-15.77,698.1800000000001
35082945,08/02/2023,-132.78,565.4000000000001
35082945,12/02/2023,113.6,679.0
35082945,14/02/2023,188.72,867.72
35083564,31/01/2023,,599.99
35083564,05/02/2023,144.77,744.76
35083564,06/02/2023,-32.2,712.5600000000001
35083564,06/02/2023,-181.24,531.3199999999999
35083564,08/02/2023,139.22,670.54
35083564,09/02/2023,59.54,730.08
35126236,31/01/2023,,739.8
35126236,02/02/2023,-379.5,360.29999999999995
35126236,04/02/2023,64.48,424.78
35126236,04/02/2023,-109.21,315.56999999999994
35126236,06/02/2023,995.2,1310.77
35126236,08/02/2023,130.56,1441.33
35126236,08/02/2023,103.89,1545.22
35126236,10/02/2023,-34.71,1510.51
35126236,13/02/2023,137.35,1647.86
35126236,13/02/2023,114.39,1762.25
35126236,14/02/2023,2138.0,3900.25
35160368,31/01/2023,,53.59
35160368,01/02/2023,41.55,95.14
35160368,05/02/2023,163.32,258.46
35160368,05/02/2023,85.08,343.53999999999996
35160368,10/02/2023,155.39,498.92999999999995
35160368,12/02/2023,139.57,638.5
35160368,13/02/2023,-39.15,599.3499999999999
35160368,14/02/2023,87.33,686.68
35160368,14/02/2023,-92.59,594.0899999999999
35177782,31/01/2023,,79.03
35177782,03/02/2023,149.54,228.57
35177782,08/02/2023,110.25,338.82
35177782,09/02/2023,-105.82,233.0
35177782,10/02/2023,72.18,305.18
35177782,10/02/2023,-123.77,181.41000000000003
35177782,11/02/2023,99.42,280.83000000000004
35194218,31/01/2023,,842.34
35194218,01/02/2023,142.2,984.54
35194218,04/02/2023,5.86,990.4
35194218,05/02/2023,-812.6,177.79999999999995
35194218,10/02/2023,70.43,248.22999999999996
35194218,11/02/2023,-134.16,114.06999999999996
35194218,12/02/2023,-76.1,37.96999999999997
35197451,31/01/2023,,411.69
35197451,01/02/2023,-96.06,315.63
35197451,02/02/2023,0.91,316.54
35197451,03/02/2023,98.31,414.85
35197451,05/02/2023,141.51,556.36
35197451,05/02/2023,86.14,642.5
35197451,07/02/2023,131.84,774.3399999999999
35197451,11/02/2023,-60.22,714.12
35197451,11/02/2023,-148.4,565.72
35197451,14/02/2023,723.4,1289.12
35210460,31/01/2023,,185.3
35210460,01/02/2023,1821.2,2006.5
35210460,01/02/2023,-99.63,1906.87
35210460,03/02/2023,117.47,2024.34
35210460,08/02/2023,199.46,2223.8
35210460,09/02/2023,42.5,2266.3
35210460,10/02/2023,68.78,2335.08
35293864,31/01/2023,,592.55
35293864,01/02/2023,-68.47,524.0799999999999
35321469,31/01/2023,,194.57
35321469,01/02/2023,76.26,270.83
35321469,02/02/2023,-119.36,151.47
35321469,07/02/2023,-113.03,38.44
35321469,09/02/2023,74.96,113.39999999999999
35321469,14/02/2023,-51.78,61.61999999999999
35330225,31/01/2023,,717.9
35330225,02/02/2023,38.42,756.3199999999999
35330225,04/02/2023,117.96,874.28
35330225,05/02/2023,72.1,946.38
35330225,06/02/2023,-90.78,855.5999999999999
35330225,08/02/2023,-95.08,760.52
35330225,09/02/2023,1169.4,1929.92
35330225,14/02/2023,-505.6,1424.3200000000002
35345678,31/01/2023,,381.43
35345678,02/02/2023,98.51,479.94
35345678,03/02/2023,170.7,650.64
35345678,06/02/2023,153.53,804.17
35345678,06/02/2023,-97.06,707.11
35345678,07/02/2023,-127.56,579.55
35379604,31/01/2023,,171.68
35379604,06/02/2023,28.36,200.04000000000002
35379604,06/02/2023,-84.79,115.25
35379604,08/02/2023,693.0,808.25
35379604,08/02/2023,14.65,822.9
35379604,10/02/2023,-113.82,709.08
35379604,13/02/2023,-58.62,650.46
35391237,31/01/2023,,412.06
35391237,01/02/2023,103.94,516.0
35391237,01/02/2023,-105.94,410.06
35391237,01/02/2023,-126.5,283.56
35391237,02/02/2023,-97.9,185.66
35391237,03/02/2023,-147.6,38.06
35391237,04/02/2023,-163.03,-124.97
35391237,07/02/2023,-153.96,-278.93
35391237,11/02/2023,58.36,-220.57
35391237,13/02/2023,-134.72,-355.29
35391237,14/02/2023,135.7,-219.59000000000003
35391340,31/01/2023,,886.56
35391340,01/02/2023,-119.2,767.3599999999999
35391340,04/02/2023,125.41,892.77
35391340,04/02/2023,-100.63,792.14
35391340,08/02/2023,-77.26,714.8799999999999
35391340,09/02/2023,156.67,871.55
35391340,09/02/2023,64.44,935.9899999999999
35391340,11/02/2023,109.76,1045.75
35391340,11/02/2023,-87.63,958.1199999999999
35391340,12/02/2023,-115.04,843.0799999999999
35405748,31/01/2023,,19.49
35405748,02/02/2023,1666.0,1685.49
35405748,03/02/2023,-171.99,1513.5
35405748,06/02/2023,-60.39,1453.11
35405748,09/02/2023,-63.99,1389.12
35445202,31/01/2023,,972.48
35445202,04/02/2023,138.34,1110.82
35445202,04/02/2023,-95.01,1015.8100000000001
35445202,05/02/2023,42.25,1058.06
35445202,07/02/2023,71.12,1129.18
35445202,13/02/2023,50.67,1179.85
35445202,13/02/2023,-80.72,1099.13
35445202,14/02/2023,128.56,1227.69
35506101,31/01/2023,,713.65
35506101,04/02/2023,-143.83,569.8199999999999
35506101,06/02/2023,-368.9,200.91999999999996
35506101,07/02/2023,26.09,227.00999999999996
35506101,07/02/2023,15.77,242.77999999999997
35506101,08/02/2023,70.92,313.69999999999993
35506101,09/02/2023,87.02,400.71999999999997
35506101,09/02/2023,-1386.8,-986.0799999999999
35506101,11/02/2023,-107.95,-1094.03
35510004,31/01/2023,,723.62
35510004,07/02/2023,-53.14,670.48
35510004,09/02/2023,-140.03,530.45
35510004,14/02/2023,122.94,653.39
35539408,31/01/2023,,469.13
35539408,08/02/2023,66.58,535.71
35539408,12/02/2023,20.96,556.67
35539408,12/02/2023,-60.3,496.37
35540836,31/01/2023,,17.91
35540836,01/02/2023,120.69,138.6
35540836,04/02/2023,162.1,300.7
35540836,11/02/2023,-64.55,236.14999999999998
35540836,12/02/2023,850.1,1086.25
35549277,31/01/2023,,505.72
35549277,03/02/2023,164.14,669.86
35549277,04/02/2023,143.95,813.81
35549277,06/02/2023,54.21,868.02
35549277,08/02/2023,-65.82,802.2
35549277,09/02/2023,79.33,881.53
35549277,14/02/2023,135.72,1017.25
35555120,31/01/2023,,598.72
35555120,05/02/2023,-112.03,486.69000000000005
35555120,06/02/2023,-155.04,331.65000000000003
35555120,09/02/2023,-75.39,256.26000000000005
35564578,31/01/2023,,621.37
35564578,01/02/2023,156.88,778.25
35564578,01/02/2023,101.68,879.9300000000001
35564578,05/02/2023,-33.32,846.61
35564578,06/02/2023,140.83,987.44
35564578,06/02/2023,76.6,1064.04
35564578,07/02/2023,-93.89,970.15
35564578,09/02/2023,93.14,1063.29
35564578,11/02/2023,-909.1,154.19000000000005
35564578,12/02/2023,-95.71,58.48000000000006
35564578,14/02/2023,153.48,211.96000000000004
35574156,31/01/2023,,471.05
35574156,02/02/2023,81.2,552.25
35574156,02/02/2023,-113.03,439.22
35574156,04/02/2023,-98.27,340.95000000000005
35574156,10/02/2023,117.79,458.74
35574156,12/02/2023,-71.65,387.09000000000003
35614465,31/01/2023,,276.17
35614465,01/02/2023,106.89,383.06
35614465,01/02/2023,75.62,458.68
35614465,01/02/2023,-111.48,347.20000000000005
35614465,02/02/2023,68.58,415.78000000000003
35614465,04/02/2023,238.96,654.74
35614465,04/02/2023,82.25,736.99
35614465,07/02/2023,176.01,913.0
35614465,09/02/2023,-81.5,831.5
35614465,12/02/2023,-41.61,789.89
35614465,14/02/2023,52.1,841.99
35614465,14/02/2023,-69.51,772.48
35616763,31/01/2023,,279.43
35616763,03/02/2023,144.98,424.40999999999997
35616763,04/02/2023,91.88,516.29
35616763,04/02/2023,90.91,607.2
35616763,05/02/2023,98.9,706.1
35616763,09/02/2023,-94.78,611.3199999999999
35616763,10/02/2023,-133.89,477.43
35633136,31/01/2023,,603.11
35633136,07/02/2023,-140.72,462.39
35633136,08/02/2023,-1589.0,-1126.6100000000001
35633136,09/02/2023,1855.5,728.8899999999999
35633136,10/02/2023,-85.16,643.7299999999999
35633136,12/02/2023,-128.62,515.1099999999999
35633136,14/02/2023,223.99,739.0999999999999
35642953,31/01/2023,,137.26
35642953,07/02/2023,-45.83,91.42999999999999
35642953,10/02/2023,141.83,233.26
35642953,11/02/2023,-102.43,130.83
35642953,13/02/2023,126.72,257.55
35652360,31/01/2023,,41.81
35652360,02/02/2023,87.3,129.11
35652360,07/02/2023,-135.62,-6.509999999999991
35652360,10/02/2023,-101.74,-108.24999999999999
35652360,12/02/2023,-7.46,-115.70999999999998
35698347,31/01/2023,,258.22
35698347,09/02/2023,-145.02,113.20000000000002
35698347,12/02/2023,82.2,195.40000000000003
35698347,12/02/2023,76.36,271.76
35698347,12/02/2023,28.42,300.18
35698347,12/02/2023,-143.1,157.08000000000004
35698347,13/02/2023,23.8,180.88000000000005
35698347,14/02/2023,-105.03,75.85000000000004
35712712,31/01/2023,,828.88
35712712,02/02/2023,94.92,923.8
35712712,04/02/2023,91.22,1015.02
35712712,13/02/2023,-93.58,921.44
35712712,14/02/2023,-131.58,789.86
35721788,31/01/2023,,837.07
35721788,02/02/2023,47.72,884.7900000000001
35721788,04/02/2023,1548.2,2432.9900000000002
35721788,05/02/2023,-189.35,2243.64
35721788,07/02/2023,166.27,2409.91
35721788,11/02/2023,-67.03,2342.88
35726421,31/01/2023,,379.1
35726421,01/02/2023,-36.3,342.8
35726421,09/02/2023,257.1,599.9000000000001
35726421,09/02/2023,-32.68,567.22
35726421,11/02/2023,-117.41,449.81000000000006
35726421,12/02/2023,118.77,568.58
35726421,12/02/2023,-146.81,421.77000000000004
35726421,13/02/2023,32.01,453.78000000000003
35726421,14/02/2023,143.07,596.85
35726421,14/02/2023,-84.96,511.89000000000004
35746207,31/01/2023,,785.36
35746207,02/02/2023,142.26,927.62
35746207,04/02/2023,-163.58,764.04
35746207,08/02/2023,-136.06,627.98
35746207,09/02/2023,-180.04,447.94
35746207,11/02/2023,-106.87,341.07
35746207,14/02/2023,82.48,423.55
35746207,14/02/2023,-73.77,349.78
35762783,31/01/2023,,346.14
35762783,04/02/2023,34.64,380.78
35762783,06/02/2023,97.52,478.29999999999995
35762783,06/02/2023,-98.21,380.09
35772673,31/01/2023,,517.9
35772673,01/02/2023,-76.39,441.51
35772673,11/02/2023,17.45,458.96
35772673,12/02/2023,113.78,572.74
35799522,31/01/2023,,750.79
35799522,04/02/2023,122.19,872.98
35799522,04/02/2023,-84.48,788.5
35799522,08/02/2023,811.2,1599.7
35799522,09/02/2023,77.09,1676.79
35799522,12/02/2023,481.2,2157.99
35799522,12/02/2023,-122.13,2035.8600000000001
35799522,13/02/2023,53.69,2089.55
35805852,31/01/2023,,886.37
35805852,03/02/2023,26.28,912.65
35805852,08/02/2023,159.05,1071.7
35805852,13/02/2023,-80.1,991.6
35805852,13/02/2023,-128.78,862.82
35827625,31/01/2023,,445.63
35827625,01/02/2023,-4.45,441.18
35827625,03/02/2023,-130.92,310.26
35827625,06/02/2023,50.86,361.12
35827625,07/02/2023,166.06,527.1800000000001
35827625,08/02/2023,-103.49,423.69
35827625,13/02/2023,138.07,561.76
35869347,31/01/2023,,768.74
35869347,01/02/2023,-99.06,669.6800000000001
35869347,06/02/2023,128.7,798.38
35869347,08/02/2023,-63.42,734.96
35869347,09/02/2023,122.91,857.87
35869347,10/02/2023,504.8,1362.67
35869347,13/02/2023,-650.5,712.1700000000001
35948735,31/01/2023,,117.14
35948735,06/02/2023,173.27,290.41
35948735,08/02/2023,-257.4,33.01000000000005
35948735,10/02/2023,-59.81,-26.799999999999955
35948735,12/02/2023,-103.8,-130.59999999999997
35948735,13/02/2023,145.83,15.230000000000075
35996817,31/01/2023,,187.89
35996817,02/02/2023,62.13,250.01999999999998
35996817,02/02/2023,-807.9,-557.88
35996817,03/02/2023,-955.4,-1513.28
35996817,04/02/2023,162.76,-1350.52
35996817,04/02/2023,97.19,-1253.33
35996817,05/02/2023,39.08,-1214.25
35996817,06/02/2023,1144.5,-69.75
35996817,13/02/2023,-111.75,-181.5
36007496,31/01/2023,,239.44
36007496,03/02/2023,-106.54,132.89999999999998
36007496,04/02/2023,130.37,263.27
36007496,10/02/2023,-142.78,120.48999999999998
36007496,11/02/2023,-55.67,64.81999999999998
36007496,12/02/2023,-90.33,-25.51000000000002
36106467,31/01/2023,,720.17
36106467,02/02/2023,54.11,774.28
36106467,13/02/2023,-48.97,725.31
36106467,14/02/2023,-109.13,616.18
36110938,31/01/2023,,532.77
36110938,05/02/2023,-151.15,381.62
36110938,14/02/2023,110.42,492.03999999999996
36110938,14/02/2023,-51.36,440.67999999999995
36112473,31/01/2023,,530.67
36112473,02/02/2023,104.28,634.9499999999999
36112473,07/02/2023,-16.72,618.23
36112473,08/02/2023,128.42,746.65
36112473,08/02/2023,37.07,783.7199999999999
36112473,11/02/2023,111.87,895.5899999999999
36114551,31/01/2023,,876.22
36114551,03/02/2023,-12.53,863.69
36114551,03/02/2023,-1488.0,-624.31
36114551,07/02/2023,-9.52,-633.8299999999999
36114551,11/02/2023,134.5,-499.3299999999999
36114551,11/02/2023,113.2,-386.12999999999994
36114551,13/02/2023,-154.15,-540.28
36114551,14/02/2023,134.51,-405.77
36126802,31/01/2023,,617.04
36126802,04/02/2023,117.97,735.01
36126802,10/02/2023,-122.66,612.3499999999999
36126802,12/02/2023,-80.63,531.72
36131723,31/01/2023,,602.96
36131723,02/02/2023,723.0,1325.96
36131723,06/02/2023,74.78,1400.74
36131723,07/02/2023,153.24,1553.98
36131723,08/02/2023,-60.7,1493.28
36131723,13/02/2023,118.36,1611.64
36141472,31/01/2023,,656.7
36141472,09/02/2023,20.1,676.8000000000001
36143004,31/01/2023,,256.22
36143004,03/02/2023,-132.95,123.27000000000004
36143004,04/02/2023,-58.74,64.53000000000003
36143004,08/02/2023,111.03,175.56000000000003
36143004,13/02/2023,127.19,302.75
36171568,31/01/2023,,343.44
36171568,06/02/2023,-169.47,173.97
36171568,14/02/2023,151.47,325.44
36192947,31/01/2023,,744.33
36192947,02/02/2023,73.15,817.48
36192947,04/02/2023,47.16,864.6400000000001
36192947,05/02/2023,-103.8,760.84
36192947,05/02/2023,-134.86,625.98
36192947,05/02/2023,-158.54,467.44000000000005
36192947,07/02/2023,435.8,903.24
36192947,11/02/2023,36.38,939.62
36192947,11/02/2023,-69.7,869.9200000000001
36192947,13/02/2023,-44.57,825.35
36192947,14/02/2023,74.53,899.88
36197772,31/01/2023,,962.03
36197772,01/02/2023,-21.82,940.2099999999999
36197772,04/02/2023,-189.3,750.91
36197772,06/02/2023,179.58,930.49
36197772,12/02/2023,-77.33,853.16
36197772,13/02/2023,-164.76,688.4
36197772,14/02/2023,-110.14,578.26
36258926,31/01/2023,,549.71
36258926,06/02/2023,103.37,653.08
36258926,06/02/2023,-100.71,552.37
36258926,09/02/2023,-133.16,419.21000000000004
36258926,10/02/2023,120.39,539.6
36259936,31/01/2023,,628.23
36259936,01/02/2023,18.77,647.0
36259936,05/02/2023,403.6,1050.6
36259936,06/02/2023,16.5,1067.1
36259936,08/02/2023,-60.7,1006.4
36259936,11/02/2023,-131.61,874.79
36259936,12/02/2023,-113.45,761.34
36296704,31/01/2023,,491.31
36296704,04/02/2023,167.73,659.04
36296704,04/02/2023,-191.64,467.4
36296704,05/02/2023,16.24,483.64
36296704,08/02/2023,116.58,600.22
36327122,31/01/2023,,808.81
36327122,02/02/2023,-127.6,681.2099999999999
36327122,07/02/2023,104.16,785.3699999999999
36327122,08/02/2023,-51.75,733.6199999999999
36389309,31/01/2023,,469.45
36389309,06/02/2023,-132.93,336.52
36389309,08/02/2023,-36.71,299.81
36389309,09/02/2023,83.47,383.28
36389309,11/02/2023,145.81,529.0899999999999
36389309,11/02/2023,-1271.5,-742.4100000000001
36393557,31/01/2023,,407.12
36393557,03/02/2023,-99.07,308.05
36393557,05/02/2023,-101.16,206.89000000000001
36393557,06/02/2023,-142.55,64.34
36393557,09/02/2023,5.59,69.93
36393557,13/02/2023,161.44,231.37
36419197,31/01/2023,,627.78
36419197,02/02/2023,129.45,757.23
36419197,07/02/2023,169.36,926.5899999999999
36419197,08/02/2023,1693.2,2619.79
36419197,14/02/2023,90.74,2710.5299999999997
36425954,31/01/2023,,93.85
36425954,03/02/2023,-146.59,-52.74000000000001
36425954,04/02/2023,150.84,98.1
36425954,04/02/2023,131.69,229.79
36425954,10/02/2023,-141.46,88.32999999999998
36425954,11/02/2023,-40.22,48.109999999999985
36425954,14/02/2023,104.18,152.29
36519974,31/01/2023,,922.41
36519974,05/02/2023,-129.47,792.9399999999999
36519974,07/02/2023,-38.88,754.06
36519974,09/02/2023,-1522.7,-768.6400000000001
36519974,12/02/2023,-138.36,-907.0000000000001
36549889,31/01/2023,,760.2
36549889,09/02/2023,-97.39,662.8100000000001
36549889,10/02/2023,-12.48,650.33
36549889,10/02/2023,-131.62,518.71
36549889,14/02/2023,143.83,662.5400000000001
36551112,31/01/2023,,976.02
36551112,01/02/2023,-12.83,963.1899999999999
36551112,05/02/2023,183.91,1147.1
36551112,05/02/2023,-40.03,1107.07
36551112,06/02/2023,97.64,1204.71
36551112,06/02/2023,-32.34,1172.37
36551112,14/02/2023,-1514.1,-341.73
36551112,14/02/2023,-2197.2,-2538.93
36596942,31/01/2023,,550.9
36596942,03/02/2023,130.92,681.8199999999999
36596942,06/02/2023,110.09,791.91
36596942,08/02/2023,-74.13,717.78
36596942,08/02/2023,-190.88,526.9
36596942,09/02/2023,155.29,682.1899999999999
36596942,13/02/2023,50.68,732.87
36596942,13/02/2023,48.38,781.25
36596942,13/02/2023,-18.85,762.4
36611100,31/01/2023,,485.06
36611100,02/02/2023,144.06,629.12
36611100,03/02/2023,-565.2,63.91999999999996
36611100,05/02/2023,-91.56,-27.640000000000043
36611100,08/02/2023,71.61,43.969999999999956
36611100,10/02/2023,-174.77,-130.80000000000007
36636385,31/01/2023,,985.55
36636385,01/02/2023,-134.06,851.49
36636385,04/02/2023,74.02,925.51
36636385,07/02/2023,1392.7,2318.21
36636385,10/02/2023,-76.06,2242.15
36636385,10/02/2023,-134.54,2107.61
36668239,31/01/2023,,566.32
36668239,02/02/2023,1640.2,2206.52
36668239,03/02/2023,-71.27,2135.25
36668239,11/02/2023,-123.81,2011.4400000000003
36668239,13/02/2023,-11.11,2000.3300000000002
36692647,31/01/2023,,710.29
36692647,02/02/2023,166.35,876.64
36692647,09/02/2023,129.76,1006.4
36696277,31/01/2023,,395.42
36696277,01/02/2023,153.43,548.85
36696277,08/02/2023,74.38,623.23
36696277,08/02/2023,-108.96,514.27
36696277,08/02/2023,-121.98,392.29
36696277,09/02/2023,50.78,443.07000000000005
36696277,10/02/2023,550.8,993.87
36696277,11/02/2023,38.74,1032.61
36696277,12/02/2023,1491.7,2524.31
36725272,31/01/2023,,52.82
36725272,02/02/2023,52.78,105.6
36725272,05/02/2023,129.27,234.87
36725272,06/02/2023,161.37,396.24
36725272,07/02/2023,-109.2,287.04
36725272,14/02/2023,-126.36,160.68
36837451,31/01/2023,,429.52
36837451,01/02/2023,146.02,575.54
36837451,02/02/2023,212.6,788.14
36837451,02/02/2023,96.32,884.46
36837451,02/02/2023,31.96,916.42
36837451,07/02/2023,-77.46,838.96
36837451,12/02/2023,77.33,916.29
36837451,12/02/2023,-119.09,797.1999999999999
36841261,31/01/2023,,172.37
36841261,01/02/2023,-127.65,44.72
36841261,04/02/2023,110.3,155.01999999999998
36841261,06/02/2023,-159.47,-4.449999999999989
36841261,10/02/2023,139.99,135.54000000000002
36841261,12/02/2023,128.62,264.16
36841261,14/02/2023,-148.63,115.53000000000003
36849841,31/01/2023,,593.56
36849841,02/02/2023,-62.52,531.04
36849841,03/02/2023,-174.62,356.41999999999996
36849841,04/02/2023,-83.73,272.68999999999994
36849841,05/02/2023,114.02,386.7099999999999
36849841,10/02/2023,-99.46,287.24999999999994
36871984,31/01/2023,,949.89
36871984,05/02/2023,-103.29,846.6
36871984,07/02/2023,56.49,903.09
36871984,08/02/2023,-154.63,748.46
36871984,12/02/2023,1663.0,2411.46
36871984,13/02/2023,-58.3,2353.16
36949196,31/01/2023,,614.22
36949196,02/02/2023,118.32,732.54
36949196,03/02/2023,124.88,857.4200000000001
36949196,04/02/2023,-86.74,770.6800000000001
36949196,04/02/2023,-125.41,645.27
36949196,07/02/2023,-85.77,559.5
36982820,31/01/2023,,833.46
36982820,01/02/2023,599.8,1433.26
36982820,05/02/2023,-74.55,1358.71
36982820,08/02/2023,2.72,1361.43
36982820,12/02/2023,117.45,1478.88
36982820,12/02/2023,-125.62,1353.26
36982820,14/02/2023,80.46,1433.72
37004975,31/01/2023,,635.77
37004975,04/02/2023,-55.54,580.23
37004975,05/02/2023,122.25,702.48
37004975,06/02/2023,91.58,794.06
37004975,06/02/2023,59.58,853.64
37004975,07/02/2023,-1679.8,-826.16
37004975,08/02/2023,-1290.2,-2116.36
37004975,09/02/2023,37.65,-2078.71
37004975,09/02/2023,-112.31,-2191.02
37004975,13/02/2023,110.17,-2080.85
37017424,31/01/2023,,71.34
37017424,01/02/2023,-85.83,-14.489999999999995
37017424,01/02/2023,-98.52,-113.00999999999999
37017424,02/02/2023,111.16,-1.8499999999999943
37017424,10/02/2023,-11.07,-12.919999999999995
37017424,10/02/2023,-1531.0,-1543.92
37017424,12/02/2023,71.74,-1472.18
37017424,13/02/2023,71.51,-1400.67
37062632,31/01/2023,,366.72
37062632,01/02/2023,119.45,486.17
37062632,04/02/2023,89.51,575.6800000000001
37062632,06/02/2023,-171.3,404.38
37062632,09/02/2023,50.41,454.79
37062632,10/02/2023,104.53,559.32
37062632,10/02/2023,-72.61,486.71000000000004
37062632,13/02/2023,87.03,573.74
37146521,31/01/2023,,471.64
37146521,01/02/2023,-18.27,453.37
37146521,04/02/2023,-94.29,359.08
37146521,08/02/2023,-93.73,265.34999999999997
37146521,08/02/2023,-195.35,70.0
37146521,08/02/2023,-1565.7,-1495.7
37146521,10/02/2023,-46.07,-1541.77
37146521,13/02/2023,37.47,-1504.3
37164421,31/01/2023,,302.68
37164421,03/02/2023,145.42,448.1
37164421,06/02/2023,133.47,581.5699999999999
37164421,10/02/2023,-197.72,383.85
37164421,11/02/2023,182.11,565.96
37247834,31/01/2023,,319.19
37247834,01/02/2023,-148.96,170.23
37247834,01/02/2023,-937.1,-766.87
37247834,07/02/2023,169.21,-597.66
37247834,08/02/2023,163.97,-433.69
37247834,08/02/2023,-56.13,-489.82
37247834,09/02/2023,-80.13,-569.95
37247834,09/02/2023,-138.48,-708.43
37247834,11/02/2023,-117.67,-826.1
37247834,12/02/2023,-185.51,-1011.6099999999999
37247834,14/02/2023,42.13,-969.4799999999999
37256412,31/01/2023,,24.43
37256412,03/02/2023,-1529.4,-1504.97
37256412,05/02/2023,135.39,-1369.58
37256412,08/02/2023,80.13,-1289.45
37256412,11/02/2023,123.24,-1166.21
37267391,31/01/2023,,819.11
37267391,01/02/2023,-105.76,713.35
37267391,02/02/2023,-666.0,47.35000000000002
37267391,04/02/2023,102.71,150.06
37267391,06/02/2023,629.3,779.3599999999999
37267391,06/02/2023,-100.8,678.56
37267391,09/02/2023,134.87,813.4299999999998
37267391,10/02/2023,-62.82,750.6099999999999
37267391,11/02/2023,47.38,797.9899999999999
37273974,31/01/2023,,533.14
37273974,02/02/2023,699.9,1233.04
37273974,02/02/2023,80.13,1313.17
37273974,03/02/2023,180.87,1494.04
37273974,05/02/2023,62.54,1556.58
37273974,13/02/2023,-125.25,1431.33
37274865,31/01/2023,,95.23
37297429,31/01/2023,,693.82
37297429,01/02/2023,-79.4,614.4200000000001
37297429,02/02/2023,983.3,1597.72
37297429,02/02/2023,108.09,1705.81
37297429,03/02/2023,-128.25,1577.56
37297429,05/02/2023,45.9,1623.46
37297429,06/02/2023,72.88,1696.3400000000001
37297429,08/02/2023,-193.89,1502.45
37297429,14/02/2023,-25.45,1477.0
37297429,14/02/2023,-153.15,1323.8500000000001
37319261,31/01/2023,,574.42
37319261,04/02/2023,-99.39,475.03
37319261,06/02/2023,-1409.6,-934.5699999999999
37319261,09/02/2023,-89.75,-1024.32
37319261,10/02/2023,55.29,-969.03
37369245,31/01/2023,,446.65
37369245,01/02/2023,-74.4,372.25
37369245,03/02/2023,-43.72,328.53
37369245,04/02/2023,82.56,411.09
37369245,04/02/2023,-118.19,292.9
37369245,05/02/2023,-40.41,252.48999999999998
37369245,10/02/2023,-1324.9,-1072.41
37369245,14/02/2023,-124.26,-1196.67
37407392,31/01/2023,,822.17
37407392,04/02/2023,79.47,901.64
37407392,05/02/2023,-6.87,894.77
37407392,10/02/2023,-110.62,784.15
37407392,13/02/2023,-87.2,696.9499999999999
37407392,14/02/2023,49.4,746.3499999999999
37443706,31/01/2023,,621.08
37443706,03/02/2023,88.33,709.4100000000001
37443706,07/02/2023,-89.31,620.1
37443706,08/02/2023,158.67,778.77
37443706,08/02/2023,48.19,826.96
37443706,12/02/2023,95.8,922.76
37443706,13/02/2023,1088.0,2010.76
37443706,13/02/2023,-97.05,1913.71
37443706,14/02/2023,47.25,1960.96
37503622,31/01/2023,,630.18
37503622,03/02/2023,146.88,777.06
37503622,03/02/2023,-121.3,655.76
37503622,04/02/2023,-1246.9,-591.1400000000001
37503622,04/02/2023,-1395.3,-1986.44
37503622,09/02/2023,1300.7,-685.74
37503622,09/02/2023,103.16,-582.58
37503622,09/02/2023,-102.69,-685.27
37510139,31/01/2023,,546.33
37510139,03/02/2023,-825.8,-279.4699999999999
37510139,05/02/2023,116.94,-162.52999999999992
37510139,11/02/2023,42.19,-120.33999999999992
37510139,14/02/2023,163.39,43.05000000000007
37528735,31/01/2023,,368.39
37528735,02/02/2023,-92.47,275.91999999999996
37528735,07/02/2023,153.3,429.22
37528735,08/02/2023,-42.59,386.63
37528735,11/02/2023,11.3,397.93
37528735,14/02/2023,89.42,487.35
37561049,31/01/2023,,903.95
37561049,01/02/2023,-80.58,823.37
37561049,02/02/2023,-140.34,683.03
37561049,03/02/2023,-78.66,604.37
37561049,04/02/2023,96.78,701.1500000000001
37561049,04/02/2023,2.86,704.01
37561049,05/02/2023,1922.5,2626.51
37561049,13/02/2023,163.33,2789.84
37561049,13/02/2023,-156.37,2633.47
37561049,14/02/2023,113.07,2746.54
37599317,31/01/2023,,177.32
37599317,02/02/2023,116.43,293.75
37599317,03/02/2023,-167.61,126.13999999999999
37599317,09/02/2023,56.53,182.67
37599317,11/02/2023,73.62,256.28999999999996
37599317,11/02/2023,-103.41,152.88
37599317,12/02/2023,-132.48,20.400000000000006
37642787,31/01/2023,,396.03
37642787,03/02/2023,78.28,474.30999999999995
37642787,03/02/2023,1.03,475.34
37642787,03/02/2023,-187.7,287.64
37642787,04/02/2023,-127.76,159.88
37642787,06/02/2023,-48.31,111.56999999999998
37642787,10/02/2023,1289.6,1401.1699999999998
37642787,10/02/2023,25.31,1426.4799999999998
37642787,14/02/2023,159.09,1585.57
37658218,31/01/2023,,561.27
37658218,01/02/2023,570.3,1131.57
37658218,02/02/2023,-39.87,1091.7
37658218,07/02/2023,43.63,1135.33
37658218,09/02/2023,-83.42,1051.9099999999999
37658218,14/02/2023,-85.5,966.41
37658218,14/02/2023,-101.53,864.8799999999999
37678813,31/01/2023,,767.56
37678813,03/02/2023,-67.35,700.2099999999999
37678813,08/02/2023,-105.41,594.8
37678813,13/02/2023,78.14,672.9399999999999
37678813,13/02/2023,66.23,739.17
37767441,31/01/2023,,726.46
37767441,01/02/2023,-88.19,638.27
37767441,02/02/2023,-15.8,622.47
37767441,03/02/2023,94.83,717.3000000000001
37767441,08/02/2023,87.01,804.3100000000001
37767441,09/02/2023,64.96,869.27
37767441,12/02/2023,169.44,1038.71
37789180,31/01/2023,,854.05
37789180,02/02/2023,-75.99,778.06
37789180,03/02/2023,19.89,797.9499999999999
37789180,07/02/2023,84.83,882.78
37789180,08/02/2023,1621.0,2503.7799999999997
37789180,09/02/2023,-1726.4,777.3799999999999
37789180,11/02/2023,1037.0,1814.3799999999999
37789180,11/02/2023,64.84,1879.2199999999998
37789180,11/02/2023,26.87,1906.09
37789180,12/02/2023,-66.32,1839.77
37789180,13/02/2023,-147.5,1692.27
37796234,31/01/2023,,992.46
37796234,02/02/2023,1698.0,2690.46
37796234,02/02/2023,54.93,2745.39
37796234,04/02/2023,189.38,2934.77
37796234,04/02/2023,-84.12,2850.65
37796234,04/02/2023,-84.91,2765.7400000000002
37796234,06/02/2023,63.36,2829.1
37796234,08/02/2023,1096.2,3925.3
37796234,09/02/2023,38.71,3964.01
37796234,09/02/2023,-173.2,3790.8100000000004
37830423,31/01/2023,,285.5
37830423,02/02/2023,-84.91,200.59
37830423,04/02/2023,120.69,321.28
37830423,05/02/2023,55.38,376.66
37830423,07/02/2023,-69.94,306.72
37830423,08/02/2023,19.11,325.83
37830423,08/02/2023,17.63,343.46
37830423,13/02/2023,-63.17,280.28999999999996
37878074,31/01/2023,,647.56
37878074,01/02/2023,-124.69,522.8699999999999
37878074,03/02/2023,-1218.0,-695.1300000000001
37878074,04/02/2023,-36.24,-731.3700000000001
37878074,11/02/2023,-102.13,-833.5000000000001
37878074,11/02/2023,-117.62,-951.1200000000001
37878074,11/02/2023,-720.7,-1671.8200000000002
37905098,31/01/2023,,389.98
37905098,04/02/2023,112.65,502.63
37905098,07/02/2023,-37.9,464.73
37905098,07/02/2023,-92.13,372.6
37905098,07/02/2023,-197.62,174.98000000000002
37905098,08/02/2023,105.41,280.39
37905098,09/02/2023,109.67,390.06
37905098,11/02/2023,80.85,470.91
37905098,12/02/2023,-125.27,345.64
37905098,12/02/2023,-170.43,175.21
37936898,31/01/2023,,745.79
37936898,01/02/2023,-104.85,640.9399999999999
37936898,03/02/2023,-98.53,542.41
37936898,06/02/2023,159.49,701.9
37936898,06/02/2023,-999.1,-297.20000000000005
37936898,10/02/2023,163.93,-133.27000000000004
37936898,10/02/2023,62.15,-71.12000000000003
37936898,11/02/2023,-86.98,-158.10000000000005
37936898,13/02/2023,73.86,-84.24000000000005
37945317,31/01/2023,,8.24
37945317,02/02/2023,122.81,131.05
37945317,03/02/2023,529.6,660.6500000000001
37945317,06/02/2023,-120.15,540.5
37945317,07/02/2023,1689.7,2230.2
37945317,09/02/2023,-108.53,2121.67
37945317,09/02/2023,-217.27,1904.4
37945317,10/02/2023,1524.4,3428.8
37945317,12/02/2023,89.44,3518.2400000000002
37945317,14/02/2023,-100.7,3417.54
37953007,31/01/2023,,440.78
37953007,02/02/2023,-68.21,372.57
37953007,04/02/2023,130.12,502.69
37953007,04/02/2023,-786.1,-283.41
38032055,31/01/2023,,416.47
38032055,04/02/2023,-32.51,383.96000000000004
38032055,07/02/2023,12.66,396.62
38032055,07/02/2023,-155.12,241.50000000000003
38032055,10/02/2023,-121.29,120.21000000000002
38032055,10/02/2023,-386.8,-266.59
38032055,12/02/2023,147.01,-119.57999999999998
38032055,14/02/2023,88.36,-31.219999999999985
38038623,31/01/2023,,526.98
38038623,05/02/2023,1345.1,1872.08
38038623,06/02/2023,-55.26,1816.82
38038623,10/02/2023,-124.93,1691.8899999999999
38038623,13/02/2023,-148.57,1543.32
38038623,14/02/2023,-195.92,1347.3999999999999
38124225,31/01/2023,,943.59
38124225,05/02/2023,107.79,1051.38
38124225,08/02/2023,91.24,1142.6200000000001
38124225,08/02/2023,-114.16,1028.46
38124225,09/02/2023,-101.24,927.22
38124225,09/02/2023,-145.58,781.6400000000001
38124225,10/02/2023,114.32,895.96
38124225,10/02/2023,63.35,959.3100000000001
38124225,13/02/2023,65.9,1025.21
38157078,31/01/2023,,756.55
38157078,04/02/2023,664.6,1421.15
38157078,07/02/2023,-86.52,1334.6299999999999
38157078,13/02/2023,-169.97,1164.6599999999999
38224160,31/01/2023,,701.82
38224160,02/02/2023,-92.9,608.9200000000001
38224160,03/02/2023,-119.1,489.82000000000005
38224160,07/02/2023,-75.95,413.87000000000006
38224160,13/02/2023,-76.04,337.83000000000004
38291062,31/01/2023,,486.68
38291062,01/02/2023,-82.42,404.26
38291062,05/02/2023,-78.67,325.59000000000003
38291062,06/02/2023,246.82,572.41
38291062,11/02/2023,1.71,574.12
38291062,12/02/2023,-119.93,454.19
38291062,14/02/2023,77.33,531.52
38291062,14/02/2023,-105.25,426.27
38316158,31/01/2023,,138.4
38316158,02/02/2023,74.49,212.89
38316158,05/02/2023,227.66,440.55
38316158,05/02/2023,92.28,532.83
38316158,07/02/2023,35.98,568.8100000000001
38316158,08/02/2023,24.76,593.57
38316158,14/02/2023,-53.27,540.3
38346624,31/01/2023,,740.09
38346624,10/02/2023,737.2,1477.29
38346624,10/02/2023,185.21,1662.5
38395807,31/01/2023,,463.52
38395807,07/02/2023,144.93,608.45
38395807,08/02/2023,44.05,652.5
38395807,09/02/2023,-40.77,611.73
38395807,12/02/2023,91.23,702.96
38428295,31/01/2023,,690.12
38428295,08/02/2023,-199.46,490.65999999999997
38428295,11/02/2023,-167.56,323.1
38428295,13/02/2023,-128.11,194.98999999999998
38428295,14/02/2023,-170.29,24.69999999999999
38429514,31/01/2023,,627.62
38429514,01/02/2023,-72.18,555.44
38429514,04/02/2023,-119.83,435.61
38429514,08/02/2023,-108.02,327.59000000000003
38429514,10/02/2023,-139.76,187.83
38429514,11/02/2023,47.32,235.15
38429514,12/02/2023,102.95,338.1
38429514,14/02/2023,53.96,392.06
38442044,31/01/2023,,106.95
38442044,02/02/2023,64.9,171.85000000000002
38442044,03/02/2023,-23.84,148.01000000000002
38442044,06/02/2023,50.95,198.96
38442044,07/02/2023,113.13,312.09000000000003
38442044,07/02/2023,-144.16,167.93
38442044,07/02/2023,-152.25,15.680000000000007
38442044,08/02/2023,57.77,73.45000000000002
38442044,08/02/2023,34.12,107.57000000000001
38442044,12/02/2023,98.65,206.22000000000003
38442044,14/02/2023,860.1,1066.3200000000002
38487215,31/01/2023,,780.01
38487215,01/02/2023,808.4,1588.4099999999999
38487215,03/02/2023,118.95,1707.36
38487215,03/02/2023,-128.1,1579.26
38487215,06/02/2023,-1543.0,36.25999999999999
38495059,31/01/2023,,14.18
38495059,02/02/2023,-36.6,-22.42
38495059,06/02/2023,-42.54,-64.96000000000001
38495059,11/02/2023,-136.0,-200.96
38502892,31/01/2023,,600.32
38502892,06/02/2023,-62.08,538.24
38502892,07/02/2023,71.61,609.85
38502892,08/02/2023,-47.37,562.48
38528119,31/01/2023,,165.9
38528119,06/02/2023,78.29,244.19
38528119,06/02/2023,-191.25,52.94
38528119,08/02/2023,-167.66,-114.72
38528119,13/02/2023,168.95,54.22999999999999
38528119,14/02/2023,116.52,170.75
38558525,31/01/2023,,833.07
38558525,04/02/2023,62.25,895.32
38558525,07/02/2023,1819.0,2714.32
38558525,08/02/2023,194.3,2908.6200000000003
38564653,31/01/2023,,647.95
38564653,03/02/2023,3.5,651.45
38564653,05/02/2023,104.58,756.0300000000001
38564653,12/02/2023,133.45,889.48
38564653,13/02/2023,93.97,983.45
38587383,31/01/2023,,579.12
38587383,01/02/2023,81.07,660.19
38587383,01/02/2023,-146.1,514.09
38587383,03/02/2023,110.66,624.75
38587383,03/02/2023,-39.37,585.38
38587383,04/02/2023,-162.1,423.28
38587383,07/02/2023,124.31,547.59
38587383,07/02/2023,-166.27,381.32
38587383,09/02/2023,-118.41,262.90999999999997
38587383,12/02/2023,-37.14,225.76999999999998
38587383,12/02/2023,-82.59,143.18
38606148,31/01/2023,,956.59
38606148,02/02/2023,-111.16,845.4300000000001
38606148,04/02/2023,67.91,913.34
38606148,04/02/2023,-72.53,840.8100000000001
38606148,06/02/2023,-26.04,814.77
38606148,11/02/2023,-132.56,682.21
38606148,12/02/2023,131.58,813.7900000000001
38606148,12/02/2023,-1323.4,-509.61
38627867,31/01/2023,,132.74
38627867,05/02/2023,-99.91,32.83000000000001
38627867,06/02/2023,70.94,103.77000000000001
38627867,14/02/2023,-102.09,1.6800000000000068
38690875,31/01/2023,,320.39
38690875,03/02/2023,-126.21,194.18
38690875,06/02/2023,-198.2,-4.019999999999982
38690875,11/02/2023,-147.09,-151.10999999999999
38690875,13/02/2023,-76.09,-227.2
38690875,13/02/2023,-104.24,-331.44
38690875,14/02/2023,-122.9,-454.34
38740782,31/01/2023,,702.64
38740782,04/02/2023,-133.55,569.0899999999999
38740782,05/02/2023,-61.09,508.0
38740782,12/02/2023,76.1,584.0999999999999
38740782,12/02/2023,-84.07,500.03
38749064,31/01/2023,,569.98
38749064,01/02/2023,143.97,713.95
38749064,02/02/2023,-1436.3,-722.3499999999999
38749064,03/02/2023,89.06,-633.29
38749064,14/02/2023,138.71,-494.5799999999999
38764064,31/01/2023,,648.12
38764064,01/02/2023,52.17,700.29
38764064,02/02/2023,15.8,716.09
38764064,07/02/2023,106.64,822.73
38764064,09/02/2023,32.87,855.6
38764064,11/02/2023,9.25,864.85
38764064,13/02/2023,96.51,961.36
38764064,14/02/2023,58.88,1020.24
38780970,31/01/2023,,846.59
38780970,01/02/2023,-118.27,728.32
38780970,04/02/2023,117.26,845.58
38780970,07/02/2023,54.28,899.86
38780970,10/02/2023,47.87,947.73
38780970,13/02/2023,-838.9,108.83000000000004
38839019,31/01/2023,,187.15
38839019,01/02/2023,937.1,1124.25
38839019,01/02/2023,-52.99,1071.26
38839019,02/02/2023,-156.04,915.22
38839019,08/02/2023,113.98,1029.2
38839019,11/02/2023,106.4,1135.6
38839019,11/02/2023,-164.37,971.23
38839019,14/02/2023,170.57,1141.8
38903150,31/01/2023,,263.28
38903150,03/02/2023,-96.77,166.51
38903150,04/02/2023,-128.19,38.31999999999999
38903150,07/02/2023,-188.36,-150.04000000000002
38903150,10/02/2023,153.84,3.799999999999983
38903150,10/02/2023,84.17,87.96999999999998
38903150,11/02/2023,-133.59,-45.62000000000002
38903150,14/02/2023,-1157.1,-1202.72
38921478,31/01/2023,,641.48
38921478,02/02/2023,112.16,753.64
38921478,03/02/2023,-7.7,745.94
38921478,04/02/2023,-90.13,655.8100000000001
38921478,05/02/2023,69.58,725.39
38921478,05/02/2023,-1292.8,-567.41
38921478,07/02/2023,46.92,-520.49
38921478,10/02/2023,-114.74,-635.23
38921478,12/02/2023,105.2,-530.03
38921478,13/02/2023,-43.56,-573.5899999999999
38921478,14/02/2023,-130.84,-704.43
38957380,31/01/2023,,37.95
38957380,02/02/2023,-117.9,-79.95
38957380,03/02/2023,75.66,-4.290000000000006
38957380,04/02/2023,88.83,84.53999999999999
38957380,07/02/2023,-112.51,-27.970000000000013
38957380,07/02/2023,-123.7,-151.67000000000002
38957380,07/02/2023,-133.96,-285.63
38957380,10/02/2023,167.95,-117.68000000000004
38957380,10/02/2023,121.27,3.589999999999961
38957380,13/02/2023,-128.09,-124.50000000000004
38969279,31/01/2023,,195.74
38969279,02/02/2023,148.09,343.83000000000004
38969279,04/02/2023,1579.8,1923.63
38969279,04/02/2023,-5.54,1918.09
38969279,05/02/2023,177.45,2095.54
38969279,05/02/2023,-2160.7,-65.15999999999985
38969279,06/02/2023,1037.3,972.1400000000001
38969279,10/02/2023,1499.1,2471.24
38969279,12/02/2023,103.8,2575.04
38990596,31/01/2023,,108.78
38990596,03/02/2023,1462.8,1571.58
38990596,07/02/2023,1348.3,2919.88
38990596,07/02/2023,-24.33,2895.5499999999997
38990596,10/02/2023,125.04,3020.5899999999997
38990596,12/02/2023,-93.42,2927.17
38990596,13/02/2023,-122.16,2805.0099999999998
38991889,31/01/2023,,292.35
38991889,05/02/2023,-104.95,187.40000000000003
38991889,08/02/2023,-162.63,24.77000000000004
38991889,10/02/2023,23.96,48.73000000000004
38991889,10/02/2023,-75.71,-26.979999999999954
38991889,12/02/2023,129.0,102.02000000000004
38991889,14/02/2023,-38.92,63.10000000000004
39001531,31/01/2023,,882.34
39001531,03/02/2023,-68.13,814.21
39001531,06/02/2023,-48.43,765.7800000000001
39001531,10/02/2023,-167.95,597.83
39001531,13/02/2023,-110.74,487.09000000000003
39013360,31/01/2023,,987.76
39013360,02/02/2023,111.21,1098.97
39013360,03/02/2023,183.87,1282.84
39013360,07/02/2023,-80.19,1202.65
39013360,12/02/2023,160.33,1362.98
39013360,12/02/2023,114.77,1477.75
39013360,12/02/2023,108.16,1585.91
39013360,12/02/2023,93.42,1679.33
39013360,12/02/2023,-1663.0,16.329999999999927
39061853,31/01/2023,,353.93
39061853,01/02/2023,98.05,451.98
39061853,03/02/2023,118.33,570.31
39061853,03/02/2023,106.6,676.91
39061853,04/02/2023,74.21,751.12
39061853,04/02/2023,0.23,751.35
39061853,04/02/2023,-58.86,692.49
39061853,05/02/2023,-117.54,574.95
39061853,07/02/2023,-100.32,474.63
39061853,09/02/2023,-185.1,289.53
39061853,12/02/2023,-86.65,202.88
39061853,14/02/2023,-82.4,120.47999999999999
39093565,31/01/2023,,107.2
39093565,04/02/2023,-178.94,-71.74
39093565,08/02/2023,-1872.8,-1944.54
39093565,10/02/2023,92.49,-1852.05
39097663,31/01/2023,,326.42
39097663,02/02/2023,124.78,451.20000000000005
39097663,08/02/2023,67.17,518.37
39097663,12/02/2023,125.48,643.85
39097663,12/02/2023,-40.07,603.78
39122920,31/01/2023,,445.68
39122920,08/02/2023,124.8,570.48
39122920,08/02/2023,66.97,637.45
39122920,09/02/2023,134.75,772.2
39122920,10/02/2023,124.93,897.13
39122920,12/02/2023,56.08,953.21
39122920,12/02/2023,-111.7,841.51
39122920,13/02/2023,96.04,937.55
39122920,13/02/2023,22.49,960.04
39122920,14/02/2023,-75.01,885.03
39122920,14/02/2023,-142.18,742.8499999999999
39123048,31/01/2023,,687.59
39123048,01/02/2023,83.41,771.0
39123048,01/02/2023,-92.64,678.36
39123048,03/02/2023,-87.46,590.9000000000001
39123048,03/02/2023,-513.3,77.60000000000014
39123048,08/02/2023,-135.88,-58.27999999999986
39123048,09/02/2023,-140.35,-198.62999999999985
39123048,09/02/2023,-157.79,-356.41999999999985
39123048,10/02/2023,-13.9,-370.3199999999998
39123048,12/02/2023,-122.43,-492.7499999999999
39123048,14/02/2023,140.0,-352.7499999999999
39160879,31/01/2023,,444.15
39160879,01/02/2023,-186.89,257.26
39160879,04/02/2023,133.05,390.31
39160879,13/02/2023,838.9,1229.21
39160879,14/02/2023,302.7,1531.9099999999999
39161053,31/01/2023,,375.28
39161053,01/02/2023,142.14,517.42
39161053,01/02/2023,-156.89,360.53
39161053,02/02/2023,93.84,454.37
39161053,03/02/2023,103.43,557.8
39161053,05/02/2023,480.6,1038.4
39161053,05/02/2023,-137.15,901.25
39161053,07/02/2023,53.14,954.39
39161053,14/02/2023,-114.68,839.7099999999999
39267013,31/01/2023,,516.74
39267013,02/02/2023,-1495.8,-979.06
39267013,03/02/2023,-67.76,-1046.82
39267013,04/02/2023,-68.14,-1114.96
39267013,12/02/2023,-89.62,-1204.58
39267013,14/02/2023,-143.79,-1348.37
39298122,31/01/2023,,607.25
39298122,01/02/2023,135.0,742.25
39298122,02/02/2023,122.54,864.79
39298122,03/02/2023,193.29,1058.08
39298122,06/02/2023,-885.9,172.18000000000006
39298122,08/02/2023,-154.47,17.710000000000065
39298122,12/02/2023,-53.57,-35.859999999999935
39298122,13/02/2023,-32.94,-68.79999999999993
39360799,31/01/2023,,379.72
39360799,01/02/2023,-98.45,281.27000000000004
39360799,01/02/2023,-137.25,144.02000000000004
39360799,01/02/2023,-1634.7,-1490.68
39360799,07/02/2023,43.24,-1447.44
39360799,13/02/2023,117.96,-1329.48
39386771,31/01/2023,,171.52
39386771,02/02/2023,99.44,270.96000000000004
39386771,02/02/2023,-87.3,183.66000000000003
39386771,04/02/2023,-94.61,89.05000000000001
39386771,04/02/2023,-162.76,-73.70999999999998
39386771,10/02/2023,107.08,33.37000000000002
39386771,10/02/2023,85.88,119.25000000000001
39386771,10/02/2023,-57.19,62.06000000000002
39398476,31/01/2023,,541.52
39398476,02/02/2023,106.61,648.13
39398476,07/02/2023,116.86,764.99
39398476,10/02/2023,100.16,865.15
39400991,31/01/2023,,896.44
39400991,05/02/2023,10.32,906.7600000000001
39400991,11/02/2023,38.45,945.21
39400991,13/02/2023,93.58,1038.79
39402264,31/01/2023,,993.04
39402264,01/02/2023,1255.3,2248.34
39402264,05/02/2023,126.99,2375.33
39402264,07/02/2023,99.51,2474.84
39402264,07/02/2023,-98.93,2375.91
39402264,11/02/2023,-1949.6,426.30999999999995
39402264,14/02/2023,-117.68,308.62999999999994
39402264,14/02/2023,-241.71,66.91999999999993
39427922,31/01/2023,,794.1
39427922,01/02/2023,-131.53,662.57
39427922,02/02/2023,145.85,808.4200000000001
39427922,03/02/2023,140.5,948.9200000000001
39427922,04/02/2023,-163.28,785.64
39427922,07/02/2023,-146.82,638.82
39427922,08/02/2023,-117.07,521.75
39427922,13/02/2023,30.41,552.1600000000001
39427922,14/02/2023,-163.28,388.88
39491241,31/01/2023,,564.0
39491241,02/02/2023,100.0,664.0
39491241,05/02/2023,122.18,786.1800000000001
39491241,06/02/2023,79.45,865.63
39491241,08/02/2023,115.63,981.26
39491241,12/02/2023,80.63,1061.89
39491241,12/02/2023,-120.9,940.99
39502821,31/01/2023,,924.88
39502821,03/02/2023,321.6,1246.48
39502821,03/02/2023,-28.45,1218.03
39502821,05/02/2023,26.93,1244.96
39502821,09/02/2023,-59.28,1185.68
39502821,09/02/2023,-136.48,1049.2
39502821,12/02/2023,-206.28,842.9200000000001
39504855,31/01/2023,,890.63
39504855,02/02/2023,118.6,1009.23
39504855,05/02/2023,-124.37,884.86
39504855,06/02/2023,55.26,940.12
39504855,11/02/2023,1000.2,1940.3200000000002
39504855,11/02/2023,-93.32,1847.0
39504855,12/02/2023,3.07,1850.0700000000002
39504855,14/02/2023,-72.35,1777.72
39516154,31/01/2023,,620.87
39516154,02/02/2023,-1273.1,-652.2299999999999
39516154,06/02/2023,22.66,-629.5699999999999
39516154,11/02/2023,-1094.0,-1723.57
39516154,12/02/2023,-106.02,-1829.59
39516154,13/02/2023,157.09,-1672.5
39516154,13/02/2023,-62.08,-1734.58
39516203,31/01/2023,,689.19
39516203,03/02/2023,129.19,818.3800000000001
39516203,07/02/2023,-186.08,632.3000000000001
39516203,10/02/2023,93.02,725.32
39516203,11/02/2023,30.47,755.7900000000001
39516203,11/02/2023,23.0,778.7900000000001
39516203,13/02/2023,-112.31,666.48
39516203,14/02/2023,172.96,839.44
39529729,31/01/2023,,425.66
39529729,01/02/2023,86.44,512.1
39529729,02/02/2023,38.74,550.84
39529729,06/02/2023,35.38,586.22
39529729,07/02/2023,-78.85,507.37
39529729,11/02/2023,-226.92,280.45000000000005
39529729,12/02/2023,100.01,380.46000000000004
39529729,13/02/2023,-63.85,316.61000000000007
39542358,31/01/2023,,671.28
39542358,06/02/2023,-48.45,622.8299999999999
39542358,07/02/2023,107.26,730.0899999999999
39542358,08/02/2023,522.3,1252.3899999999999
39542358,08/02/2023,257.4,1509.79
39542358,08/02/2023,-71.61,1438.1799999999998
39542358,10/02/2023,-125.04,1313.1399999999999
39542358,11/02/2023,2361.6,3674.74
39542358,11/02/2023,1168.2,4842.94
39542358,11/02/2023,-62.18,4780.76
39590347,31/01/2023,,180.22
39590347,04/02/2023,-35.8,144.42000000000002
39590347,05/02/2023,-101.45,42.97
39590347,09/02/2023,-165.46,-122.49000000000001
39590347,12/02/2023,-57.89,-180.38
39590347,12/02/2023,-133.67,-314.05
39602737,31/01/2023,,881.44
39602737,06/02/2023,83.89,965.33
39602737,13/02/2023,-95.71,869.6200000000001
39620163,31/01/2023,,126.08
39620163,03/02/2023,-126.76,-0.6800000000000068
39620163,05/02/2023,-193.2,-193.88
39620163,09/02/2023,-59.74,-253.62
39620163,10/02/2023,27.61,-226.01
39620163,12/02/2023,122.43,-103.57999999999998
39620163,12/02/2023,-105.79,-209.37
39620163,14/02/2023,-99.23,-308.6
39623640,31/01/2023,,617.74
39623640,03/02/2023,141.26,759.0
39623640,03/02/2023,62.98,821.98
39623640,03/02/2023,-163.12,658.86
39623640,09/02/2023,-136.79,522.0699999999999
39623640,09/02/2023,-176.29,345.78
39623640,10/02/2023,-186.7,159.08
39623640,11/02/2023,94.12,253.20000000000002
39662559,31/01/2023,,536.88
39662559,06/02/2023,106.77,643.65
39662559,08/02/2023,-45.23,598.42
39662559,09/02/2023,140.11,738.53
39662559,09/02/2023,78.03,816.56
39662559,13/02/2023,45.1,861.66
39684993,31/01/2023,,168.99
39684993,03/02/2023,612.6,781.59
39684993,04/02/2023,102.22,883.8100000000001
39684993,05/02/2023,27.15,910.96
39684993,06/02/2023,-146.22,764.74
39684993,08/02/2023,83.02,847.76
39684993,14/02/2023,47.11,894.87
39710099,31/01/2023,,155.88
39710099,01/02/2023,105.76,261.64
39710099,02/02/2023,-191.44,70.19999999999999
39710099,05/02/2023,-63.96,6.239999999999988
39710099,09/02/2023,-105.33,-99.09
39710099,11/02/2023,-82.76,-181.85000000000002
39710099,13/02/2023,-211.13,-392.98
39744047,31/01/2023,,505.93
39744047,08/02/2023,103.57,609.5
39744047,14/02/2023,1583.4,2192.9
39744047,14/02/2023,-55.79,2137.11
39749381,31/01/2023,,576.13
39749381,02/02/2023,-70.63,505.5
39749381,03/02/2023,16.93,522.43
39749381,03/02/2023,-207.91,314.52
39749381,04/02/2023,91.7,406.22
39749381,06/02/2023,158.11,564.33
39749381,06/02/2023,142.55,706.8800000000001
39749381,08/02/2023,183.05,889.9300000000001
39749381,08/02/2023,49.6,939.5300000000001
39749381,09/02/2023,-156.71,782.82
39749381,11/02/2023,-143.94,638.8800000000001
39749381,14/02/2023,52.36,691.24
39772392,31/01/2023,,370.34
39772392,01/02/2023,101.28,471.62
39772392,01/02/2023,-116.66,354.96
39772392,02/02/2023,179.0,533.96
39772392,03/02/2023,7.7,541.66
39772392,08/02/2023,38.27,579.93
39772392,09/02/2023,-108.57,471.36
39772392,10/02/2023,171.22,642.5799999999999
39822234,31/01/2023,,718.73
39822234,02/02/2023,681.0,1399.73
39822234,02/02/2023,97.9,1497.63
39822234,04/02/2023,113.62,1611.25
39822234,05/02/2023,17.88,1629.13
39822234,09/02/2023,159.54,1788.67
39822234,09/02/2023,40.77,1829.44
39822234,10/02/2023,-849.7,979.74
39822234,14/02/2023,64.1,1043.84
39863459,31/01/2023,,387.4
39863459,02/02/2023,-121.1,266.29999999999995
39863459,04/02/2023,-48.63,217.67
39863459,13/02/2023,101.87,319.53999999999996
39863459,13/02/2023,-123.49,196.05
39875057,31/01/2023,,126.02
39875057,05/02/2023,-149.4,-23.38000000000001
39875057,09/02/2023,-115.89,-139.27
39875057,11/02/2023,96.34,-42.93000000000001
39875057,11/02/2023,-126.5,-169.43
39875057,13/02/2023,153.16,-16.27000000000001
39875057,14/02/2023,-104.45,-120.72000000000001
39920664,31/01/2023,,627.45
39920664,06/02/2023,101.84,729.2900000000001
39920664,10/02/2023,190.65,919.94
39920664,10/02/2023,-72.61,847.33
39974803,31/01/2023,,567.93
39974803,04/02/2023,85.93,653.8599999999999
39974803,04/02/2023,-39.82,614.04
39974803,07/02/2023,-131.84,482.19999999999993
39974803,08/02/2023,86.91,569.1099999999999
39974803,10/02/2023,74.29,643.4
40004707,31/01/2023,,206.15
40004707,04/02/2023,74.84,280.99
40004707,12/02/2023,111.7,392.69
40039031,31/01/2023,,124.72
40039031,02/02/2023,792.0,916.72
40039031,07/02/2023,-1581.8,-665.0799999999999
40039031,08/02/2023,157.28,-507.79999999999995
40039031,08/02/2023,-35.13,-542.93
40039031,09/02/2023,97.15,-445.7799999999999
40039031,12/02/2023,-43.72,-489.4999999999999
40039031,14/02/2023,-134.52,-624.02
40048102,31/01/2023,,519.25
40048102,03/02/2023,103.29,622.54
40048102,06/02/2023,-43.89,578.65
40048102,08/02/2023,-811.2,-232.55000000000007
40048102,09/02/2023,-119.86,-352.4100000000001
40048102,10/02/2023,168.35,-184.06000000000006
40048102,12/02/2023,20.81,-163.25000000000006
40082477,31/01/2023,,171.74
40082477,01/02/2023,-131.11,40.629999999999995
40082477,07/02/2023,86.16,126.78999999999999
40082477,09/02/2023,1434.1,1560.8899999999999
40082477,09/02/2023,135.47,1696.36
40082477,11/02/2023,-49.15,1647.2099999999998
40082477,13/02/2023,121.9,1769.11
40082477,14/02/2023,120.81,1889.9199999999998
40082950,31/01/2023,,322.41
40082950,04/02/2023,40.4,362.81
40082950,04/02/2023,-80.37,282.44000000000005
40082950,08/02/2023,169.4,451.84000000000003
40082950,08/02/2023,149.73,601.57
40082950,12/02/2023,171.12,772.69
40091206,31/01/2023,,812.34
40091206,01/02/2023,86.72,899.0600000000001
40091206,08/02/2023,-118.11,780.95
40091206,09/02/2023,-11.2,769.75
40091206,11/02/2023,-36.38,733.37
40091206,12/02/2023,157.02,890.3900000000001
40091206,13/02/2023,67.73,958.12
40098771,31/01/2023,,742.62
40098771,03/02/2023,-47.78,694.84
40098771,08/02/2023,-145.4,549.44
40098771,10/02/2023,62.82,612.26
40098771,10/02/2023,-93.3,518.96
40098771,11/02/2023,-60.09,458.87
40098771,14/02/2023,71.12,529.99
40098912,31/01/2023,,951.18
40098912,08/02/2023,54.56,1005.74
40098912,10/02/2023,78.83,1084.57
40098912,11/02/2023,47.98,1132.55
40098912,14/02/2023,109.46,1242.01
40112082,31/01/2023,,289.68
40112082,04/02/2023,-97.86,191.82
40112082,12/02/2023,-168.73,23.090000000000032
40112082,13/02/2023,-113.44,-90.34999999999997
40127778,31/01/2023,,196.74
40127778,01/02/2023,-85.77,110.97000000000001
40127778,02/02/2023,-205.49,-94.52
40127778,05/02/2023,-26.38,-120.89999999999999
40127778,05/02/2023,-179.9,-300.8
40127778,07/02/2023,-159.97,-460.77
40127778,10/02/2023,-90.86,-551.63
40127778,11/02/2023,-832.5,-1384.13
40127778,14/02/2023,-65.19,-1449.32
40176462,31/01/2023,,193.24
40176462,02/02/2023,744.2,937.44
40176462,05/02/2023,276.4,1213.8400000000001
40176462,06/02/2023,77.47,1291.31
40176462,08/02/2023,141.03,1432.3400000000001
40176462,10/02/2023,-116.72,1315.6200000000001
40176462,13/02/2023,33.75,1349.3700000000001
40189934,31/01/2023,,804.21
40189934,02/02/2023,1824.3,2628.51
40189934,04/02/2023,-1705.8,922.71
40189934,07/02/2023,64.02,986.73
40189934,13/02/2023,-108.27,878.46
40224914,31/01/2023,,53.1
40224914,01/02/2023,8.07,61.17
40224914,05/02/2023,-104.89,-43.72
40224914,13/02/2023,-39.74,-83.46000000000001
40224914,14/02/2023,91.53,8.069999999999993
40247376,31/01/2023,,209.78
40247376,02/02/2023,58.7,268.48
40247376,04/02/2023,-124.72,143.76
40247376,11/02/2023,-91.93,51.83
40247376,12/02/2023,-38.33,13.5
40247376,13/02/2023,-49.9,-36.4
40374724,31/01/2023,,692.58
40374724,01/02/2023,-187.15,505.43000000000006
40374724,02/02/2023,36.32,541.75
40374724,03/02/2023,105.36,647.11
40374724,04/02/2023,97.05,744.1600000000001
40374724,04/02/2023,84.48,828.6400000000001
40374724,04/02/2023,-40.4,788.24
40374724,05/02/2023,62.34,850.58
40374724,05/02/2023,-63.32,787.26
40374724,06/02/2023,-160.25,627.01
40374724,09/02/2023,-60.37,566.6400000000001
40374724,10/02/2023,58.79,625.4300000000001
40374724,14/02/2023,1139.7,1765.13
40374724,14/02/2023,-95.2,1669.93
40436811,31/01/2023,,445.93
40436811,03/02/2023,-40.33,405.6
40436811,03/02/2023,-55.47,350.13
40436811,08/02/2023,-66.67,283.46000000000004
40436811,11/02/2023,42.48,325.94
40436811,13/02/2023,30.92,356.86
40436811,13/02/2023,-81.01,275.85
40507682,31/01/2023,,524.63
40507682,01/02/2023,86.68,611.31
40507682,02/02/2023,-83.88,527.4300000000001
40507682,08/02/2023,53.13,580.5600000000001
40507682,10/02/2023,-74.41,506.15
40507682,12/02/2023,118.43,624.58
40507682,12/02/2023,-77.47,547.11
40507682,13/02/2023,76.49,623.6
40507682,14/02/2023,1514.1,2137.7
40530538,31/01/2023,,364.98
40530538,06/02/2023,-13.61,351.37
40530538,06/02/2023,-16.08,335.29
40530538,06/02/2023,-87.21,248.08000000000004
40530538,07/02/2023,166.24,414.32000000000005
40530538,07/02/2023,27.47,441.7900000000001
40530538,13/02/2023,-112.38,329.4100000000001
40548885,31/01/2023,,160.32
40548885,04/02/2023,-25.82,134.5
40548885,05/02/2023,130.7,265.2
40548885,07/02/2023,117.32,382.52
40548885,12/02/2023,56.37,438.89
40548885,13/02/2023,334.9,773.79
40548885,14/02/2023,-68.84,704.9499999999999
40550712,31/01/2023,,511.4
40550712,05/02/2023,85.05,596.4499999999999
40550712,06/02/2023,-72.25,524.1999999999999
40550712,06/02/2023,-98.85,425.34999999999997
40550712,07/02/2023,-112.11,313.24
40550712,09/02/2023,-84.03,229.20999999999998
40550712,11/02/2023,149.28,378.49
40551490,31/01/2023,,569.45
40551490,04/02/2023,95.01,664.46
40551490,04/02/2023,-761.9,-97.43999999999994
40551490,05/02/2023,101.23,3.790000000000063
40551490,12/02/2023,76.51,80.30000000000007
40600852,31/01/2023,,15.08
40600852,01/02/2023,57.48,72.56
40600852,01/02/2023,32.39,104.94999999999999
40600852,06/02/2023,157.94,262.89
40600852,08/02/2023,-146.43,116.45999999999998
40600852,09/02/2023,24.49,140.95
40600852,10/02/2023,-34.9,106.04999999999998
40600852,11/02/2023,154.67,260.71999999999997
40600852,11/02/2023,-111.87,148.84999999999997
40600852,11/02/2023,-667.1,-518.25
40600852,13/02/2023,-93.21,-611.4600000000002
40631802,31/01/2023,,104.96
40631802,02/02/2023,136.28,241.24
40631802,02/02/2023,-528.9,-287.65999999999997
40631802,04/02/2023,189.3,-98.35999999999996
40631802,06/02/2023,136.61,38.25000000000006
40631802,08/02/2023,-714.2,-675.95
40631802,10/02/2023,-92.9,-768.85
40673170,31/01/2023,,124.66
40673170,01/02/2023,95.49,220.14999999999998
40673170,04/02/2023,-103.05,117.1
40673170,06/02/2023,-80.15,36.94999999999999
40673170,08/02/2023,123.3,160.25
40673170,13/02/2023,14.09,174.33999999999997
40712298,31/01/2023,,781.72
40712298,06/02/2023,107.96,889.6800000000001
40712298,07/02/2023,74.11,963.79
40712298,11/02/2023,147.09,1110.88
40745545,31/01/2023,,460.29
40745545,01/02/2023,-85.94,374.35
40745545,04/02/2023,-189.33,185.02
40745545,11/02/2023,159.21,344.23
40745545,11/02/2023,-100.04,244.19
40745545,12/02/2023,-139.58,104.61000000000001
40745545,13/02/2023,121.39,226.0
40745965,31/01/2023,,654.15
40745965,01/02/2023,-1264.3,-610.15
40745965,02/02/2023,-196.6,-806.75
40745965,03/02/2023,77.07,-729.68
40745965,05/02/2023,-98.72,-828.4
40745965,07/02/2023,-42.04,-870.4399999999999
40745965,08/02/2023,-100.85,-971.29
40745965,09/02/2023,111.83,-859.4599999999999
40745965,09/02/2023,-81.65,-941.11
40797438,31/01/2023,,679.38
40797438,01/02/2023,49.69,729.0699999999999
40797438,02/02/2023,-153.46,575.61
40797438,03/02/2023,116.69,692.3
40797438,04/02/2023,-77.37,614.93
40797438,06/02/2023,193.06,807.99
40797438,10/02/2023,98.45,906.4399999999999
40797438,12/02/2023,84.72,991.16
40797438,14/02/2023,-154.35,836.81
40813783,31/01/2023,,288.51
40813783,03/02/2023,130.36,418.87
40813783,06/02/2023,32.2,451.07
40813783,07/02/2023,119.18,570.25
40813783,14/02/2023,-182.1,388.15000000000003
40872555,31/01/2023,,115.88
40872555,02/02/2023,89.7,205.57999999999998
40872555,03/02/2023,-27.83,177.75
40872555,04/02/2023,-1218.0,-1040.25
40872555,12/02/2023,61.6,-978.65
40898013,31/01/2023,,650.33
40898013,04/02/2023,-115.27,535.0600000000001
40898013,04/02/2023,-245.23,289.83000000000004
40898013,05/02/2023,28.46,318.29
40898013,06/02/2023,-68.98,249.31000000000003
40898013,09/02/2023,-30.36,218.95000000000005
40898013,11/02/2023,130.61,349.56000000000006
40898013,13/02/2023,-145.19,204.37000000000006
40906801,31/01/2023,,83.77
40906801,01/02/2023,185.45,269.21999999999997
40906801,02/02/2023,-24.23,244.98999999999998
40906801,06/02/2023,-42.19,202.79999999999995
40906801,09/02/2023,1162.9,1365.7
40906801,09/02/2023,97.54,1463.24
40906801,09/02/2023,39.08,1502.3200000000002
40906801,09/02/2023,-100.36,1401.96
41022448,31/01/2023,,37.89
41022448,07/02/2023,168.78,206.67000000000002
41022448,10/02/2023,-180.01,26.659999999999997
41022448,13/02/2023,-168.95,-142.29
41022448,14/02/2023,161.34,19.05000000000001
41036701,31/01/2023,,249.29
41036701,01/02/2023,-802.6,-553.3100000000001
41036701,09/02/2023,109.88,-443.43000000000006
41036701,14/02/2023,823.0,379.56999999999994
41038634,31/01/2023,,802.08
41038634,02/02/2023,-37.84,764.24
41038634,11/02/2023,-202.15,562.09
41038634,14/02/2023,-120.81,441.28000000000003
41085190,31/01/2023,,78.73
41085190,03/02/2023,113.59,192.32
41085190,03/02/2023,-43.6,148.72
41085190,05/02/2023,37.99,186.71
41085190,07/02/2023,143.04,329.75
41085190,07/02/2023,-1522.0,-1192.25
41085190,08/02/2023,-118.54,-1310.79
41085190,08/02/2023,-1168.1,-2478.89
41085190,10/02/2023,1580.9,-897.9899999999998
41085190,12/02/2023,78.26,-819.7299999999998
41085190,14/02/2023,884.5,64.77000000000021
41085190,14/02/2023,43.95,108.72000000000021
41170515,31/01/2023,,713.46
41170515,03/02/2023,227.05,940.51
41170515,10/02/2023,-1147.5,-206.99
41194009,31/01/2023,,585.15
41194009,07/02/2023,-108.31,476.84
41194009,07/02/2023,-138.38,338.46
41194009,09/02/2023,145.82,484.28
41194009,12/02/2023,-104.69,379.59
41194009,13/02/2023,-53.28,326.30999999999995
41211432,31/01/2023,,205.0
41211432,01/02/2023,87.59,292.59000000000003
41211432,01/02/2023,-80.9,211.69
41211432,04/02/2023,129.37,341.06
41211432,07/02/2023,-60.73,280.33
41211432,08/02/2023,120.67,401.0
41211432,10/02/2023,-97.9,303.1
41211432,11/02/2023,-79.08,224.01999999999998
41245288,31/01/2023,,540.61
41245288,05/02/2023,92.78,633.39
41245288,10/02/2023,59.42,692.8100000000001
41245288,10/02/2023,34.9,727.71
41245288,11/02/2023,87.57,815.28
41245288,13/02/2023,-80.87,734.41
41245288,13/02/2023,-1088.0,-353.59000000000003
41245805,31/01/2023,,753.91
41245805,03/02/2023,-116.55,637.36
41245805,04/02/2023,900.7,1538.06
41245805,04/02/2023,-55.24,1482.8200000000002
41245805,04/02/2023,-176.15,1306.67
41252281,31/01/2023,,834.88
41252281,01/02/2023,148.34,983.22
41252281,03/02/2023,67.76,1050.98
41252281,03/02/2023,19.31,1070.29
41252281,03/02/2023,-89.06,981.23
41252281,05/02/2023,-89.54,891.69
41252281,09/02/2023,787.2,1678.89
41252281,10/02/2023,1052.9,2731.79
41282329,31/01/2023,,80.32
41282329,01/02/2023,-42.27,38.04999999999999
41282329,05/02/2023,1685.4,1723.45
41282329,09/02/2023,-112.38,1611.0700000000002
41282329,10/02/2023,75.67,1686.74
41282329,13/02/2023,1023.0,2709.74
41356963,31/01/2023,,398.3
41356963,04/02/2023,80.86,479.16
41356963,05/02/2023,74.98,554.14
41356963,05/02/2023,-98.47,455.67
41356963,06/02/2023,-125.59,330.08000000000004
41356963,09/02/2023,132.11,462.19000000000005
41420018,31/01/2023,,816.5
41420018,02/02/2023,-118.87,697.63
41420018,09/02/2023,-166.64,530.99
41420018,10/02/2023,114.86,645.85
41420018,13/02/2023,68.86,714.71
41420018,14/02/2023,96.41,811.12
41542689,31/01/2023,,246.73
41542689,03/02/2023,36.94,283.66999999999996
41542689,03/02/2023,-149.87,133.79999999999998
41542689,04/02/2023,-124.08,9.719999999999985
41542689,07/02/2023,-130.23,-120.51
41542689,11/02/2023,106.87,-13.64
41542689,12/02/2023,1255.7,1242.06
41542689,13/02/2023,-67.31,1174.75
41561470,31/01/2023,,750.8
41561470,01/02/2023,490.9,1241.6999999999998
41561470,03/02/2023,144.92,1386.62
41561470,04/02/2023,58.38,1445.0
41561470,05/02/2023,161.25,1606.25
41561470,08/02/2023,195.35,1801.6
41561470,11/02/2023,41.42,1843.02
41561470,14/02/2023,-1083.0,760.02
41574018,31/01/2023,,254.89
41574018,01/02/2023,160.61,415.5
41574018,01/02/2023,-19.88,395.62
41574018,05/02/2023,-118.39,277.23
41574018,09/02/2023,18.91,296.14
41574018,11/02/2023,58.37,354.51
41574018,12/02/2023,145.1,499.61
41574018,14/02/2023,40.82,540.4300000000001
41584073,31/01/2023,,561.74
41584073,03/02/2023,-46.59,515.15
41584073,04/02/2023,91.41,606.56
41584073,04/02/2023,34.22,640.78
41584073,05/02/2023,96.95,737.73
41584073,08/02/2023,-245.8,491.93
41584073,10/02/2023,133.89,625.8199999999999
41584073,11/02/2023,114.84,740.66
41584073,12/02/2023,-70.6,670.06
41664336,31/01/2023,,853.37
41664336,01/02/2023,45.11,898.48
41706310,31/01/2023,,126.08
41706310,01/02/2023,82.09,208.17000000000002
41706310,01/02/2023,71.89,280.06
41706310,01/02/2023,34.17,314.23
41706310,03/02/2023,89.33,403.56
41706310,04/02/2023,-88.18,315.38
41706310,05/02/2023,89.54,404.92
41706310,06/02/2023,-49.54,355.38
41706310,06/02/2023,-114.75,240.63
41706310,12/02/2023,-97.82,142.81
41716822,31/01/2023,,418.05
41716822,01/02/2023,78.07,496.12
41716822,06/02/2023,158.15,654.27
41716822,10/02/2023,106.77,761.04
41716822,10/02/2023,-143.3,617.74
41716822,11/02/2023,125.71,743.45
41716822,12/02/2023,-68.38,675.07
41716822,13/02/2023,-47.15,627.92
41741558,31/01/2023,,435.71
41741558,02/02/2023,-43.55,392.15999999999997
41741558,05/02/2023,57.79,449.95
41741558,05/02/2023,-97.55,352.4
41741558,06/02/2023,-86.91,265.49
41741558,07/02/2023,-112.5,152.98999999999998
41741558,09/02/2023,-58.59,94.39999999999998
41741558,09/02/2023,-101.51,-7.110000000000028
41741558,10/02/2023,-151.6,-158.71000000000004
41741558,11/02/2023,989.3,830.5899999999999
41755476,31/01/2023,,72.71
41755476,02/02/2023,205.22,277.93
41755476,02/02/2023,62.51,340.44
41755476,06/02/2023,59.59,400.03
41755476,14/02/2023,71.18,471.21
41773473,31/01/2023,,355.0
41773473,01/02/2023,68.47,423.47
41773473,06/02/2023,78.99,502.46
41773473,12/02/2023,-118.77,383.69
41778536,31/01/2023,,722.03
41778536,02/02/2023,132.64,854.67
41778536,07/02/2023,34.47,889.14
41778536,07/02/2023,-129.29,759.8499999999999
41778536,08/02/2023,-42.43,717.42
41778536,09/02/2023,859.1,1576.52
41778536,11/02/2023,-160.56,1415.96
41778536,12/02/2023,-150.22,1265.74
41778536,12/02/2023,-1499.6,-233.8599999999999
41778536,13/02/2023,112.18,-121.6799999999999
41778536,14/02/2023,141.62,19.94000000000011
41852767,31/01/2023,,993.36
41852767,01/02/2023,114.68,1108.04
41852767,03/02/2023,-106.35,1001.69
41852767,04/02/2023,207.89,1209.58
41852767,06/02/2023,155.92,1365.5
41852767,10/02/2023,92.13,1457.63
41852767,13/02/2023,-23.37,1434.26
41879906,31/01/2023,,29.05
41879906,01/02/2023,-80.81,-51.760000000000005
41879906,03/02/2023,105.23,53.47
41879906,06/02/2023,-46.31,7.159999999999997
41879906,09/02/2023,-65.76,-58.60000000000001
41879906,10/02/2023,958.6,900.0
41879906,10/02/2023,82.73,982.73
41879906,11/02/2023,-99.31,883.42
41881442,31/01/2023,,650.34
41881442,01/02/2023,-135.55,514.79
41881442,01/02/2023,-212.26,302.53000000000003
41881442,10/02/2023,-139.99,162.54000000000002
41881442,11/02/2023,114.97,277.51
41881442,12/02/2023,50.34,327.85
41881442,12/02/2023,26.35,354.20000000000005
41914097,31/01/2023,,921.06
41914097,02/02/2023,87.3,1008.3599999999999
41914097,03/02/2023,84.5,1092.86
41914097,04/02/2023,-95.13,997.7299999999999
41914097,07/02/2023,192.3,1190.03
41914097,07/02/2023,-61.37,1128.66
41914097,08/02/2023,-25.37,1103.29
41914097,08/02/2023,-86.91,1016.38
41914097,10/02/2023,-111.11,905.27
41914097,13/02/2023,93.82,999.0899999999999
41914097,13/02/2023,-44.17,954.92
41919083,31/01/2023,,884.52
41919083,01/02/2023,-164.31,720.21
41919083,03/02/2023,-99.68,620.53
41919083,07/02/2023,1738.7,2359.23
41919083,07/02/2023,109.89,2469.12
41919083,14/02/2023,86.17,2555.29
41919083,14/02/2023,-69.27,2486.02
41954037,31/01/2023,,768.8
41954037,08/02/2023,34.38,803.18
41954037,08/02/2023,-27.23,775.9499999999999
41954037,12/02/2023,-1015.8,-239.85000000000002
41954037,14/02/2023,-145.08,-384.93000000000006
41972741,31/01/2023,,374.09
41972741,02/02/2023,123.02,497.10999999999996
41972741,08/02/2023,88.5,585.61
41972741,09/02/2023,155.66,741.27
41972741,12/02/2023,57.33,798.6
41972741,13/02/2023,48.57,847.17
41981752,31/01/2023,,843.61
41981752,05/02/2023,-179.42,664.19
41981752,10/02/2023,1375.3,2039.49
41981752,10/02/2023,114.57,2154.06
41981752,11/02/2023,50.91,2204.97
42017456,31/01/2023,,947.67
42017456,04/02/2023,-55.98,891.6899999999999
42017456,04/02/2023,-132.12,759.5699999999999
42017456,05/02/2023,-62.54,697.03
42017456,06/02/2023,222.12,919.15
42017456,08/02/2023,-77.04,842.11
42017456,10/02/2023,66.19,908.3
42181728,31/01/2023,,51.89
42181728,02/02/2023,-87.3,-35.41
42181728,04/02/2023,-88.31,-123.72
42181728,05/02/2023,116.94,-6.780000000000001
42181728,06/02/2023,-98.86,-105.64
42181728,06/02/2023,-98.97,-204.61
42181728,07/02/2023,153.16,-51.44999999999999
42181728,08/02/2023,50.38,-1.069999999999986
42181728,13/02/2023,-60.63,-61.69999999999999
42202867,31/01/2023,,614.83
42202867,06/02/2023,117.02,731.85
42202867,06/02/2023,-82.67,649.1800000000001
42202867,07/02/2023,129.86,779.0400000000001
42202867,07/02/2023,57.45,836.49
42202867,10/02/2023,-85.13,751.36
42202867,11/02/2023,-177.1,574.26
42232896,31/01/2023,,647.99
42232896,02/02/2023,21.71,669.7
42232896,04/02/2023,-42.73,626.97
42232896,04/02/2023,-84.59,542.38
42232896,09/02/2023,97.8,640.1800000000001
42232896,10/02/2023,130.57,770.75
42232896,10/02/2023,74.94,845.69
42232896,13/02/2023,-74.01,771.68
42235537,31/01/2023,,165.2
42235537,01/02/2023,807.2,972.4000000000001
42235537,02/02/2023,-92.05,880.3500000000001
42235537,02/02/2023,-101.22,779.1300000000001
42235537,04/02/2023,-127.96,651.1700000000001
42235537,06/02/2023,-161.61,489.56000000000006
42235537,07/02/2023,-185.51,304.05000000000007
42235537,08/02/2023,167.23,471.2800000000001
42235537,08/02/2023,130.54,601.82
42235537,08/02/2023,-118.58,483.24000000000007
42235537,08/02/2023,-1244.2,-760.96
42235537,09/02/2023,101.12,-659.84
42235537,10/02/2023,118.64,-541.2
42235537,12/02/2023,119.03,-422.17
42235537,13/02/2023,-116.3,-538.47
42235537,14/02/2023,88.32,-450.15000000000003
42245590,31/01/2023,,229.01
42245590,01/02/2023,55.09,284.1
42245590,02/02/2023,120.7,404.8
42245590,07/02/2023,639.3,1044.1
42245590,09/02/2023,144.93,1189.03
42245590,09/02/2023,-137.79,1051.24
42245590,12/02/2023,134.05,1185.29
42245590,13/02/2023,0.22,1185.51
42255054,31/01/2023,,550.4
42255054,01/02/2023,129.39,679.79
42255054,01/02/2023,126.46,806.25
42255054,04/02/2023,292.64,1098.8899999999999
42255054,05/02/2023,144.67,1243.56
42255054,07/02/2023,-50.0,1193.56
42255054,08/02/2023,57.72,1251.28
42268900,31/01/2023,,521.35
42268900,01/02/2023,140.67,662.02
42268900,03/02/2023,177.67,839.69
42268900,03/02/2023,-85.29,754.4
42268900,03/02/2023,-97.5,656.9
42268900,05/02/2023,-46.87,610.03
42268900,08/02/2023,-103.7,506.33
42268900,09/02/2023,38.42,544.75
42300418,31/01/2023,,151.39
42300418,01/02/2023,-808.4,-657.01
42300418,04/02/2023,-950.2,-1607.21
42300418,11/02/2023,127.49,-1479.72
42311039,31/01/2023,,98.95
42311039,01/02/2023,156.73,255.68
42311039,03/02/2023,-8.57,247.10999999999999
42311039,05/02/2023,160.67,407.78
42311039,06/02/2023,-144.74,263.03999999999996
42311039,10/02/2023,39.22,302.26
42311039,10/02/2023,-124.46,177.79999999999995
42311039,13/02/2023,-128.84,48.95999999999998
42322494,31/01/2023,,486.58
42322494,03/02/2023,-15.35,471.22999999999996
42322494,06/02/2023,78.93,550.16
42322494,07/02/2023,-47.31,502.85
42322494,12/02/2023,110.14,612.99
42322494,12/02/2023,-101.4,511.59
42340050,31/01/2023,,935.61
42340050,01/02/2023,188.33,1123.94
42340050,01/02/2023,-3.55,1120.39
42340050,03/02/2023,-41.22,1079.17
42340050,05/02/2023,130.71,1209.88
42340050,07/02/2023,52.36,1262.24
42340050,11/02/2023,174.4,1436.64
42340050,12/02/2023,-170.0,1266.64
42340050,13/02/2023,-1678.8,-412.15999999999985
42396753,31/01/2023,,628.86
42396753,02/02/2023,-38.42,590.44
42396753,07/02/2023,98.66,689.1
42396753,08/02/2023,-95.14,593.96
42396753,08/02/2023,-194.3,399.65999999999997
42396753,09/02/2023,77.75,477.40999999999997
42509068,31/01/2023,,890.56
42509068,05/02/2023,127.52,1018.0799999999999
42509068,05/02/2023,-191.47,826.6099999999999
42509068,06/02/2023,97.06,923.67
42509068,11/02/2023,137.31,1060.98
42509068,12/02/2023,518.5,1579.48
42509068,14/02/2023,156.79,1736.27
42515631,31/01/2023,,186.74
42515631,09/02/2023,-117.38,69.36000000000001
42515631,10/02/2023,-64.12,5.240000000000009
42515631,10/02/2023,-121.27,-116.02999999999999
42515631,11/02/2023,116.46,0.4300000000000068
42515631,13/02/2023,186.35,186.78
42546381,31/01/2023,,409.3
42546381,05/02/2023,197.22,606.52
42546381,05/02/2023,-128.72,477.8
42546381,06/02/2023,-127.85,349.95000000000005
42546381,09/02/2023,61.15,411.1
42546381,14/02/2023,104.78,515.88
42589255,31/01/2023,,282.84
42589255,03/02/2023,240.55,523.39
42589255,03/02/2023,101.42,624.81
42589255,12/02/2023,-134.18,490.63
42602631,31/01/2023,,539.62
42602631,04/02/2023,-196.98,342.64
42602631,07/02/2023,-764.7,-422.06000000000006
42652193,31/01/2023,,566.53
42652193,04/02/2023,1465.5,2032.03
42652193,05/02/2023,-129.51,1902.52
42652193,10/02/2023,-89.09,1813.43
42652193,13/02/2023,-1062.5,750.9300000000001
42652193,14/02/2023,-174.26,576.6700000000001
42726921,31/01/2023,,590.15
42726921,05/02/2023,155.76,745.91
42726921,05/02/2023,-99.16,646.75
42726921,12/02/2023,1342.4,1989.15
42726921,12/02/2023,157.87,2147.02
42726928,31/01/2023,,601.3
42726928,01/02/2023,102.89,704.1899999999999
42726928,04/02/2023,-55.58,648.6099999999999
42726928,04/02/2023,-63.83,584.78
42726928,04/02/2023,-210.25,374.53
42726928,05/02/2023,181.42,555.9499999999999
42726928,06/02/2023,-52.22,503.72999999999996
42726928,06/02/2023,-63.33,440.4
42726928,06/02/2023,-75.55,364.84999999999997
42726928,12/02/2023,187.21,552.06
42726928,14/02/2023,-163.23,388.83
42746180,31/01/2023,,12.15
42746180,04/02/2023,-1610.8,-1598.6499999999999
42746180,05/02/2023,-8.72,-1607.37
42746180,07/02/2023,-79.0,-1686.37
42746180,08/02/2023,-92.43,-1778.8
42746180,09/02/2023,-176.97,-1955.77
42752982,31/01/2023,,526.19
42752982,06/02/2023,-106.97,419.22
42752982,07/02/2023,-192.3,226.92000000000004
42752982,11/02/2023,-43.78,183.14000000000004
42752982,14/02/2023,-12.8,170.34000000000003
42752982,14/02/2023,-42.9,127.44000000000004
42783101,31/01/2023,,289.82
42783101,01/02/2023,-61.16,228.66
42783101,06/02/2023,92.42,321.08
42783101,07/02/2023,-1035.2,-714.1200000000001
42783101,11/02/2023,125.65,-588.4700000000001
42783101,12/02/2023,-88.66,-677.1300000000001
42783101,13/02/2023,142.63,-534.5000000000001
42813808,31/01/2023,,633.08
42813808,08/02/2023,-129.37,503.71000000000004
42813808,09/02/2023,-125.63,378.08000000000004
42838186,31/01/2023,,466.48
42838186,01/02/2023,56.55,523.03
42838186,08/02/2023,-1382.5,-859.47
42838186,09/02/2023,1176.8,317.3299999999999
42838186,10/02/2023,-149.19,168.13999999999993
42882563,31/01/2023,,419.69
42882563,07/02/2023,-77.43,342.26
42889744,31/01/2023,,223.01
42889744,02/02/2023,98.78,321.78999999999996
42889744,03/02/2023,-175.68,146.10999999999999
42889744,04/02/2023,160.12,306.23
43017336,31/01/2023,,935.99
43017336,03/02/2023,-152.86,783.13
43017336,12/02/2023,-122.62,660.51
43017336,13/02/2023,196.46,856.97
43017336,14/02/2023,-96.78,760.19
43017598,31/01/2023,,151.6
43017598,02/02/2023,-148.35,3.25
43017598,07/02/2023,164.87,168.12
43017598,07/02/2023,-64.08,104.04
43017598,10/02/2023,-39.22,64.82000000000001
43017598,12/02/2023,-158.31,-93.49
43017598,13/02/2023,75.37,-18.11999999999999
43017598,13/02/2023,-77.47,-95.58999999999999
43017598,14/02/2023,-64.61,-160.2
43032836,31/01/2023,,386.83
43032836,01/02/2023,137.9,524.73
43032836,01/02/2023,132.52,657.25
43032836,01/02/2023,-52.56,604.69
43032836,02/02/2023,148.04,752.73
43032836,03/02/2023,136.92,889.65
43032836,03/02/2023,56.07,945.72
43032836,04/02/2023,-49.53,896.1899999999999
43032836,09/02/2023,-42.5,853.6899999999999
43032836,09/02/2023,-130.36,723.3299999999999
43064169,31/01/2023,,555.44
43064169,02/02/2023,27.69,583.1300000000001
43064169,03/02/2023,772.8,1355.93
43064169,03/02/2023,188.47,1544.4
43064169,03/02/2023,-141.26,1403.14
43064169,05/02/2023,974.8,2377.94
43064169,07/02/2023,-109.58,2268.36
43064169,07/02/2023,-124.55,2143.81
43064169,10/02/2023,-1289.6,854.21
43064169,11/02/2023,110.11,964.32
43064169,11/02/2023,75.76,1040.08
43064169,13/02/2023,-103.99,936.09
43074888,31/01/2023,,779.86
43074888,02/02/2023,-130.94,648.9200000000001
43074888,05/02/2023,112.03,760.95
43074888,05/02/2023,6.73,767.6800000000001
43074888,11/02/2023,991.6,1759.2800000000002
43074888,11/02/2023,104.39,1863.67
43074888,13/02/2023,61.19,1924.8600000000001
43080619,31/01/2023,,426.64
43080619,03/02/2023,-22.57,404.07
43080619,05/02/2023,17.93,422.0
43080619,08/02/2023,-53.32,368.68
43080619,09/02/2023,-112.69,255.98999999999998
43080619,13/02/2023,84.91,340.9
43140934,31/01/2023,,820.81
43140934,05/02/2023,160.91,981.7199999999999
43140934,05/02/2023,-57.87,923.8499999999999
43140934,10/02/2023,-150.39,773.4599999999999
43140934,14/02/2023,97.09,870.55
43140934,14/02/2023,-58.12,812.43
43257373,31/01/2023,,483.49
43257373,04/02/2023,46.93,530.42
43257373,04/02/2023,-135.72,394.70000000000005
43257373,06/02/2023,116.91,511.61
43257373,06/02/2023,-117.11,394.5
43257373,09/02/2023,96.17,490.67
43257373,12/02/2023,-129.61,361.06
43265708,31/01/2023,,814.0
43265708,03/02/2023,179.75,993.75
43265708,04/02/2023,95.37,1089.12
43265708,13/02/2023,65.62,1154.74
43265708,14/02/2023,117.3,1272.04
43312288,31/01/2023,,830.91
43312288,02/02/2023,-152.95,677.96
43312288,04/02/2023,-72.87,605.0899999999999
43312288,05/02/2023,-84.4,520.6899999999999
43312288,08/02/2023,110.55,631.24
43312288,13/02/2023,66.09,697.3299999999999
43312288,14/02/2023,-132.36,564.97
43329727,31/01/2023,,477.69
43329727,04/02/2023,-96.31,381.38
43329727,04/02/2023,-1231.2,-849.82
43329727,07/02/2023,144.16,-705.6600000000001
43329727,07/02/2023,-141.01,-846.6700000000001
43329727,08/02/2023,99.49,-747.1800000000001
43329727,13/02/2023,42.54,-704.6400000000001
43330367,31/01/2023,,172.38
43330367,02/02/2023,-52.78,119.6
43330367,06/02/2023,88.52,208.12
43330367,10/02/2023,-182.81,25.310000000000002
43330367,11/02/2023,24.9,50.21
43330367,13/02/2023,87.2,137.41
43338400,31/01/2023,,783.12
43338400,01/02/2023,-80.7,702.42
43338400,04/02/2023,-134.81,567.61
43338400,08/02/2023,147.81,715.4200000000001
43338400,08/02/2023,98.38,813.8
43338400,14/02/2023,2197.2,3011.0
43354643,31/01/2023,,863.38
43354643,02/02/2023,105.59,968.97
43354643,06/02/2023,-51.69,917.28
43354643,10/02/2023,98.85,1016.13
43354643,11/02/2023,125.91,1142.04
43365633,31/01/2023,,57.11
43365633,07/02/2023,-27.88,29.23
43365633,10/02/2023,-107.66,-78.42999999999999
43365633,13/02/2023,111.43,33.000000000000014
43368978,31/01/2023,,133.07
43368978,01/02/2023,55.49,188.56
43368978,06/02/2023,-172.68,15.879999999999995
43368978,06/02/2023,-202.83,-186.95000000000002
43368978,11/02/2023,64.21,-122.74000000000002
43387803,31/01/2023,,646.4
43387803,02/02/2023,57.84,704.24
43387803,03/02/2023,50.38,754.62
43387803,05/02/2023,128.94,883.56
43387803,05/02/2023,23.02,906.5799999999999
43387803,05/02/2023,-81.21,825.37
43387803,06/02/2023,71.54,896.91
43387803,10/02/2023,-113.99,782.92
43387803,10/02/2023,-249.81,533.11
43387803,11/02/2023,-139.14,393.97
43387803,14/02/2023,141.17,535.14
43417466,31/01/2023,,874.02
43417466,01/02/2023,66.84,940.86
43417466,07/02/2023,-84.97,855.89
43417466,12/02/2023,-153.64,702.25
43417466,14/02/2023,-195.84,506.40999999999997
43420385,31/01/2023,,881.49
43420385,02/02/2023,117.9,999.39
43420385,06/02/2023,-71.0,928.39
43420385,07/02/2023,52.52,980.91
43420385,09/02/2023,1522.7,2503.61
43420385,09/02/2023,129.19,2632.7999999999997
43420385,09/02/2023,-83.64,2549.16
43453543,31/01/2023,,890.67
43453543,01/02/2023,-98.39,792.28
43453543,02/02/2023,75.16,867.4399999999999
43453543,10/02/2023,130.32,997.76
43453543,12/02/2023,72.09,1069.85
43490748,31/01/2023,,807.92
43490748,01/02/2023,-143.86,664.06
43490748,07/02/2023,173.42,837.4799999999999
43490748,08/02/2023,66.93,904.41
43490748,10/02/2023,135.0,1039.4099999999999
43490748,13/02/2023,-82.37,957.04
43490748,13/02/2023,-102.44,854.5999999999999
43490748,14/02/2023,77.21,931.81
43499771,31/01/2023,,28.4
43499771,01/02/2023,78.47,106.87
43499771,06/02/2023,1003.2,1110.0700000000002
43499771,06/02/2023,77.81,1187.88
43499771,06/02/2023,-65.08,1122.8
43499771,07/02/2023,-75.13,1047.67
43499771,07/02/2023,-149.48,898.19
43499771,11/02/2023,143.86,1042.0500000000002
43499771,11/02/2023,-118.35,923.7
43499771,12/02/2023,-154.74,768.96
43499771,12/02/2023,-157.02,611.94
43499771,14/02/2023,228.87,840.8100000000001
43541008,31/01/2023,,413.2
43541008,01/02/2023,105.55,518.75
43541008,05/02/2023,-56.72,462.03
43541008,05/02/2023,-1144.8,-682.77
43541008,11/02/2023,-42.48,-725.25
43541008,13/02/2023,73.96,-651.29
43597919,31/01/2023,,906.64
43597919,03/02/2023,-95.54,811.1
43597919,06/02/2023,144.03,955.13
43597919,06/02/2023,-944.2,10.92999999999995
43597919,07/02/2023,1610.4,1621.33
43597919,08/02/2023,-87.01,1534.32
43597919,12/02/2023,1323.4,2857.7200000000003
43597919,12/02/2023,-114.06,2743.66
43597919,14/02/2023,44.44,2788.1
43616790,31/01/2023,,365.67
43616790,02/02/2023,62.33,428.0
43616790,05/02/2023,61.68,489.68
43616790,06/02/2023,-154.24,335.44
43616790,07/02/2023,139.63,475.07
43616790,08/02/2023,943.5,1418.57
43616790,08/02/2023,36.72,1455.29
43616790,09/02/2023,74.39,1529.6799999999998
43616790,09/02/2023,-1705.6,-175.92000000000007
43616790,13/02/2023,104.18,-71.74000000000007
43623061,31/01/2023,,724.39
43623061,02/02/2023,1502.2,2226.59
43623061,04/02/2023,-75.48,2151.11
43623061,11/02/2023,331.8,2482.91
43623061,12/02/2023,66.33,2549.24
43623061,12/02/2023,-76.84,2472.4
43623061,13/02/2023,-129.32,2343.08
43623061,14/02/2023,-49.38,2293.7
43623061,14/02/2023,-124.19,2169.5099999999998
43772330,31/01/2023,,701.52
43772330,03/02/2023,-169.95,531.5699999999999
43772330,05/02/2023,-143.73,387.84000000000003
43772330,06/02/2023,-97.33,290.51
43772330,08/02/2023,65.49,356.0
43772330,10/02/2023,98.76,454.76
43772330,11/02/2023,90.71,545.47
43772330,12/02/2023,45.77,591.24
43781476,31/01/2023,,28.83
43781476,01/02/2023,128.49,157.32
43781476,02/02/2023,115.98,273.3
43781476,02/02/2023,56.3,329.6
43781476,04/02/2023,143.83,473.43
43781476,06/02/2023,45.55,518.98
43781476,08/02/2023,-52.3,466.68
43781476,08/02/2023,-943.5,-476.82
43781476,13/02/2023,153.14,-323.68
43811112,31/01/2023,,99.92
43811112,02/02/2023,-97.69,2.230000000000004
43811112,05/02/2023,5.44,7.670000000000004
43811112,07/02/2023,1760.8,1768.47
43811112,08/02/2023,-99.77,1668.7
43811112,08/02/2023,-136.68,1532.02
43811112,09/02/2023,-1485.0,47.01999999999998
43811112,10/02/2023,-52.93,-5.910000000000018
43811112,13/02/2023,65.54,59.62999999999999
43811112,14/02/2023,93.12,152.75
43830772,31/01/2023,,158.17
43830772,03/02/2023,89.74,247.90999999999997
43843937,31/01/2023,,79.03
43843937,06/02/2023,67.96,146.99
43843937,09/02/2023,940.9,1087.8899999999999
43843937,10/02/2023,155.28,1243.17
43843937,11/02/2023,518.1,1761.27
43843937,13/02/2023,901.5,2662.77
43858112,31/01/2023,,641.78
43858112,01/02/2023,-102.95,538.8299999999999
43858112,02/02/2023,-39.75,499.08
43858112,04/02/2023,77.7,576.78
43858112,04/02/2023,-49.6,527.18
43858112,05/02/2023,-65.82,461.36
43858112,08/02/2023,-99.49,361.87
43858112,13/02/2023,90.0,451.87
43858112,13/02/2023,-118.46,333.40999999999997
43858112,14/02/2023,171.25,504.65999999999997
43858112,14/02/2023,-170.78,333.88
43860538,31/01/2023,,478.05
43860538,02/02/2023,-89.8,388.25
43860538,08/02/2023,69.75,458.0
43860538,12/02/2023,-53.98,404.02000000000004
43892675,31/01/2023,,997.95
43892675,03/02/2023,64.03,1061.98
43892675,07/02/2023,-150.57,911.4100000000001
43892675,08/02/2023,-80.77,830.6400000000001
43892675,14/02/2023,-53.35,777.2900000000001
43930935,31/01/2023,,651.22
43930935,04/02/2023,-21.78,629.44
43930935,04/02/2023,-120.69,508.75
43930935,09/02/2023,-63.04,445.71000000000004
43930935,12/02/2023,69.99,515.7
43930935,14/02/2023,-82.7,433.0
43979238,31/01/2023,,68.08
43979238,01/02/2023,170.96,239.04000000000002
43979238,03/02/2023,49.39,288.43
43979238,03/02/2023,-64.85,223.57999999999998
43979238,04/02/2023,115.27,338.85
43979238,06/02/2023,-178.37,160.48
43979238,12/02/2023,1486.8,1647.28
44007497,31/01/2023,,331.92
44007497,03/02/2023,41.22,373.14
44007497,05/02/2023,-87.07,286.07000000000005
44007497,06/02/2023,-39.91,246.16000000000003
44007497,07/02/2023,-54.52,191.64000000000001
44007497,08/02/2023,88.74,280.38
44007497,08/02/2023,61.39,341.77000000000004
44009985,31/01/2023,,763.43
44009985,02/02/2023,13.68,777.1099999999999
44009985,08/02/2023,-946.2,-169.09000000000015
44009985,10/02/2023,905.0,735.9099999999999
44009985,11/02/2023,102.26,838.1699999999998
44009985,11/02/2023,-60.05,778.1199999999999
44009985,13/02/2023,106.6,884.7199999999998
44009985,14/02/2023,-104.91,779.8099999999998
44019515,31/01/2023,,312.63
44019515,02/02/2023,116.25,428.88
44019515,04/02/2023,-151.32,277.56
44019515,06/02/2023,-38.7,238.86
44019515,06/02/2023,-102.12,136.74
44019515,07/02/2023,1159.5,1296.24
44019515,09/02/2023,80.13,1376.37
44019515,13/02/2023,101.48,1477.85
44066457,31/01/2023,,18.09
44066457,03/02/2023,1179.0,1197.09
44066457,03/02/2023,78.92,1276.01
44066457,03/02/2023,-92.94,1183.07
44066457,04/02/2023,21.78,1204.85
44066457,05/02/2023,102.9,1307.75
44066457,11/02/2023,103.18,1410.9299999999998
44066457,13/02/2023,-1226.1,184.82999999999993
44066457,14/02/2023,156.38,341.2099999999999
44066457,14/02/2023,-51.9,289.30999999999995
44066457,14/02/2023,-149.95,139.35999999999993
44075619,31/01/2023,,979.0
44075619,05/02/2023,217.15,1196.15
44075619,08/02/2023,-83.96,1112.19
44075619,08/02/2023,-108.51,1003.6800000000001
44075619,09/02/2023,97.39,1101.07
44075619,10/02/2023,92.21,1193.28
44075619,10/02/2023,50.52,1243.8
44075619,12/02/2023,-78.89,1164.91
44130477,31/01/2023,,918.0
44130477,04/02/2023,622.4,1540.4
44130477,04/02/2023,-66.17,1474.23
44130477,08/02/2023,137.66,1611.8899999999999
44130477,08/02/2023,129.87,1741.76
44130477,12/02/2023,-36.64,1705.12
44133867,31/01/2023,,358.61
44133867,03/02/2023,169.26,527.87
44133867,04/02/2023,-91.11,436.76
44133867,11/02/2023,851.2,1287.96
44133867,14/02/2023,26.02,1313.98
44140049,31/01/2023,,372.02
44140049,06/02/2023,-49.33,322.69
44140049,10/02/2023,84.47,407.15999999999997
44140049,10/02/2023,-114.57,292.59
44140049,11/02/2023,122.35,414.94
44140049,11/02/2023,-89.98,324.96
44140049,13/02/2023,77.8,402.76
44145489,31/01/2023,,635.75
44145489,03/02/2023,87.5,723.25
44145489,06/02/2023,51.69,774.94
44145489,10/02/2023,-79.08,695.86
44145489,11/02/2023,-55.33,640.53
44145489,12/02/2023,-1003.7,-363.1700000000001
44162563,31/01/2023,,325.77
44162563,09/02/2023,-1162.9,-837.1300000000001
44162563,11/02/2023,-41.42,-878.5500000000001
44162563,14/02/2023,-102.55,-981.1000000000001
44164363,31/01/2023,,998.43
44164363,02/02/2023,164.6,1163.03
44164363,02/02/2023,82.72,1245.75
44164363,03/02/2023,-155.02,1090.73
44164363,06/02/2023,-51.71,1039.02
44164363,09/02/2023,-72.19,966.8299999999999
44228646,31/01/2023,,651.3
44228646,03/02/2023,129.77,781.0699999999999
44228646,03/02/2023,-53.78,727.29
44228646,04/02/2023,1315.2,2042.49
44228646,05/02/2023,1144.8,3187.29
44228646,05/02/2023,112.01,3299.3
44228646,07/02/2023,36.15,3335.45
44228646,08/02/2023,1244.2,4579.65
44228646,08/02/2023,105.88,4685.53
44228646,09/02/2023,-101.37,4584.16
44228646,10/02/2023,46.55,4630.71
44228646,12/02/2023,-169.44,4461.27
44234432,31/01/2023,,399.17
44234432,01/02/2023,-127.46,271.71000000000004
44234432,06/02/2023,82.67,354.38
44234432,07/02/2023,-46.31,308.07000000000005
44234432,08/02/2023,-90.88,217.19000000000003
44234432,09/02/2023,156.08,373.27000000000004
44234432,09/02/2023,95.64,468.91
44234432,10/02/2023,180.0,648.9100000000001
44234432,11/02/2023,10.99,659.9
44234432,12/02/2023,140.79,800.69
44234432,14/02/2023,-191.09,609.6
44239230,31/01/2023,,390.94
44239230,01/02/2023,-189.46,201.48
44239230,06/02/2023,-68.72,132.76
44242297,31/01/2023,,388.02
44242297,01/02/2023,-136.95,251.07
44242297,03/02/2023,195.91,446.98
44242297,05/02/2023,962.0,1408.98
44242297,09/02/2023,170.19,1579.17
44242297,10/02/2023,46.07,1625.24
44242297,11/02/2023,102.02,1727.26
44242297,12/02/2023,1003.7,2730.96
44242297,12/02/2023,124.55,2855.51
44242297,13/02/2023,147.05,3002.56
44242297,14/02/2023,179.57,3182.13
44243236,31/01/2023,,797.95
44243236,01/02/2023,-54.25,743.7
44243236,02/02/2023,108.85,852.5500000000001
44243236,04/02/2023,51.81,904.36
44243236,11/02/2023,-123.03,781.33
44243236,12/02/2023,966.7,1748.0300000000002
44243236,14/02/2023,137.37,1885.4
44272912,31/01/2023,,448.18
44272912,01/02/2023,-142.26,305.92
44272912,07/02/2023,742.8,1048.72
44272912,07/02/2023,-18.61,1030.1100000000001
44272912,07/02/2023,-89.09,941.02
44272912,08/02/2023,113.46,1054.48
44272912,09/02/2023,78.16,1132.64
44272912,09/02/2023,38.09,1170.73
44272912,09/02/2023,-157.69,1013.04
44272912,11/02/2023,63.8,1076.84
44272912,12/02/2023,882.7,1959.54
44272912,14/02/2023,-118.75,1840.79
44281556,31/01/2023,,70.7
44281556,01/02/2023,-117.4,-46.7
44281556,08/02/2023,58.6,11.899999999999999
44310966,31/01/2023,,361.02
44310966,02/02/2023,107.8,468.82
44310966,03/02/2023,-136.66,332.15999999999997
44310966,05/02/2023,137.15,469.30999999999995
44310966,07/02/2023,-41.35,427.96
44310966,09/02/2023,-117.9,310.05999999999995
44310966,13/02/2023,113.3,423.35999999999996
44310966,14/02/2023,-0.36,422.99999999999994
44317934,31/01/2023,,920.21
44317934,01/02/2023,1888.2,2808.41
44317934,02/02/2023,-162.4,2646.01
44317934,10/02/2023,-206.87,2439.14
44317934,13/02/2023,117.77,2556.91
44331942,31/01/2023,,389.13
44331942,02/02/2023,225.34,614.47
44331942,03/02/2023,60.47,674.94
44331942,04/02/2023,49.6,724.54
44331942,12/02/2023,169.34,893.88
44358901,31/01/2023,,576.73
44358901,01/02/2023,-144.31,432.42
44358901,02/02/2023,137.17,569.59
44358901,03/02/2023,-117.51,452.08
44358901,04/02/2023,73.67,525.75
44358901,08/02/2023,1805.6,2331.35
44358901,10/02/2023,75.3,2406.65
44358901,11/02/2023,-40.81,2365.8399999999997
44358901,12/02/2023,88.66,2454.5
44364430,31/01/2023,,306.44
44364430,01/02/2023,-65.61,240.82999999999998
44364430,09/02/2023,-142.44,98.38999999999999
44364430,11/02/2023,116.14,214.52999999999997
44364430,11/02/2023,87.14,301.66999999999996
44364430,13/02/2023,216.37,518.04
44368280,31/01/2023,,291.54
44368280,03/02/2023,13.52,305.06
44368280,09/02/2023,-46.29,258.77000000000004
44368280,11/02/2023,-84.29,174.48000000000002
44368280,11/02/2023,-92.54,81.94000000000001
44368280,12/02/2023,19.56,101.50000000000001
44378133,31/01/2023,,721.21
44378133,01/02/2023,-12.5,708.71
44378133,02/02/2023,123.2,831.9100000000001
44378133,03/02/2023,100.38,932.2900000000001
44378133,03/02/2023,66.09,998.38
44378133,08/02/2023,44.49,1042.8700000000001
44378133,11/02/2023,-633.2,409.66999999999996
44378133,12/02/2023,-197.45,212.21999999999997
44378133,14/02/2023,-102.06,110.15999999999997
44378133,14/02/2023,-107.51,2.649999999999963
44389169,31/01/2023,,978.69
44389169,04/02/2023,-51.81,926.8800000000001
44389169,10/02/2023,-103.67,823.21
44389169,10/02/2023,-135.0,688.21
44413402,31/01/2023,,75.55
44413402,02/02/2023,23.22,98.77
44413402,08/02/2023,140.73,239.5
44413402,11/02/2023,-126.93,112.56999999999996
44427272,31/01/2023,,970.1
44427272,01/02/2023,-174.19,795.9100000000001
44427272,02/02/2023,2.63,798.5400000000001
44427272,05/02/2023,108.26,906.8000000000001
44427272,07/02/2023,97.67,1004.47
44427272,10/02/2023,-15.31,989.1600000000001
44474369,31/01/2023,,663.93
44474369,09/02/2023,64.46,728.39
44474369,09/02/2023,-97.79,630.5999999999999
44474369,10/02/2023,-71.41,559.1899999999999
44474369,11/02/2023,-120.57,438.61999999999995
44474369,12/02/2023,80.58,519.1999999999999
44474369,12/02/2023,69.4,588.5999999999999
44516940,31/01/2023,,930.17
44516940,01/02/2023,-182.19,747.98
44516940,06/02/2023,-172.27,575.7099999999999
44516940,08/02/2023,209.01,784.7199999999999
44516940,09/02/2023,-12.71,772.01
44516940,12/02/2023,165.18,937.1899999999999
44516940,12/02/2023,58.82,996.01
44516940,12/02/2023,-67.31,928.6999999999999
44537960,31/01/2023,,675.03
44537960,01/02/2023,-168.84,506.18999999999994
44537960,02/02/2023,95.09,601.28
44537960,06/02/2023,147.34,748.62
44537960,06/02/2023,-135.04,613.5799999999999
44537960,09/02/2023,-187.78,425.79999999999995
44537960,10/02/2023,-72.06,353.74
44537960,12/02/2023,-192.75,160.98999999999998
44537960,13/02/2023,-116.22,44.76999999999998
44564500,31/01/2023,,355.18
44564500,01/02/2023,215.02,570.2
44564500,03/02/2023,67.38,637.58
44564500,06/02/2023,34.38,671.96
44564500,10/02/2023,67.6,739.56
44586370,31/01/2023,,440.56
44586370,02/02/2023,-84.65,355.90999999999997
44586370,06/02/2023,-40.91,315.0
44586370,06/02/2023,-42.82,272.18
44586370,07/02/2023,1500.0,1772.18
44586370,07/02/2023,77.43,1849.6100000000001
44586370,08/02/2023,-166.36,1683.25
44586370,12/02/2023,117.51,1800.76
44586370,13/02/2023,-105.71,1695.0500000000002
44586370,14/02/2023,69.01,1764.0600000000002
44586370,14/02/2023,-52.78,1711.28
44626164,31/01/2023,,915.14
44626164,07/02/2023,65.37,980.51
44626164,09/02/2023,-1166.4,-185.8900000000001
44626164,14/02/2023,-124.79,-310.6800000000001
44662337,31/01/2023,,768.12
44662337,01/02/2023,119.68,887.8
44662337,09/02/2023,-140.49,747.31
44662337,14/02/2023,162.09,909.4
44701536,31/01/2023,,995.4
44701536,01/02/2023,-76.18,919.22
44701536,06/02/2023,-151.44,767.78
44701536,08/02/2023,110.6,878.38
44701536,08/02/2023,-117.22,761.16
44701536,10/02/2023,-117.1,644.06
44701536,11/02/2023,-75.88,568.18
44711172,31/01/2023,,382.83
44711172,02/02/2023,-174.75,208.07999999999998
44711172,04/02/2023,150.01,358.09
44711172,04/02/2023,141.33,499.41999999999996
44711172,08/02/2023,-81.17,418.25
44711172,13/02/2023,8.94,427.19
44759468,31/01/2023,,962.91
44759468,01/02/2023,-97.92,864.99
44759468,04/02/2023,141.71,1006.7
44759468,07/02/2023,84.46,1091.16
44759468,09/02/2023,-35.18,1055.98
44759468,10/02/2023,74.15,1130.13
44759468,10/02/2023,-105.35,1024.78
44759468,11/02/2023,-34.81,989.97
44759468,12/02/2023,-169.36,820.61
44759468,13/02/2023,-110.34,710.27
44794340,31/01/2023,,488.91
44794340,13/02/2023,-71.54,417.37
44812075,31/01/2023,,863.71
44812075,01/02/2023,601.7,1465.41
44812075,02/02/2023,116.1,1581.51
44812075,02/02/2023,-108.51,1473.0
44812075,06/02/2023,127.59,1600.5900000000001
44812075,12/02/2023,127.27,1727.8600000000001
44812075,13/02/2023,64.31,1792.17
44816910,31/01/2023,,185.51
44816910,01/02/2023,229.8,415.31
44816910,04/02/2023,89.58,504.89
44816910,05/02/2023,56.62,561.51
44816910,05/02/2023,-9.05,552.46
44816910,05/02/2023,-147.37,405.09000000000003
44816910,06/02/2023,30.45,435.54
44816910,07/02/2023,756.5,1192.04
44816910,08/02/2023,110.8,1302.84
44816910,13/02/2023,-32.01,1270.83
44816910,13/02/2023,-118.4,1152.4299999999998
44873253,31/01/2023,,660.51
44873253,03/02/2023,60.33,720.84
44873253,03/02/2023,8.57,729.41
44873253,05/02/2023,-93.57,635.84
44873253,07/02/2023,-113.43,522.41
44873253,10/02/2023,-93.74,428.67
44873253,10/02/2023,-192.26,236.41000000000003
44873253,11/02/2023,726.2,962.6100000000001
44902994,31/01/2023,,790.34
44902994,01/02/2023,85.77,876.11
44902994,02/02/2023,-174.13,701.98
44902994,03/02/2023,23.84,725.82
44902994,03/02/2023,-31.0,694.82
44902994,03/02/2023,-58.23,636.59
44902994,03/02/2023,-1259.6,-623.0099999999999
44902994,04/02/2023,94.29,-528.7199999999999
44902994,04/02/2023,76.17,-452.54999999999984
44902994,05/02/2023,99.16,-353.3899999999999
44902994,06/02/2023,-28.63,-382.01999999999987
44902994,08/02/2023,117.41,-264.6099999999999
44902994,13/02/2023,-61.69,-326.29999999999984
44912164,31/01/2023,,355.61
44912164,03/02/2023,-110.67,244.94
44912164,05/02/2023,-29.75,215.19
44912164,07/02/2023,-50.93,164.26000000000002
44912164,12/02/2023,25.82,190.08
44912164,13/02/2023,-128.76,61.32000000000002
44912164,14/02/2023,157.43,218.75000000000003
44912164,14/02/2023,49.38,268.13000000000005
45015534,31/01/2023,,215.54
45015534,06/02/2023,-154.92,60.620000000000005
45015534,07/02/2023,76.2,136.82
45015534,08/02/2023,1032.4,1169.22
45015534,09/02/2023,83.42,1252.64
45015570,31/01/2023,,905.57
45015570,01/02/2023,754.9,1660.47
45015570,01/02/2023,137.72,1798.19
45015570,06/02/2023,-72.7,1725.49
45015570,06/02/2023,-98.87,1626.6200000000001
45015570,07/02/2023,136.3,1762.92
45015570,08/02/2023,-150.64,1612.28
45015570,09/02/2023,-145.82,1466.46
45015570,13/02/2023,159.89,1626.35
45015570,14/02/2023,176.37,1802.72
45020832,31/01/2023,,104.89
45020832,02/02/2023,92.05,196.94
45020832,03/02/2023,89.95,286.89
45020832,05/02/2023,-158.24,128.64999999999998
45020832,09/02/2023,110.01,238.65999999999997
45020832,11/02/2023,42.85,281.51
45020832,11/02/2023,16.09,297.59999999999997
45021115,31/01/2023,,464.27
45021115,07/02/2023,116.04,580.31
45021115,08/02/2023,-189.71,390.59999999999997
45021115,10/02/2023,125.47,516.0699999999999
45021115,10/02/2023,62.01,578.0799999999999
45021115,11/02/2023,1813.6,2391.68
45021115,12/02/2023,41.2,2432.8799999999997
45021115,13/02/2023,-18.93,2413.95
45021398,31/01/2023,,783.24
45021398,02/02/2023,77.43,860.6700000000001
45021398,04/02/2023,515.6,1376.27
45021398,08/02/2023,-68.68,1307.59
45021398,10/02/2023,108.64,1416.23
45021398,10/02/2023,-72.23,1344.0
45021398,10/02/2023,-344.3,999.6999999999999
45026430,31/01/2023,,745.31
45026430,04/02/2023,178.94,924.25
45026430,07/02/2023,-36.73,887.52
45026430,09/02/2023,-148.45,739.0699999999999
45026430,10/02/2023,-55.29,683.78
45026430,11/02/2023,626.6,1310.38
45026430,13/02/2023,-85.75,1224.63
45027876,31/01/2023,,80.13
45027876,01/02/2023,72.35,152.48
45027876,01/02/2023,-57.48,95.0
45027876,01/02/2023,-170.25,-75.25
45027876,03/02/2023,-79.86,-155.11
45027876,04/02/2023,176.15,21.04000000000002
45027876,06/02/2023,-80.8,-59.75999999999998
45027876,07/02/2023,54.35,-5.409999999999975
45027876,07/02/2023,-227.16,-232.56999999999996
45027876,12/02/2023,-3.07,-235.63999999999996
45027876,14/02/2023,-85.41,-321.04999999999995
45029598,31/01/2023,,558.87
45029598,06/02/2023,-67.0,491.87
45029598,06/02/2023,-119.61,372.26
45029598,08/02/2023,-149.83,222.43
45029598,09/02/2023,76.46,298.89
45029598,09/02/2023,70.47,369.36
45029598,09/02/2023,-64.47,304.89
45029598,12/02/2023,7.46,312.35
45029598,14/02/2023,42.19,354.54
45029598,14/02/2023,-1338.4,-983.8600000000001
45067158,31/01/2023,,115.23
45067158,04/02/2023,-78.83,36.400000000000006
45067158,04/02/2023,-101.3,-64.89999999999999
45067158,04/02/2023,-102.44,-167.33999999999997
45067158,05/02/2023,106.32,-61.019999999999996
45067158,05/02/2023,-83.99,-145.01
45067158,09/02/2023,184.91,39.900000000000006
45067158,10/02/2023,177.19,217.09
45067158,11/02/2023,90.72,307.81
45089475,31/01/2023,,676.92
45089475,03/02/2023,-119.64,557.28
45089475,13/02/2023,-125.97,431.30999999999995
45089475,13/02/2023,-1582.4,-1151.0900000000001
45111669,31/01/2023,,459.28
45111669,01/02/2023,121.91,581.1899999999999
45111669,03/02/2023,16.43,597.62
45111669,10/02/2023,-116.33,481.28999999999996
45111669,11/02/2023,-84.36,396.92999999999995
45111669,14/02/2023,-173.04,223.89
45161114,31/01/2023,,282.6
45161114,01/02/2023,134.43,417.03000000000003
45161114,06/02/2023,132.91,549.94
45161114,10/02/2023,126.15,676.09
45196342,31/01/2023,,402.48
45196342,01/02/2023,-64.89,337.59000000000003
45196342,03/02/2023,-104.89,232.70000000000002
45196342,04/02/2023,136.46,369.16
45196342,10/02/2023,120.91,490.07000000000005
45196342,11/02/2023,-112.23,377.84000000000003
45196342,12/02/2023,-1192.7,-814.86
45238909,31/01/2023,,904.83
45238909,04/02/2023,120.85,1025.68
45238909,08/02/2023,751.9,1777.58
45238909,08/02/2023,-38.91,1738.67
45238909,13/02/2023,133.97,1872.64
45242171,31/01/2023,,174.66
45242171,04/02/2023,84.12,258.78
45242171,09/02/2023,-93.14,165.64
45242171,13/02/2023,73.31,238.95
45253870,31/01/2023,,273.37
45253870,07/02/2023,485.9,759.27
45253870,11/02/2023,-78.2,681.0699999999999
45253870,12/02/2023,142.98,824.05
45275334,31/01/2023,,49.55
45275334,02/02/2023,112.23,161.78
45275334,03/02/2023,-89.95,71.83
45397824,31/01/2023,,741.62
45397824,01/02/2023,-130.8,610.8199999999999
45397824,02/02/2023,177.51,788.3299999999999
45397824,03/02/2023,20.42,808.75
45397824,03/02/2023,-154.95,653.8
45397824,07/02/2023,-113.55,540.25
45397824,11/02/2023,46.65,586.9
45397824,12/02/2023,134.97,721.87
45397824,14/02/2023,-625.3,96.57000000000005
45519330,31/01/2023,,840.22
45519330,01/02/2023,-80.88,759.34
45519330,01/02/2023,-180.83,578.51
45519330,03/02/2023,240.26,818.77
45519330,07/02/2023,85.76,904.53
45519330,11/02/2023,-163.65,740.88
45519330,13/02/2023,25.59,766.47
45543867,31/01/2023,,419.92
45543867,01/02/2023,82.42,502.34000000000003
45543867,02/02/2023,117.71,620.05
45543867,03/02/2023,136.66,756.71
45543867,03/02/2023,106.43,863.14
45543867,07/02/2023,1522.0,2385.14
45543867,09/02/2023,100.78,2485.92
45543867,11/02/2023,-78.66,2407.2599999999998
45543867,13/02/2023,562.4,2969.66
45558696,31/01/2023,,760.19
45558696,02/02/2023,1890.0,2650.19
45558696,05/02/2023,-1526.1,1124.0900000000001
45558696,07/02/2023,42.19,1166.2800000000002
45558696,07/02/2023,-144.93,1021.3500000000001
45558696,07/02/2023,-173.42,847.9300000000002
45558696,08/02/2023,-62.15,785.7800000000002
45611838,31/01/2023,,784.55
45611838,03/02/2023,47.74,832.29
45611838,04/02/2023,46.49,878.78
45611838,04/02/2023,-53.51,825.27
45611838,06/02/2023,-97.64,727.63
45611838,07/02/2023,-69.22,658.41
45611838,09/02/2023,173.88,832.29
45611838,14/02/2023,122.61,954.9
45631973,31/01/2023,,762.7
45631973,01/02/2023,-187.01,575.69
45631973,04/02/2023,109.43,685.1200000000001
45631973,05/02/2023,-220.0,465.12000000000006
45631973,08/02/2023,-1428.0,-962.8799999999999
45631973,09/02/2023,105.79,-857.0899999999999
45631973,11/02/2023,-108.78,-965.8699999999999
45639009,31/01/2023,,489.05
45639009,04/02/2023,-72.72,416.33000000000004
45639009,04/02/2023,-108.24,308.09000000000003
45639009,05/02/2023,-5.44,302.65000000000003
45639009,05/02/2023,-72.56,230.09000000000003
45639009,09/02/2023,-44.94,185.15000000000003
45639009,12/02/2023,205.26,390.41
45639009,12/02/2023,-114.03,276.38
45688415,31/01/2023,,686.92
45688415,01/02/2023,1393.7,2080.62
45688415,03/02/2023,178.47,2259.09
45688415,07/02/2023,-121.91,2137.1800000000003
45688415,11/02/2023,96.36,2233.54
45688415,11/02/2023,-135.48,2098.06
45688415,13/02/2023,102.31,2200.37
45706674,31/01/2023,,390.73
45706674,01/02/2023,-1187.7,-796.97
45706674,04/02/2023,114.54,-682.4300000000001
45706674,04/02/2023,-141.31,-823.74
45706674,04/02/2023,-150.84,-974.58
45706674,05/02/2023,109.63,-864.95
45706674,06/02/2023,-60.77,-925.72
45706674,10/02/2023,-123.35,-1049.07
45706674,12/02/2023,-158.11,-1207.18
45740727,31/01/2023,,904.27
45740727,05/02/2023,149.91,1054.18
45740727,08/02/2023,-220.34,833.8399999999999
45740727,13/02/2023,155.36,989.2
45790907,31/01/2023,,567.67
45790907,01/02/2023,1264.3,1831.9699999999998
45790907,01/02/2023,112.34,1944.31
45790907,04/02/2023,133.0,2077.31
45790907,04/02/2023,-45.53,2031.78
45790907,05/02/2023,108.92,2140.7
45790907,05/02/2023,58.28,2198.98
45790907,07/02/2023,-67.95,2131.03
45790907,10/02/2023,-1275.4,855.6299999999999
45790907,12/02/2023,-144.32,711.31
45790907,14/02/2023,-67.85,643.4599999999999
45816894,31/01/2023,,227.68
45816894,02/02/2023,-81.01,146.67000000000002
45816894,08/02/2023,1006.9,1153.57
45816894,13/02/2023,-44.84,1108.73
45816894,13/02/2023,-152.58,956.1500000000001
45822265,31/01/2023,,881.34
45822265,02/02/2023,-180.16,701.1800000000001
45822265,03/02/2023,-113.78,587.4000000000001
45822265,05/02/2023,99.15,686.5500000000001
45822265,05/02/2023,-617.7,68.85000000000002
45822265,05/02/2023,-1152.5,-1083.65
45822265,11/02/2023,-86.28,-1169.93
45822265,11/02/2023,-140.15,-1310.0800000000002
45822265,12/02/2023,877.5,-432.58000000000015
45829157,31/01/2023,,361.77
45829157,01/02/2023,-147.6,214.17
45829157,03/02/2023,-183.87,30.299999999999983
45829157,05/02/2023,23.74,54.03999999999998
45829157,06/02/2023,156.97,211.01
45829157,08/02/2023,-80.46,130.54999999999995
45829157,10/02/2023,114.0,244.54999999999995
45829157,12/02/2023,89.04,333.59
45829157,14/02/2023,-153.48,180.10999999999999
45859156,31/01/2023,,644.5
45859156,01/02/2023,-146.02,498.48
45859156,02/02/2023,120.32,618.8
45859156,05/02/2023,166.03,784.8299999999999
45859156,07/02/2023,102.22,887.05
45859156,10/02/2023,1725.1,2612.1499999999996
45960045,31/01/2023,,853.47
45960045,03/02/2023,128.1,981.57
45960045,03/02/2023,49.28,1030.85
45960045,07/02/2023,-45.38,985.47
45960045,09/02/2023,120.08,1105.55
45960045,13/02/2023,-35.47,1070.08
45960045,13/02/2023,-48.13,1021.95
45974864,31/01/2023,,957.27
45974864,03/02/2023,-108.6,848.67
45974864,10/02/2023,120.81,969.48
45974864,13/02/2023,63.85,1033.33
45974864,14/02/2023,-43.42,989.91
46012936,31/01/2023,,120.79
46012936,03/02/2023,46.59,167.38
46012936,04/02/2023,-113.62,53.760000000000005
46012936,06/02/2023,55.52,109.28
46012936,13/02/2023,62.93,172.21
46012936,14/02/2023,-175.07,-2.859999999999985
46059921,31/01/2023,,905.78
46059921,01/02/2023,-95.21,810.5699999999999
46059921,02/02/2023,-79.3,731.27
46059921,10/02/2023,83.52,814.79
46059921,13/02/2023,9.8,824.59
46059921,14/02/2023,-147.85,676.74
46064017,31/01/2023,,672.77
46064017,02/02/2023,28.99,701.76
46064017,03/02/2023,129.73,831.49
46064017,05/02/2023,60.9,892.39
46064017,10/02/2023,1575.6,2467.99
46064017,11/02/2023,-471.8,1996.1899999999998
46064017,12/02/2023,145.68,2141.87
46064017,12/02/2023,-115.87,2025.9999999999998
46064017,13/02/2023,-800.9,1225.1
46064017,14/02/2023,141.13,1366.2299999999998
46067647,31/01/2023,,677.66
46067647,03/02/2023,-54.41,623.25
46067647,03/02/2023,-88.94,534.31
46067647,03/02/2023,-98.31,436.0
46067647,06/02/2023,64.29,500.28999999999996
46067647,08/02/2023,-43.9,456.39
46067647,13/02/2023,140.52,596.91
46067647,14/02/2023,101.91,698.8199999999999
46073044,31/01/2023,,957.36
46073044,06/02/2023,-158.15,799.21
46073044,08/02/2023,-265.04,534.17
46073044,11/02/2023,-121.51,412.65999999999997
46073044,14/02/2023,1879.5,2292.16
46073044,14/02/2023,155.82,2447.98
46085917,31/01/2023,,340.16
46085917,06/02/2023,104.85,445.01
46085917,08/02/2023,-110.8,334.21000000000004
46085917,08/02/2023,-1374.1,-1039.8899999999999
46085917,09/02/2023,-155.66,-1195.55
46085917,10/02/2023,90.3,-1105.2499999999998
46085917,11/02/2023,155.49,-949.7599999999999
46085917,13/02/2023,67.31,-882.4499999999998
46085917,13/02/2023,62.41,-820.0399999999998
46100177,31/01/2023,,979.25
46100177,02/02/2023,-93.98,885.27
46100177,02/02/2023,-681.0,204.26999999999998
46100177,03/02/2023,-42.34,161.92999999999998
46100177,06/02/2023,-74.62,87.30999999999997
46100177,08/02/2023,797.2,884.51
46100177,09/02/2023,99.44,983.95
46133743,31/01/2023,,862.26
46133743,02/02/2023,-100.0,762.26
46133743,06/02/2023,93.21,855.47
46133743,10/02/2023,29.52,884.99
46215382,31/01/2023,,549.77
46215382,03/02/2023,-76.11,473.65999999999997
46215382,03/02/2023,-152.95,320.71
46215382,03/02/2023,-1569.4,-1248.69
46215382,04/02/2023,-57.41,-1306.1000000000001
46215382,05/02/2023,-114.53,-1420.63
46215382,06/02/2023,171.29,-1249.3400000000001
46215382,07/02/2023,-167.72,-1417.06
46215382,10/02/2023,2084.1,667.04
46215382,11/02/2023,-56.36,610.68
46215382,13/02/2023,135.78,746.46
46215382,13/02/2023,-38.78,707.68
46230315,31/01/2023,,4.43
46230315,02/02/2023,120.61,125.03999999999999
46230315,04/02/2023,-153.16,-28.119999999999976
46230315,06/02/2023,-145.42,-173.53999999999996
46230315,13/02/2023,125.25,-48.289999999999964
46230315,13/02/2023,-66.15,-114.43999999999997
46231176,31/01/2023,,290.35
46231176,01/02/2023,162.41,452.76
46231176,01/02/2023,-1397.4,-944.6400000000001
46231176,02/02/2023,98.15,-846.4900000000001
46231176,05/02/2023,-46.86,-893.3500000000001
46231176,09/02/2023,625.1,-268.2500000000001
46231176,11/02/2023,-17.45,-285.7000000000001
46231176,12/02/2023,55.81,-229.8900000000001
46231176,12/02/2023,-37.7,-267.59000000000015
46231176,13/02/2023,94.69,-172.90000000000012
46231176,13/02/2023,-16.59,-189.49000000000012
46255563,31/01/2023,,565.42
46255563,01/02/2023,92.51,657.93
46255563,04/02/2023,-129.16,528.77
46255563,14/02/2023,-52.1,476.66999999999996
46255563,14/02/2023,-89.67,387.0
46322903,31/01/2023,,873.01
46322903,06/02/2023,-22.54,850.47
46322903,06/02/2023,-179.1,671.37
46322903,08/02/2023,66.39,737.76
46322903,08/02/2023,-206.07,531.69
46322903,09/02/2023,143.77,675.46
46322903,14/02/2023,81.74,757.2
46326165,31/01/2023,,571.8
46326165,03/02/2023,-94.28,477.52
46326165,06/02/2023,14.55,492.06999999999994
46326165,07/02/2023,-87.09,404.97999999999996
46326165,10/02/2023,143.62,548.5999999999999
46326165,12/02/2023,-99.3,449.29999999999995
46326165,13/02/2023,185.27,634.5699999999999
46346470,31/01/2023,,787.87
46346470,02/02/2023,-93.94,693.9300000000001
46346470,04/02/2023,-133.0,560.9300000000001
46346470,08/02/2023,-35.51,525.42
46346470,09/02/2023,70.29,595.71
46346470,11/02/2023,-118.19,477.52
46346470,12/02/2023,81.44,558.96
46346470,13/02/2023,-67.73,491.23
46355307,31/01/2023,,152.4
46355307,01/02/2023,-161.31,-8.909999999999997
46355307,02/02/2023,174.13,165.22
46355307,14/02/2023,-987.9,-822.68
46442210,31/01/2023,,732.14
46442210,02/02/2023,-118.22,613.92
46442210,06/02/2023,80.8,694.72
46442210,09/02/2023,-899.8,-205.07999999999993
46442210,11/02/2023,-23.58,-228.6599999999999
46442210,14/02/2023,34.84,-193.81999999999994
46479025,31/01/2023,,323.03
46479025,04/02/2023,88.89,411.91999999999996
46479025,04/02/2023,-45.51,366.40999999999997
46479025,11/02/2023,-90.03,276.38
46479025,12/02/2023,100.49,376.86999999999995
46479025,14/02/2023,-172.38,204.48999999999995
46525458,31/01/2023,,938.4
46525458,05/02/2023,-1748.6,-810.1999999999999
46525458,07/02/2023,1225.0,414.80000000000007
46525458,07/02/2023,153.96,568.7600000000001
46525458,10/02/2023,86.14,654.9000000000001
46525458,11/02/2023,-38.25,616.6500000000001
46525458,13/02/2023,-116.37,500.2800000000001
46552077,31/01/2023,,672.51
46552077,02/02/2023,-54.94,617.5699999999999
46552077,06/02/2023,-153.53,464.03999999999996
46561814,31/01/2023,,216.29
46561814,01/02/2023,70.34,286.63
46561814,06/02/2023,-106.0,180.63
46561814,07/02/2023,93.93,274.56
46561814,07/02/2023,-185.39,89.17000000000002
46561814,07/02/2023,-214.17,-124.99999999999997
46561814,09/02/2023,124.56,-0.4399999999999693
46561814,13/02/2023,-159.46,-159.89999999999998
46597215,31/01/2023,,455.5
46597215,06/02/2023,73.5,529.0
46597215,07/02/2023,165.34,694.34
46597215,08/02/2023,1123.1,1817.44
46597215,09/02/2023,-11.47,1805.97
46597728,31/01/2023,,920.72
46597728,04/02/2023,110.99,1031.71
46597728,05/02/2023,749.9,1781.6100000000001
46597728,06/02/2023,111.94,1893.55
46597728,13/02/2023,-165.07,1728.48
46597728,13/02/2023,-1856.7,-128.22000000000003
46643937,31/01/2023,,751.73
46643937,03/02/2023,61.92,813.65
46643937,07/02/2023,67.88,881.53
46643937,07/02/2023,-74.11,807.4200000000001
46643937,07/02/2023,-1348.3,-540.8799999999999
46643937,11/02/2023,226.92,-313.9599999999999
46643937,12/02/2023,1041.9,727.9400000000002
46643937,12/02/2023,76.94,804.8800000000001
46643937,14/02/2023,-110.66,694.2200000000001
46663039,31/01/2023,,989.43
46663039,01/02/2023,49.37,1038.8
46663039,03/02/2023,-52.27,986.53
46663039,03/02/2023,-119.2,867.3299999999999
46663039,06/02/2023,161.03,1028.36
46663039,06/02/2023,34.2,1062.56
46663039,09/02/2023,-813.0,249.55999999999995
46663039,12/02/2023,120.86,370.41999999999996
46663039,14/02/2023,-112.47,257.94999999999993
46730484,31/01/2023,,398.49
46730484,04/02/2023,111.88,510.37
46730484,10/02/2023,-111.05,399.32
46730484,11/02/2023,-63.08,336.24
46730484,13/02/2023,80.9,417.14
46730484,14/02/2023,-79.28,337.86
46741126,31/01/2023,,393.18
46741126,02/02/2023,-114.87,278.31
46741126,03/02/2023,-169.26,109.05000000000001
46741126,06/02/2023,-46.16,62.890000000000015
46741126,07/02/2023,-60.76,2.1300000000000168
46741126,10/02/2023,184.75,186.88000000000002
46741126,13/02/2023,-116.37,70.51000000000002
46768821,31/01/2023,,458.81
46768821,03/02/2023,90.12,548.9300000000001
46768821,04/02/2023,135.11,684.04
46768821,06/02/2023,124.41,808.45
46768821,08/02/2023,-132.61,675.84
46768821,13/02/2023,129.28,805.12
46790294,31/01/2023,,855.42
46790294,01/02/2023,-55.85,799.5699999999999
46790294,01/02/2023,-156.88,642.6899999999999
46790294,03/02/2023,-72.41,570.28
46790294,07/02/2023,87.09,657.37
46790294,08/02/2023,-98.38,558.99
46790294,09/02/2023,37.65,596.64
46792863,31/01/2023,,843.5
46792863,01/02/2023,-81.07,762.4300000000001
46792863,03/02/2023,87.36,849.79
46792863,06/02/2023,159.47,1009.26
46792863,07/02/2023,-84.66,924.6
46851905,31/01/2023,,18.23
46851905,01/02/2023,216.49,234.72
46851905,01/02/2023,-123.29,111.42999999999999
46851905,04/02/2023,196.98,308.40999999999997
46851905,05/02/2023,140.22,448.63
46851905,06/02/2023,441.4,890.03
46851905,09/02/2023,50.63,940.66
46854962,31/01/2023,,364.03
46854962,01/02/2023,35.88,399.90999999999997
46854962,01/02/2023,-81.49,318.41999999999996
46854962,02/02/2023,93.7,412.12
46854962,13/02/2023,104.27,516.39
46854962,14/02/2023,111.83,628.22
46854962,14/02/2023,-544.0,84.22000000000003
46879333,31/01/2023,,462.44
46879333,06/02/2023,-135.77,326.66999999999996
46879333,10/02/2023,38.95,365.62
46879333,14/02/2023,-79.28,286.34
46879333,14/02/2023,-128.86,157.47999999999996
46913859,31/01/2023,,410.19
46913859,01/02/2023,-119.68,290.51
46913859,05/02/2023,88.7,379.21
46913859,07/02/2023,126.94,506.15
46913859,08/02/2023,1127.1,1633.25
46913859,09/02/2023,-107.84,1525.41
46920610,31/01/2023,,124.16
46920610,01/02/2023,124.86,249.01999999999998
46920610,02/02/2023,25.85,274.87
46920610,05/02/2023,36.13,311.0
46920610,05/02/2023,-161.25,149.75
46920610,08/02/2023,-30.53,119.22
46920610,09/02/2023,-93.51,25.709999999999994
46925211,31/01/2023,,509.25
46925211,01/02/2023,189.46,698.71
46925211,09/02/2023,4.38,703.09
46925211,12/02/2023,-205.26,497.83000000000004
46925211,13/02/2023,49.89,547.72
47040996,31/01/2023,,462.95
47040996,01/02/2023,-130.83,332.12
47040996,02/02/2023,173.89,506.01
47040996,03/02/2023,121.3,627.31
47040996,04/02/2023,-98.52,528.79
47040996,07/02/2023,-89.73,439.05999999999995
47040996,09/02/2023,-76.61,362.44999999999993
47040996,12/02/2023,7.66,370.10999999999996
47091705,31/01/2023,,54.6
47091705,01/02/2023,-75.52,-20.919999999999995
47091705,02/02/2023,41.88,20.960000000000008
47091705,02/02/2023,-88.29,-67.33
47091705,03/02/2023,-67.38,-134.70999999999998
47091705,04/02/2023,95.6,-39.11
47091705,05/02/2023,1195.0,1155.89
47091705,05/02/2023,-142.28,1013.6100000000001
47091705,06/02/2023,92.29,1105.9
47091705,09/02/2023,1340.1,2446.0
47091705,14/02/2023,96.17,2542.17
47115177,31/01/2023,,759.59
47115177,01/02/2023,81.36,840.95
47115177,01/02/2023,-137.75,703.2
47115177,04/02/2023,110.0,813.2
47115177,06/02/2023,-527.4,285.80000000000007
47115177,09/02/2023,-136.48,149.32000000000008
47115177,11/02/2023,120.95,270.2700000000001
47115177,13/02/2023,167.82,438.0900000000001
47115177,13/02/2023,165.07,603.1600000000001
47115177,13/02/2023,72.13,675.2900000000001
47115177,14/02/2023,123.42,798.71
47127756,31/01/2023,,300.02
47127756,02/02/2023,-101.47,198.54999999999998
47127756,12/02/2023,-84.03,114.51999999999998
47133143,31/01/2023,,723.52
47133143,01/02/2023,-182.36,541.16
47133143,03/02/2023,33.17,574.3299999999999
47133143,07/02/2023,-57.45,516.88
47133143,13/02/2023,-31.07,485.80999999999995
47133143,14/02/2023,-41.25,444.55999999999995
47172665,31/01/2023,,11.06
47172665,08/02/2023,-80.13,-69.07
47172665,08/02/2023,-130.56,-199.63
47172665,13/02/2023,56.41,-143.22
47172665,13/02/2023,-25.59,-168.81
47172665,14/02/2023,135.61,-33.19999999999999
47226769,31/01/2023,,449.88
47226769,01/02/2023,126.5,576.38
47226769,04/02/2023,-132.93,443.45
47226769,06/02/2023,1065.6,1509.05
47226769,06/02/2023,-125.82,1383.23
47226769,07/02/2023,169.12,1552.35
47232232,31/01/2023,,53.44
47232232,01/02/2023,126.4,179.84
47232232,07/02/2023,-134.29,45.55000000000001
47232232,10/02/2023,-136.1,-90.54999999999998
47232232,12/02/2023,153.41,62.860000000000014
47232232,12/02/2023,-117.55,-54.68999999999998
47232232,12/02/2023,-157.46,-212.14999999999998
47266645,31/01/2023,,207.15
47266645,02/02/2023,876.4,1083.55
47266645,02/02/2023,-190.68,892.8699999999999
47266645,06/02/2023,122.69,1015.56
47266645,07/02/2023,-484.1,531.4599999999999
47266645,13/02/2023,138.4,669.8599999999999
47313428,31/01/2023,,204.67
47313428,03/02/2023,965.4,1170.07
47313428,08/02/2023,-113.3,1056.77
47313428,13/02/2023,-127.61,929.16
47356348,31/01/2023,,65.95
47356348,03/02/2023,1223.8,1289.75
47356348,13/02/2023,-139.98,1149.77
47406737,31/01/2023,,963.14
47406737,01/02/2023,844.6,1807.74
47406737,03/02/2023,-68.61,1739.13
47406737,06/02/2023,-1204.5,534.6300000000001
47406737,08/02/2023,24.94,559.5700000000002
47406737,09/02/2023,179.26,738.8300000000002
47406737,09/02/2023,-115.75,623.0800000000002
47406737,12/02/2023,144.32,767.4000000000001
47406737,12/02/2023,128.61,896.0100000000001
47406737,12/02/2023,52.46,948.4700000000001
47406737,14/02/2023,-129.18,819.2900000000001
47414258,31/01/2023,,900.7
47414258,06/02/2023,-27.94,872.76
47414258,06/02/2023,-123.37,749.3900000000001
47414258,06/02/2023,-184.01,565.3800000000001
47414258,07/02/2023,-1277.4,-712.02
47414258,08/02/2023,-63.1,-775.12
47414258,11/02/2023,108.92,-666.2
47414258,13/02/2023,-134.58,-800.78
47473145,31/01/2023,,801.43
47473145,12/02/2023,132.48,933.91
47473145,12/02/2023,-35.17,898.7399999999999
47483982,31/01/2023,,661.58
47483982,08/02/2023,-76.6,584.98
47483982,10/02/2023,74.87,659.85
47483982,11/02/2023,159.08,818.9300000000001
47483982,13/02/2023,1017.6,1836.5300000000002
47582488,31/01/2023,,744.99
47582488,02/02/2023,-124.68,620.31
47582488,03/02/2023,-55.81,564.5
47582488,05/02/2023,1.11,565.61
47582488,05/02/2023,-88.27,477.34000000000003
47582488,05/02/2023,-110.72,366.62
47582488,06/02/2023,87.2,453.82
47582488,07/02/2023,114.74,568.56
47582488,12/02/2023,-7.97,560.59
47582488,13/02/2023,-101.4,459.19
47654093,31/01/2023,,294.0
47654093,04/02/2023,-63.26,230.74
47654093,05/02/2023,161.8,392.54
47654093,10/02/2023,88.04,480.58000000000004
47654093,12/02/2023,109.8,590.38
47654093,12/02/2023,-191.46,398.92
47763906,31/01/2023,,980.42
47763906,02/02/2023,-20.57,959.8499999999999
47763906,02/02/2023,-187.19,772.66
47763906,07/02/2023,99.56,872.22
47763906,12/02/2023,7.97,880.1899999999999
47763906,12/02/2023,-210.36,669.8299999999999
47781255,31/01/2023,,462.62
47781255,02/02/2023,133.0,595.62
47781255,02/02/2023,-24.87,570.75
47781255,02/02/2023,-78.61,492.14
47781255,03/02/2023,101.07,593.21
47781255,05/02/2023,-67.95,525.26
47781255,08/02/2023,63.9,589.16
47781255,10/02/2023,34.35,623.51
47781255,14/02/2023,124.48,747.99
47808992,31/01/2023,,885.16
47808992,09/02/2023,197.63,1082.79
47808992,10/02/2023,106.19,1188.98
47808992,11/02/2023,-121.09,1067.8899999999999
47808992,12/02/2023,-44.96,1022.93
47824990,31/01/2023,,704.97
47824990,12/02/2023,86.17,791.14
47824990,13/02/2023,113.91,905.0500000000001
47886866,31/01/2023,,399.75
47886866,02/02/2023,-25.61,374.14
47886866,04/02/2023,105.17,479.31
47886866,07/02/2023,-110.79,368.52
47886866,10/02/2023,51.82,420.34
47886866,11/02/2023,125.01,545.35
47886866,11/02/2023,-133.59,411.76
47886866,14/02/2023,-32.8,378.96
47902339,31/01/2023,,919.92
47902339,05/02/2023,-65.25,854.67
47902339,06/02/2023,-80.92,773.75
47902339,10/02/2023,165.02,938.77
47932460,31/01/2023,,785.05
47932460,01/02/2023,-99.41,685.64
47932460,04/02/2023,204.89,890.53
47932460,04/02/2023,-220.77,669.76
47932460,07/02/2023,-81.45,588.31
47932460,08/02/2023,-124.98,463.3299999999999
47932460,09/02/2023,-27.53,435.79999999999995
47932460,11/02/2023,909.1,1344.9
47964895,31/01/2023,,982.97
47964895,04/02/2023,-111.88,871.09
47964895,05/02/2023,-184.78,686.3100000000001
47964895,07/02/2023,-46.27,640.0400000000001
47964895,14/02/2023,-109.46,530.58
48018851,31/01/2023,,288.26
48018851,05/02/2023,897.5,1185.76
48018851,07/02/2023,-101.82,1083.94
48018851,13/02/2023,85.75,1169.69
48018851,14/02/2023,144.57,1314.26
48029032,31/01/2023,,422.88
48029032,06/02/2023,69.2,492.08
48029032,06/02/2023,27.93,520.01
48029032,09/02/2023,98.06,618.0699999999999
48029032,09/02/2023,15.37,633.4399999999999
48029032,09/02/2023,-168.19,465.25
48029032,10/02/2023,-65.29,399.96
48029032,12/02/2023,92.12,492.08
48029032,12/02/2023,-7.66,484.42
48029032,13/02/2023,142.2,626.62
48050578,31/01/2023,,203.26
48050578,06/02/2023,60.08,263.34
48050578,07/02/2023,101.89,365.23
48056301,31/01/2023,,943.28
48056301,03/02/2023,85.06,1028.34
48056301,03/02/2023,-98.24,930.1
48056301,13/02/2023,52.77,982.87
48056301,13/02/2023,-114.39,868.48
48071843,31/01/2023,,997.62
48071843,01/02/2023,-387.9,609.72
48071843,02/02/2023,159.22,768.94
48071843,09/02/2023,-1877.3,-1108.36
48075275,31/01/2023,,881.31
48075275,01/02/2023,-77.94,803.3699999999999
48075275,01/02/2023,-98.75,704.6199999999999
48075275,04/02/2023,117.79,822.41
48075275,09/02/2023,85.81,908.2199999999999
48075275,10/02/2023,142.07,1050.29
48075275,14/02/2023,-1209.0,-158.71000000000004
48081999,31/01/2023,,290.89
48081999,02/02/2023,96.07,386.96
48081999,04/02/2023,189.06,576.02
48081999,05/02/2023,111.66,687.68
48081999,06/02/2023,27.72,715.4
48081999,11/02/2023,72.7,788.1
48081999,11/02/2023,-132.19,655.91
48081999,12/02/2023,1291.9,1947.81
48081999,12/02/2023,-89.43,1858.3799999999999
48081999,12/02/2023,-168.57,1689.81
48081999,13/02/2023,-104.18,1585.6299999999999
48131431,31/01/2023,,809.8
48131431,01/02/2023,-128.93,680.8699999999999
48131431,14/02/2023,404.9,1085.77
48185625,31/01/2023,,822.11
48185625,02/02/2023,-74.49,747.62
48185625,03/02/2023,-106.8,640.82
48185625,07/02/2023,185.51,826.33
48185625,13/02/2023,-98.9,727.4300000000001
48186857,31/01/2023,,518.26
48186857,03/02/2023,145.32,663.5799999999999
48186857,06/02/2023,98.85,762.43
48186857,09/02/2023,97.62,860.05
48186857,09/02/2023,69.39,929.4399999999999
48186857,12/02/2023,110.79,1040.23
48271608,31/01/2023,,343.94
48271608,01/02/2023,54.71,398.65
48271608,03/02/2023,164.56,563.21
48271608,07/02/2023,140.12,703.33
48271608,10/02/2023,55.38,758.71
48271608,10/02/2023,47.4,806.11
48271608,10/02/2023,-111.12,694.99
48271608,13/02/2023,1665.4,2360.3900000000003
48271608,14/02/2023,153.15,2513.54
48318402,31/01/2023,,965.28
48318402,04/02/2023,-44.62,920.66
48318402,04/02/2023,-111.18,809.48
48318402,08/02/2023,-96.4,713.0799999999999
48318402,09/02/2023,30.36,743.4399999999999
48318402,14/02/2023,101.59,845.03
48350476,31/01/2023,,305.2
48350476,02/02/2023,95.1,400.29999999999995
48350476,02/02/2023,-38.74,361.56
48350476,03/02/2023,-82.71,278.85
48350476,04/02/2023,-152.03,126.82
48350476,05/02/2023,-92.4,34.41999999999999
48350476,06/02/2023,39.91,74.32999999999998
48350476,10/02/2023,213.83,288.15999999999997
48350476,10/02/2023,-57.64,230.51999999999998
48399121,31/01/2023,,984.98
48399121,09/02/2023,233.91,1218.89
48399121,14/02/2023,-104.64,1114.25
48429255,31/01/2023,,79.7
48429255,06/02/2023,-110.9,-31.200000000000003
48429255,11/02/2023,99.36,68.16
48429255,12/02/2023,128.19,196.35
48429255,14/02/2023,-88.32,108.03
48434572,31/01/2023,,351.7
48434572,01/02/2023,-113.69,238.01
48434572,03/02/2023,28.45,266.46
48434572,04/02/2023,72.42,338.88
48434572,10/02/2023,75.71,414.59
48434572,11/02/2023,720.7,1135.29
48434572,12/02/2023,-118.43,1016.8599999999999
48444386,31/01/2023,,962.57
48444386,05/02/2023,-91.73,870.84
48444386,06/02/2023,94.25,965.09
48444386,11/02/2023,152.17,1117.26
48444386,14/02/2023,73.36,1190.6200000000001
48491614,31/01/2023,,754.45
48491614,01/02/2023,120.88,875.33
48491614,06/02/2023,-738.2,137.13
48491614,11/02/2023,-6.19,130.94
48500030,31/01/2023,,917.05
48500030,09/02/2023,-125.13,791.92
48500030,13/02/2023,56.68,848.5999999999999
48500030,14/02/2023,-148.05,700.55
48507357,31/01/2023,,980.8
48507357,03/02/2023,80.54,1061.34
48507357,06/02/2023,-80.07,981.27
48507357,11/02/2023,-81.26,900.01
48524535,31/01/2023,,265.03
48524535,01/02/2023,32.75,297.78
48524535,02/02/2023,50.17,347.95
48524535,03/02/2023,-76.66,271.28999999999996
48524535,06/02/2023,-50.95,220.33999999999997
48524535,06/02/2023,-78.99,141.34999999999997
48524535,07/02/2023,-126.03,15.319999999999979
48524535,08/02/2023,43.73,59.049999999999976
48524535,08/02/2023,-65.85,-6.8000000000000185
48524535,10/02/2023,-71.44,-78.24000000000001
48524535,11/02/2023,-24.18,-102.42000000000002
48524535,14/02/2023,120.62,18.19999999999999
48524535,14/02/2023,-50.36,-32.16000000000001
48532894,31/01/2023,,662.86
48532894,02/02/2023,109.57,772.4300000000001
48532894,03/02/2023,79.16,851.59
48532894,11/02/2023,91.38,942.97
48532894,14/02/2023,597.7,1540.67
48553648,31/01/2023,,80.62
48553648,02/02/2023,-122.23,-41.61
48553648,05/02/2023,-12.08,-53.69
48553648,13/02/2023,89.1,35.41
48569537,31/01/2023,,374.69
48569537,01/02/2023,-1153.0,-778.31
48569537,05/02/2023,-178.08,-956.39
48569537,07/02/2023,-173.79,-1130.1799999999998
48569537,07/02/2023,-230.31,-1360.49
48569537,09/02/2023,938.3,-422.19000000000005
48569537,10/02/2023,-92.21,-514.4000000000001
48569537,11/02/2023,818.2,303.79999999999995
48569537,13/02/2023,-46.16,257.64
48569537,14/02/2023,50.36,307.99999999999994
48591774,31/01/2023,,422.94
48591774,01/02/2023,84.03,506.97
48591774,03/02/2023,-91.97,415.0
48591774,08/02/2023,146.43,561.4300000000001
48591774,09/02/2023,117.1,678.53
48591774,10/02/2023,-90.33,588.2
48591774,10/02/2023,-121.67,466.53
48591774,14/02/2023,-139.74,326.78999999999996
48625559,31/01/2023,,797.88
48625559,03/02/2023,88.02,885.9
48625559,04/02/2023,-146.29,739.61
48625559,07/02/2023,105.97,845.58
48625559,08/02/2023,147.08,992.6600000000001
48625559,08/02/2023,-129.99,862.6700000000001
48625559,09/02/2023,44.19,906.86
48625559,10/02/2023,-93.87,812.99
48625559,11/02/2023,187.8,1000.79
48625559,12/02/2023,85.27,1086.06
48625559,14/02/2023,-53.72,1032.34
48654969,31/01/2023,,83.93
48654969,03/02/2023,43.31,127.24000000000001
48654969,08/02/2023,-119.16,8.080000000000013
48654969,10/02/2023,951.2,959.2800000000001
48654969,10/02/2023,747.3,1706.58
48722022,31/01/2023,,586.44
48722022,01/02/2023,123.96,710.4000000000001
48722022,05/02/2023,-45.1,665.3000000000001
48722022,07/02/2023,148.28,813.58
48722022,12/02/2023,93.42,907.0
48722022,12/02/2023,-61.43,845.57
48733708,31/01/2023,,370.74
48733708,01/02/2023,-60.93,309.81
48733708,01/02/2023,-212.62,97.19
48733708,02/02/2023,6.47,103.66
48733708,03/02/2023,87.65,191.31
48733708,04/02/2023,5.54,196.85
48733708,05/02/2023,-118.28,78.57000000000001
48733708,08/02/2023,-105.76,-27.189999999999998
48733708,09/02/2023,123.28,96.09
48757991,31/01/2023,,676.6
48757991,01/02/2023,141.6,818.2
48757991,07/02/2023,136.97,955.1700000000001
48757991,11/02/2023,86.98,1042.15
48781678,31/01/2023,,401.55
48781678,01/02/2023,-856.5,-454.95
48781678,05/02/2023,150.73,-304.22
48783408,31/01/2023,,278.34
48783408,03/02/2023,140.36,418.7
48783408,04/02/2023,101.75,520.45
48783408,07/02/2023,185.47,705.92
48783408,08/02/2023,105.53,811.45
48783408,09/02/2023,163.2,974.65
48783408,11/02/2023,87.63,1062.28
48799650,31/01/2023,,160.75
48799650,01/02/2023,83.35,244.1
48799650,08/02/2023,-154.93,89.16999999999999
48831634,31/01/2023,,146.94
48831634,04/02/2023,-90.91,56.03
48831634,04/02/2023,-1593.8,-1537.77
48831634,06/02/2023,141.38,-1396.3899999999999
48831634,09/02/2023,91.85,-1304.54
48831634,09/02/2023,69.64,-1234.9
48831634,11/02/2023,-103.93,-1338.83
48831634,11/02/2023,-1243.0,-2581.83
48831634,13/02/2023,35.46,-2546.37
48831634,13/02/2023,-148.74,-2695.11
48860469,31/01/2023,,730.37
48860469,01/02/2023,-166.48,563.89
48860469,07/02/2023,195.55,759.44
48860469,08/02/2023,-55.57,703.87
48860469,08/02/2023,-103.37,600.5
48860469,10/02/2023,-167.13,433.37
48875351,31/01/2023,,239.7
48875351,12/02/2023,100.25,339.95
48886521,31/01/2023,,827.29
48886521,01/02/2023,134.06,961.3499999999999
48886521,03/02/2023,98.44,1059.79
48886521,04/02/2023,184.38,1244.17
48886521,05/02/2023,-101.6,1142.57
48886521,08/02/2023,33.64,1176.21
48906756,31/01/2023,,996.87
48906756,02/02/2023,36.6,1033.47
48906756,02/02/2023,-34.56,998.91
48906756,05/02/2023,637.3,1636.21
48906756,09/02/2023,-229.85,1406.36
48911149,31/01/2023,,580.54
48911149,05/02/2023,144.63,725.17
48911149,09/02/2023,82.08,807.25
48911149,11/02/2023,-518.1,289.15
48930319,31/01/2023,,595.65
48930319,01/02/2023,167.53,763.18
48930319,04/02/2023,76.06,839.24
48930319,05/02/2023,-68.53,770.71
48930319,05/02/2023,-177.45,593.26
48930319,08/02/2023,23.59,616.85
48930319,12/02/2023,51.05,667.9
48940493,31/01/2023,,394.19
48940493,02/02/2023,217.51,611.7
48940493,02/02/2023,-22.64,589.06
48940493,04/02/2023,125.73,714.79
48940493,04/02/2023,90.44,805.23
48940493,05/02/2023,216.4,1021.63
48940493,05/02/2023,174.7,1196.33
48940493,07/02/2023,-106.64,1089.69
48940493,08/02/2023,149.31,1239.0
48940493,08/02/2023,-66.57,1172.43
48940493,08/02/2023,-967.3,205.1300000000001
48940493,12/02/2023,970.8,1175.93
48940493,12/02/2023,-175.32,1000.6100000000001
48976336,31/01/2023,,400.12
48976336,01/02/2023,-2027.7,-1627.58
48976336,03/02/2023,-59.2,-1686.7800000000002
48976336,06/02/2023,58.17,-1628.6100000000001
48976336,07/02/2023,-218.78,-1847.39
48976336,08/02/2023,-91.24,-1938.63
48976336,10/02/2023,117.56,-1821.0700000000002
49031081,31/01/2023,,788.18
49031081,02/02/2023,131.8,919.98
49031081,03/02/2023,127.58,1047.56
49031081,04/02/2023,-97.05,950.51
49031081,08/02/2023,76.81,1027.32
49031081,09/02/2023,-94.81,932.51
49031081,10/02/2023,134.24,1066.75
49031081,10/02/2023,81.26,1148.01
49031081,12/02/2023,-137.83,1010.18
49031081,14/02/2023,-58.59,951.5899999999999
49031379,31/01/2023,,373.63
49031379,01/02/2023,67.01,440.64
49031379,03/02/2023,135.44,576.0799999999999
49031379,03/02/2023,96.51,672.59
49031379,07/02/2023,46.14,718.73
49031379,08/02/2023,-119.48,599.25
49031379,10/02/2023,-129.69,469.56
49039474,31/01/2023,,574.7
49039474,01/02/2023,89.56,664.26
49039474,03/02/2023,143.42,807.6800000000001
49039474,04/02/2023,56.75,864.4300000000001
49039474,05/02/2023,-1168.4,-303.97
49039474,07/02/2023,24.41,-279.56
49039474,11/02/2023,-1815.0,-2094.56
49071892,31/01/2023,,909.58
49071892,04/02/2023,132.12,1041.7
49071892,04/02/2023,-95.76,945.94
49071892,06/02/2023,50.78,996.72
49071892,08/02/2023,113.3,1110.02
49071892,09/02/2023,-93.18,1016.84
49071892,10/02/2023,-141.83,875.01
49075324,31/01/2023,,301.39
49075324,03/02/2023,-40.55,260.84
49075324,03/02/2023,-716.6,-455.76000000000005
49075324,06/02/2023,73.4,-382.36
49075324,10/02/2023,55.08,-327.28000000000003
49095464,31/01/2023,,1.3
49095464,01/02/2023,91.66,92.96
49095464,01/02/2023,-146.39,-53.42999999999999
49095464,06/02/2023,-149.41,-202.83999999999997
49095464,06/02/2023,-168.59,-371.43
49095464,11/02/2023,43.12,-328.31
49095464,11/02/2023,-155.81,-484.12
49095464,12/02/2023,-140.22,-624.34
49095464,13/02/2023,140.3,-484.03999999999996
49095464,13/02/2023,119.03,-365.01
49095464,13/02/2023,-1237.4,-1602.41
49127699,31/01/2023,,155.53
49127699,01/02/2023,83.63,239.16
49127699,07/02/2023,89.31,328.47
49127699,08/02/2023,110.78,439.25
49127699,08/02/2023,-122.65,316.6
49127699,09/02/2023,108.53,425.13
49127699,11/02/2023,-130.19,294.94
49157903,31/01/2023,,601.62
49157903,03/02/2023,-993.7,-392.08000000000004
49157903,05/02/2023,175.05,-217.03000000000003
49157903,06/02/2023,-103.08,-320.11
49157903,12/02/2023,94.16,-225.95000000000005
49172838,31/01/2023,,136.96
49172838,03/02/2023,-113.68,23.28
49172838,10/02/2023,24.85,48.13
49172838,11/02/2023,-96.47,-48.339999999999996
49172838,13/02/2023,1545.5,1497.16
49172838,14/02/2023,141.48,1638.64
49186099,31/01/2023,,208.24
49186099,01/02/2023,118.24,326.48
49186099,01/02/2023,90.07,416.55
49186099,04/02/2023,92.27,508.82
49216581,31/01/2023,,911.91
49216581,01/02/2023,-754.9,157.01
49216581,07/02/2023,1147.4,1304.41
49216581,10/02/2023,-1812.5,-508.0899999999999
49216581,13/02/2023,138.94,-369.1499999999999
49216581,13/02/2023,-127.19,-496.3399999999999
49216581,13/02/2023,-569.6,-1065.94
49253709,31/01/2023,,473.46
49253709,01/02/2023,65.02,538.48
49253709,01/02/2023,-120.88,417.59999999999997
49253709,03/02/2023,134.37,551.97
49253709,04/02/2023,129.16,681.13
49253709,04/02/2023,107.78,788.91
49253709,05/02/2023,-209.45,579.46
49253709,07/02/2023,129.29,708.75
49253709,12/02/2023,151.37,860.12
49253709,12/02/2023,-52.81,807.31
49253709,12/02/2023,-87.33,719.98
49253709,13/02/2023,-109.33,610.65
49310474,31/01/2023,,929.16
49310474,01/02/2023,131.27,1060.43
49310474,01/02/2023,-84.68,975.75
49310474,06/02/2023,-79.45,896.3
49310474,07/02/2023,124.51,1020.81
49310474,07/02/2023,-49.81,971.0
49310474,13/02/2023,165.82,1136.82
49310474,14/02/2023,32.96,1169.78
49310474,14/02/2023,-88.77,1081.01
49400211,31/01/2023,,460.24
49400211,01/02/2023,212.62,672.86
49400211,02/02/2023,155.92,828.78
49400211,08/02/2023,192.5,1021.28
49400211,09/02/2023,67.33,1088.61
49400211,10/02/2023,-102.74,985.87
49410021,31/01/2023,,508.72
49410021,01/02/2023,112.52,621.24
49410021,06/02/2023,-121.6,499.64000000000004
49410021,12/02/2023,-129.45,370.19000000000005
49410021,14/02/2023,-72.61,297.58000000000004
49427302,31/01/2023,,468.73
49427302,03/02/2023,79.37,548.1
49427302,04/02/2023,-76.17,471.93
49427302,06/02/2023,1045.4,1517.3300000000002
49427302,06/02/2023,-93.16,1424.17
49427302,07/02/2023,51.11,1475.2800000000002
49427302,08/02/2023,81.34,1556.6200000000001
49427302,11/02/2023,-112.24,1444.38
49427302,12/02/2023,49.41,1493.7900000000002
49441522,31/01/2023,,75.3
49441522,01/02/2023,159.64,234.94
49441522,02/02/2023,-132.64,102.30000000000001
49441522,03/02/2023,183.44,285.74
49441522,09/02/2023,35.02,320.76
49441522,10/02/2023,10.96,331.72
49441522,11/02/2023,-152.11,179.61
49454023,31/01/2023,,798.72
49454023,01/02/2023,780.9,1579.62
49454023,02/02/2023,-50.17,1529.45
49454023,02/02/2023,-92.61,1436.84
49454023,02/02/2023,-123.95,1312.89
49454023,03/02/2023,111.24,1424.13
49454023,06/02/2023,155.88,1580.01
49454023,07/02/2023,1070.1,2650.1099999999997
49454023,08/02/2023,-751.9,1898.21
49454023,10/02/2023,-86.78,1811.4299999999998
49454023,12/02/2023,57.5,1868.9299999999998
49459559,31/01/2023,,467.56
49459559,07/02/2023,808.1,1275.66
49459559,11/02/2023,-96.16,1179.5
49459559,12/02/2023,-144.16,1035.34
49459559,13/02/2023,-107.55,927.79
49459559,14/02/2023,68.56,996.35
49467252,31/01/2023,,444.92
49467252,04/02/2023,64.43,509.35
49467252,05/02/2023,59.15,568.5
49467252,06/02/2023,-51.78,516.72
49467252,10/02/2023,-17.18,499.54
49516533,31/01/2023,,7.4
49516533,02/02/2023,-65.53,-58.13
49516533,02/02/2023,-65.93,-124.06
49516533,04/02/2023,-578.6,-702.6600000000001
49516533,05/02/2023,61.84,-640.8199999999999
49516533,07/02/2023,42.04,-598.78
49516533,08/02/2023,-141.86,-740.64
49516533,09/02/2023,-106.29,-846.93
49516533,11/02/2023,187.53,-659.4
49516533,11/02/2023,-20.99,-680.39
49516533,13/02/2023,-1188.4,-1868.79
49520335,31/01/2023,,198.79
49520335,01/02/2023,77.78,276.57
49520335,03/02/2023,-104.62,171.95
49520335,08/02/2023,-14.84,157.10999999999999
49520335,10/02/2023,1795.9,1953.01
49520335,12/02/2023,88.2,2041.21
49520335,14/02/2023,-88.67,1952.54
49533543,31/01/2023,,190.64
49533543,04/02/2023,-45.03,145.60999999999999
49533543,04/02/2023,-164.38,-18.77000000000001
49533543,05/02/2023,-986.7,-1005.47
49533543,11/02/2023,57.11,-948.36
49533543,11/02/2023,-77.77,-1026.13
49533543,11/02/2023,-139.2,-1165.33
49534905,31/01/2023,,383.91
49534905,07/02/2023,106.1,490.01
49536707,31/01/2023,,37.3
49536707,01/02/2023,-136.75,-99.45
49536707,02/02/2023,-104.98,-204.43
49536707,03/02/2023,-120.86,-325.29
49536707,03/02/2023,-173.01,-498.3
49536707,05/02/2023,147.37,-350.93
49536707,08/02/2023,35.81,-315.12
49536707,11/02/2023,-113.2,-428.32
49536707,14/02/2023,-101.69,-530.01
49536707,14/02/2023,-120.83,-650.84
49536707,14/02/2023,-228.87,-879.71
49540328,31/01/2023,,458.12
49540328,02/02/2023,-98.11,360.01
49540328,04/02/2023,-122.19,237.82
49540328,05/02/2023,-93.03,144.79000000000002
49540328,09/02/2023,110.51,255.3
49540328,13/02/2023,-172.54,82.76000000000002
49550154,31/01/2023,,178.14
49550154,01/02/2023,-122.7,55.43999999999998
49550154,05/02/2023,76.04,131.48
49550154,08/02/2023,-63.41,68.07
49550154,08/02/2023,-79.16,-11.090000000000003
49550154,10/02/2023,-179.95,-191.04
49550154,13/02/2023,151.76,-39.28
49550154,14/02/2023,166.38,127.1
49581833,31/01/2023,,117.56
49581833,01/02/2023,-52.0,65.56
49581833,02/02/2023,-185.74,-120.18
49581833,02/02/2023,-1640.2,-1760.38
49581833,04/02/2023,-56.75,-1817.13
49581833,13/02/2023,1013.4,-803.7300000000001
49581833,14/02/2023,-138.71,-942.4400000000002
49696722,31/01/2023,,142.69
49696722,02/02/2023,153.46,296.15
49696722,04/02/2023,-88.15,208.0
49696722,07/02/2023,-127.37,80.63
49696722,11/02/2023,126.93,207.56
49696722,13/02/2023,1291.4,1498.96
49696722,13/02/2023,-44.2,1454.76
49834565,31/01/2023,,51.12
49834565,03/02/2023,72.44,123.56
49834565,12/02/2023,-76.93,46.629999999999995
49840526,31/01/2023,,461.64
49840526,03/02/2023,95.71,557.35
49840526,05/02/2023,-200.77,356.58
49840526,08/02/2023,2591.7,2948.2799999999997
49840526,09/02/2023,1530.9,4479.18
49840526,09/02/2023,229.85,4709.03
49840526,09/02/2023,168.65,4877.68
49840526,09/02/2023,-58.39,4819.29
49840526,10/02/2023,107.56,4926.849999999999
49941860,31/01/2023,,655.66
49941860,01/02/2023,60.93,716.5899999999999
49941860,03/02/2023,66.9,783.49
49941860,08/02/2023,-34.93,748.56
49961732,31/01/2023,,673.71
49961732,01/02/2023,99.06,772.77
49961732,01/02/2023,49.48,822.25
49961732,08/02/2023,48.01,870.26
49961732,08/02/2023,-133.54,736.72
49961732,09/02/2023,22.93,759.65
49961732,11/02/2023,107.51,867.1600000000001
49961732,11/02/2023,-68.14,799.02
49966528,31/01/2023,,641.18
49966528,01/02/2023,133.29,774.4699999999999
49966528,03/02/2023,-92.73,681.7399999999999
49966528,04/02/2023,-115.54,566.1999999999999
49966528,05/02/2023,176.37,742.5699999999999
49966528,06/02/2023,152.43,895.0
49966528,06/02/2023,-161.12,733.8799999999999
49966528,07/02/2023,180.28,914.16
49966528,09/02/2023,115.5,1029.6599999999999
49966528,12/02/2023,114.03,1143.69
50018070,31/01/2023,,450.64
50018070,03/02/2023,-656.3,-205.65999999999997
50018070,05/02/2023,112.93,-92.72999999999996
50018070,08/02/2023,-92.25,-184.97999999999996
50018070,10/02/2023,-90.3,-275.28
50024545,31/01/2023,,867.21
50024545,03/02/2023,84.79,952.0
50024545,07/02/2023,-113.13,838.87
50024545,07/02/2023,-605.2,233.66999999999996
50024545,09/02/2023,180.04,413.7099999999999
50024545,11/02/2023,-122.19,291.52
50024545,11/02/2023,-1733.6,-1442.08
50024545,13/02/2023,-37.47,-1479.55
50024545,13/02/2023,-71.7,-1551.25
50031425,31/01/2023,,695.18
50031425,03/02/2023,493.5,1188.6799999999998
50031425,03/02/2023,115.16,1303.84
50031425,07/02/2023,124.56,1428.3999999999999
50031425,10/02/2023,180.01,1608.4099999999999
50031425,12/02/2023,-124.59,1483.82
50031425,14/02/2023,42.03,1525.85
50114041,31/01/2023,,60.83
50114041,06/02/2023,-152.43,-91.60000000000001
50115324,31/01/2023,,329.32
50115324,01/02/2023,80.86,410.18
50115324,03/02/2023,46.85,457.03
50115324,03/02/2023,-130.53,326.5
50115324,08/02/2023,120.55,447.05
50115324,12/02/2023,170.71,617.76
50115324,13/02/2023,33.78,651.54
50115324,13/02/2023,-130.18,521.36
50115324,13/02/2023,-813.5,-292.14
50122119,31/01/2023,,264.61
50122119,01/02/2023,774.6,1039.21
50122119,03/02/2023,-33.17,1006.0400000000001
50122119,12/02/2023,18.99,1025.03
50122119,12/02/2023,-970.8,54.23000000000013
50132654,31/01/2023,,562.17
50132654,02/02/2023,177.5,739.67
50132654,04/02/2023,-97.84,641.8299999999999
50132654,05/02/2023,168.74,810.5699999999999
50132654,07/02/2023,88.86,899.43
50132654,08/02/2023,63.1,962.53
50132654,09/02/2023,-89.08,873.4499999999999
50132654,12/02/2023,117.48,990.93
50132654,14/02/2023,-88.1,902.8299999999999
50150279,31/01/2023,,567.24
50150279,05/02/2023,-74.52,492.72
50150279,06/02/2023,106.53,599.25
50150279,09/02/2023,62.92,662.1700000000001
50161801,31/01/2023,,180.69
50161801,02/02/2023,174.75,355.44
50161801,02/02/2023,100.46,455.9
50161801,03/02/2023,172.24,628.14
50161801,03/02/2023,108.09,736.23
50161801,03/02/2023,89.51,825.74
50161801,07/02/2023,113.43,939.17
50161801,08/02/2023,78.98,1018.15
50161801,09/02/2023,-188.3,829.85
50161801,10/02/2023,144.1,973.95
50161801,11/02/2023,105.27,1079.22
50161801,14/02/2023,1674.0,2753.2200000000003
50217872,31/01/2023,,667.95
50217872,02/02/2023,65.93,733.8800000000001
50217872,03/02/2023,-625.5,108.38000000000011
50217872,07/02/2023,-70.62,37.760000000000105
50217872,08/02/2023,-120.31,-82.5499999999999
50217872,10/02/2023,-63.32,-145.8699999999999
50217872,11/02/2023,139.07,-6.799999999999898
50217872,11/02/2023,-47.32,-54.1199999999999
50217872,13/02/2023,-119.03,-173.1499999999999
50217872,14/02/2023,735.5,562.3500000000001
50219545,31/01/2023,,548.12
50219545,01/02/2023,1057.7,1605.8200000000002
50219545,06/02/2023,-50.67,1555.1499999999999
50219545,07/02/2023,124.42,1679.57
50219545,11/02/2023,-818.2,861.3699999999999
50219545,14/02/2023,1209.0,2070.37
50231864,31/01/2023,,117.34
50231864,02/02/2023,135.95,253.29
50231864,02/02/2023,-128.36,124.92999999999998
50231864,04/02/2023,-134.46,-9.53000000000003
50231864,07/02/2023,150.57,141.03999999999996
50231864,07/02/2023,29.79,170.82999999999996
50231864,10/02/2023,148.04,318.86999999999995
50231864,14/02/2023,178.04,496.90999999999997
50276595,31/01/2023,,686.91
50276595,01/02/2023,-102.6,584.31
50276595,03/02/2023,-88.33,495.97999999999996
50276595,03/02/2023,-98.41,397.57
50276595,04/02/2023,86.9,484.46999999999997
50276595,06/02/2023,1107.9,1592.3700000000001
50276595,11/02/2023,88.16,1680.5300000000002
50276595,11/02/2023,-81.2,1599.3300000000002
50276595,11/02/2023,-146.95,1452.38
50276595,12/02/2023,-55.85,1396.5300000000002
50324230,31/01/2023,,945.15
50324230,05/02/2023,-64.51,880.64
50324230,05/02/2023,-145.13,735.51
50324230,07/02/2023,-1380.5,-644.99
50324230,09/02/2023,-95.64,-740.63
50335174,31/01/2023,,650.98
50335174,05/02/2023,-99.24,551.74
50335174,09/02/2023,176.84,728.58
50335174,09/02/2023,157.79,886.37
50335174,11/02/2023,194.38,1080.75
50335174,14/02/2023,14.98,1095.73
50360111,31/01/2023,,193.83
50360111,02/02/2023,40.94,234.77
50360111,05/02/2023,183.09,417.86
50360111,12/02/2023,26.59,444.45
50402197,31/01/2023,,717.07
50402197,01/02/2023,-65.02,652.0500000000001
50402197,01/02/2023,-469.6,182.45000000000005
50402197,02/02/2023,-962.8,-780.3499999999999
50402197,05/02/2023,75.06,-705.29
50402197,05/02/2023,69.93,-635.3599999999999
50402197,11/02/2023,167.56,-467.7999999999999
50402197,11/02/2023,66.39,-401.4099999999999
50402197,12/02/2023,-109.08,-510.4899999999999
50428641,31/01/2023,,271.51
50428641,05/02/2023,-102.38,169.13
50428641,07/02/2023,62.85,231.98
50428641,07/02/2023,-119.18,112.79999999999998
50428641,09/02/2023,-126.46,-13.66000000000001
50428641,10/02/2023,186.7,173.03999999999996
50428641,13/02/2023,101.21,274.24999999999994
50463777,31/01/2023,,143.45
50463777,04/02/2023,-83.95,59.499999999999986
50463777,08/02/2023,64.87,124.36999999999999
50463777,09/02/2023,-90.79,33.579999999999984
50463777,13/02/2023,-80.9,-47.32000000000002
50463777,14/02/2023,-73.71,-121.03000000000002
50463777,14/02/2023,-150.33,-271.36
50463777,14/02/2023,-154.58,-425.94000000000005
50520009,31/01/2023,,892.55
50520009,04/02/2023,-68.1,824.4499999999999
50520009,06/02/2023,-136.61,687.8399999999999
50520009,08/02/2023,1808.4,2496.24
50520009,12/02/2023,-68.89,2427.35
50520009,13/02/2023,145.1,2572.45
50520009,14/02/2023,137.73,2710.18
50547726,31/01/2023,,675.06
50547726,04/02/2023,143.88,818.9399999999999
50547726,04/02/2023,46.13,865.0699999999999
50547726,07/02/2023,-1070.1,-205.02999999999997
50547726,08/02/2023,-121.72,-326.75
50547726,10/02/2023,-106.19,-432.93999999999994
50547726,11/02/2023,-132.76,-565.6999999999999
50610780,31/01/2023,,536.41
50610780,02/02/2023,133.59,670.0
50610780,02/02/2023,-166.35,503.65
50610780,05/02/2023,-2112.8,-1609.15
50610780,06/02/2023,-436.1,-2045.25
50610780,07/02/2023,737.4,-1307.8500000000001
50610780,08/02/2023,-251.9,-1559.7500000000002
50610780,10/02/2023,-127.71,-1687.46
50610780,12/02/2023,81.53,-1605.93
50610780,13/02/2023,89.42,-1516.5100000000002
50624960,31/01/2023,,5.03
50624960,04/02/2023,-26.76,-21.73
50624960,11/02/2023,159.09,137.36
50624960,11/02/2023,-119.87,17.49000000000001
50624960,12/02/2023,-113.72,-96.22999999999999
50624960,13/02/2023,167.76,71.53
50624960,13/02/2023,-126.46,-54.92999999999999
50627436,31/01/2023,,183.41
50627436,02/02/2023,30.52,213.93
50627436,04/02/2023,48.4,262.33
50627436,05/02/2023,-103.36,158.97
50627436,07/02/2023,146.5,305.47
50627436,07/02/2023,62.35,367.82
50627436,08/02/2023,473.2,841.02
50627436,08/02/2023,-162.59,678.43
50627436,09/02/2023,-113.82,564.61
50627436,10/02/2023,-90.73,473.88
50627436,14/02/2023,105.03,578.91
50647892,31/01/2023,,540.71
50647892,03/02/2023,121.58,662.2900000000001
50647892,04/02/2023,-180.29,482.00000000000006
50647892,05/02/2023,212.21,694.21
50647892,05/02/2023,95.98,790.19
50647892,05/02/2023,23.88,814.07
50647892,06/02/2023,120.78,934.85
50647892,10/02/2023,94.84,1029.69
50693024,31/01/2023,,171.87
50693024,02/02/2023,147.71,319.58000000000004
50693024,05/02/2023,-100.33,219.25
50693024,09/02/2023,115.1,334.35
50693024,09/02/2023,-54.92,279.43
50693024,10/02/2023,-98.76,180.67000000000002
50693024,13/02/2023,35.47,216.14
50693024,14/02/2023,139.82,355.96
50756739,31/01/2023,,177.65
50756739,02/02/2023,79.3,256.95
50756739,06/02/2023,-159.04,97.91000000000003
50756739,07/02/2023,94.27,192.18
50756739,07/02/2023,78.73,270.91
50756739,09/02/2023,167.25,438.16
50756739,12/02/2023,20.21,458.37
50756739,13/02/2023,106.08,564.45
50756739,13/02/2023,25.66,590.11
50772829,31/01/2023,,47.57
50772829,10/02/2023,115.74,163.31
50772829,11/02/2023,-63.01,100.29999999999998
50772829,12/02/2023,200.04,300.34
50772829,12/02/2023,76.84,377.17999999999995
50772829,12/02/2023,-1278.9,-901.7200000000001
50772829,13/02/2023,79.92,-821.8000000000002
50772829,13/02/2023,66.5,-755.3000000000002
50772829,14/02/2023,836.0,80.69999999999982
50813708,31/01/2023,,339.04
50813708,01/02/2023,172.78,511.82000000000005
50813708,03/02/2023,-140.36,371.46000000000004
50813708,04/02/2023,-97.67,273.79
50813708,05/02/2023,45.47,319.26
50813708,05/02/2023,-108.33,210.93
50813708,06/02/2023,-28.34,182.59
50813708,08/02/2023,167.66,350.25
50813708,10/02/2023,9.75,360.0
50813708,13/02/2023,-84.2,275.8
50837270,31/01/2023,,613.53
50837270,02/02/2023,147.44,760.97
50837270,04/02/2023,-105.81,655.16
50837270,12/02/2023,114.06,769.22
50837270,13/02/2023,-437.5,331.71999999999997
50837270,14/02/2023,66.68,398.4
50880352,31/01/2023,,12.46
50880352,05/02/2023,-133.1,-120.63999999999999
50880352,06/02/2023,-59.59,-180.23
50880352,08/02/2023,19.59,-160.64
50880352,09/02/2023,205.74,45.10000000000002
50887252,31/01/2023,,464.78
50887252,03/02/2023,56.35,521.13
50887252,04/02/2023,-119.53,401.59999999999997
50887252,05/02/2023,772.5,1174.1
50887252,06/02/2023,210.36,1384.46
50887252,09/02/2023,175.48,1559.9399999999998
50887252,09/02/2023,137.17,1697.11
50887252,10/02/2023,104.93,1802.04
50887252,14/02/2023,-129.59,1672.4499999999998
50893310,31/01/2023,,185.13
50893310,06/02/2023,90.19,275.32
50893310,08/02/2023,104.32,379.64
50893310,12/02/2023,130.06,509.7
50893310,13/02/2023,-69.71,439.99
50959802,31/01/2023,,821.37
50959802,01/02/2023,-97.11,724.26
50959802,02/02/2023,1436.3,2160.56
50959802,10/02/2023,-221.22,1939.34
50959802,14/02/2023,1157.1,3096.4399999999996
51079213,31/01/2023,,783.58
51079213,01/02/2023,-70.27,713.3100000000001
51079213,03/02/2023,80.5,793.8100000000001
51079213,05/02/2023,-144.1,649.71
51079213,05/02/2023,-184.06,465.65000000000003
51079213,07/02/2023,-61.01,404.64000000000004
51079213,08/02/2023,187.24,591.8800000000001
51079213,11/02/2023,-26.87,565.0100000000001
51079213,14/02/2023,-70.52,494.49000000000007
51102699,31/01/2023,,626.91
51102699,02/02/2023,-56.94,569.97
51102699,08/02/2023,-168.14,401.83
51102699,10/02/2023,94.45,496.28
51102699,12/02/2023,-66.33,429.95
51102699,13/02/2023,38.04,467.99
51122335,31/01/2023,,219.24
51122335,02/02/2023,-150.2,69.04000000000002
51122335,08/02/2023,42.88,111.92000000000002
51122335,10/02/2023,-88.04,23.880000000000024
51198722,31/01/2023,,559.63
51198722,06/02/2023,-995.2,-435.57000000000005
51198722,06/02/2023,-1045.4,-1480.9700000000003
51198722,07/02/2023,1035.2,-445.7700000000002
51198722,07/02/2023,-19.21,-464.9800000000002
51266306,31/01/2023,,163.99
51266306,01/02/2023,1187.7,1351.69
51266306,01/02/2023,-92.86,1258.8300000000002
51266306,04/02/2023,118.6,1377.43
51266306,05/02/2023,-118.23,1259.2
51272805,31/01/2023,,135.47
51272805,01/02/2023,153.9,289.37
51272805,01/02/2023,-103.94,185.43
51272805,03/02/2023,-718.2,-532.77
51272805,05/02/2023,43.28,-489.49
51272805,12/02/2023,-82.2,-571.6899999999999
51272805,13/02/2023,105.95,-465.74
51298007,31/01/2023,,427.17
51298007,04/02/2023,73.7,500.87
51298007,05/02/2023,-848.7,-347.83000000000004
51298007,07/02/2023,-1613.2,-1961.0300000000002
51298007,09/02/2023,137.44,-1823.59
51298007,09/02/2023,96.82,-1726.77
51298007,12/02/2023,89.55,-1637.22
51298007,12/02/2023,-104.78,-1742.0
51313899,31/01/2023,,189.04
51313899,01/02/2023,-1072.7,-883.6600000000001
51313899,02/02/2023,-52.11,-935.7700000000001
51313899,03/02/2023,1488.0,552.2299999999999
51313899,04/02/2023,128.26,680.4899999999999
51313899,05/02/2023,-119.88,560.6099999999999
51313899,06/02/2023,-91.53,469.0799999999999
51313899,07/02/2023,283.4,752.4799999999999
51313899,09/02/2023,1653.1,2405.58
51325070,31/01/2023,,933.4
51325070,01/02/2023,104.85,1038.25
51325070,01/02/2023,-83.77,954.48
51325070,02/02/2023,-154.85,799.63
51325070,03/02/2023,61.29,860.92
51325070,03/02/2023,4.02,864.9399999999999
51325070,04/02/2023,183.25,1048.19
51325070,05/02/2023,40.03,1088.22
51325070,06/02/2023,53.53,1141.75
51325070,06/02/2023,28.71,1170.46
51325070,06/02/2023,-8.04,1162.42
51325070,07/02/2023,-99.21,1063.21
51325070,08/02/2023,96.43,1159.64
51325070,08/02/2023,31.2,1190.84
51325070,11/02/2023,106.02,1296.8600000000001
51325070,12/02/2023,-99.56,1197.3
51353910,31/01/2023,,523.88
51353910,07/02/2023,-146.17,377.71000000000004
51353910,09/02/2023,40.77,418.48
51358248,31/01/2023,,222.93
51358248,02/02/2023,-179.19,43.74000000000001
51358248,10/02/2023,127.71,171.45
51358248,14/02/2023,130.09,301.54
51358248,14/02/2023,42.94,344.48
51389636,31/01/2023,,917.98
51389636,02/02/2023,-109.29,808.69
51389636,02/02/2023,-177.36,631.3299999999999
51389636,09/02/2023,-79.33,552.0
51398784,31/01/2023,,909.2
51398784,07/02/2023,313.5,1222.7
51398784,13/02/2023,11.11,1233.81
51401655,31/01/2023,,877.47
51401655,02/02/2023,-121.58,755.89
51401655,04/02/2023,97.26,853.1500000000001
51401655,04/02/2023,62.69,915.84
51401655,05/02/2023,200.77,1116.6100000000001
51435617,31/01/2023,,140.46
51435617,03/02/2023,110.67,251.13
51435617,05/02/2023,-87.66,163.47000000000003
51435617,06/02/2023,133.2,296.67
51435617,12/02/2023,-55.39,241.28000000000003
51435617,12/02/2023,-76.51,164.77
51435617,13/02/2023,18.93,183.70000000000002
51450938,31/01/2023,,157.37
51450938,06/02/2023,98.21,255.57999999999998
51450938,07/02/2023,150.92,406.5
51450938,10/02/2023,-67.01,339.49
51471469,31/01/2023,,611.19
51471469,05/02/2023,-103.21,507.9800000000001
51471469,10/02/2023,-1725.1,-1217.12
51471469,12/02/2023,-50.94,-1268.06
51493379,31/01/2023,,436.15
51493379,01/02/2023,69.52,505.66999999999996
51493379,08/02/2023,-49.64,456.03
51504474,31/01/2023,,153.25
51504474,01/02/2023,219.71,372.96000000000004
51504474,04/02/2023,68.14,441.1
51504474,04/02/2023,18.25,459.35
51504474,07/02/2023,-123.24,336.11
51504474,08/02/2023,-1254.7,-918.59
51504474,09/02/2023,134.52,-784.07
51504474,12/02/2023,-126.99,-911.0600000000001
51504474,13/02/2023,-69.63,-980.69
51653690,31/01/2023,,280.41
51653690,01/02/2023,-78.4,202.01000000000002
51653690,02/02/2023,127.6,329.61
51653690,06/02/2023,-179.58,150.03
51653690,08/02/2023,837.3,987.3299999999999
51653868,31/01/2023,,410.88
51653868,02/02/2023,-179.94,230.94
51653868,03/02/2023,104.0,334.94
51653868,04/02/2023,77.66,412.6
51653868,06/02/2023,-138.83,273.77
51653868,07/02/2023,89.6,363.37
51653868,07/02/2023,-43.63,319.73999999999995
51653868,09/02/2023,53.97,373.71
51653868,10/02/2023,1046.8,1420.51
51653868,10/02/2023,-91.66,1328.85
51653868,10/02/2023,-624.8,704.0500000000001
51653868,12/02/2023,-48.09,655.96
51653868,13/02/2023,30.31,686.2700000000001
51653868,14/02/2023,159.73,846.0
51653868,14/02/2023,-132.75,713.25
51718829,31/01/2023,,260.45
51718829,04/02/2023,-905.4,-644.95
51718829,05/02/2023,181.23,-463.7199999999999
51718829,05/02/2023,-860.7,-1324.42
51718829,06/02/2023,-58.84,-1383.26
51718829,08/02/2023,189.92,-1193.34
51718829,09/02/2023,-1043.8,-2237.14
51718829,13/02/2023,813.5,-1423.6399999999999
51718829,14/02/2023,-99.88,-1523.52
51771015,31/01/2023,,876.29
51771015,04/02/2023,87.1,963.39
51771015,05/02/2023,-159.59,803.8
51771015,07/02/2023,100.32,904.1199999999999
51771015,11/02/2023,1035.1,1939.2199999999998
51771015,11/02/2023,147.31,2086.5299999999997
51771015,12/02/2023,115.87,2202.3999999999996
51771015,14/02/2023,-85.81,2116.5899999999997
51774315,31/01/2023,,291.01
51774315,06/02/2023,98.97,389.98
51774315,07/02/2023,38.62,428.59999999999997
51774315,10/02/2023,55.88,484.48
51774315,11/02/2023,-101.84,382.64
51774315,12/02/2023,-78.98,303.65999999999997
51793205,31/01/2023,,715.25
51793205,02/02/2023,1902.2,2617.45
51793205,07/02/2023,-176.26,2441.19
51793205,08/02/2023,-133.59,2307.6
51906599,31/01/2023,,174.48
51906599,01/02/2023,-125.14,49.33999999999999
51906599,04/02/2023,36.24,85.57999999999998
51906599,06/02/2023,-55.84,29.739999999999988
51906599,06/02/2023,-84.58,-54.84000000000001
51906599,08/02/2023,53.25,-1.5900000000000105
51906599,10/02/2023,-86.75,-88.34
51906599,13/02/2023,157.9,69.56
52104303,31/01/2023,,810.97
52104303,03/02/2023,99.85,910.82
52104303,04/02/2023,-77.13,833.69
52104303,06/02/2023,-87.57,746.12
52104303,09/02/2023,-1530.9,-784.7800000000001
52117174,31/01/2023,,932.96
52117174,03/02/2023,-120.56,812.4000000000001
52117174,05/02/2023,-91.78,720.62
52117174,08/02/2023,-43.73,676.89
52117174,09/02/2023,-59.54,617.35
52117174,09/02/2023,-1131.6,-514.2499999999999
52125171,31/01/2023,,973.17
52125171,01/02/2023,112.77,1085.94
52125171,02/02/2023,132.64,1218.58
52125171,05/02/2023,101.6,1320.1799999999998
52125171,09/02/2023,-63.75,1256.4299999999998
52127978,31/01/2023,,84.8
52127978,08/02/2023,-603.0,-518.2
52127978,09/02/2023,-25.95,-544.1500000000001
52127978,12/02/2023,13.57,-530.58
52127978,12/02/2023,-134.36,-664.94
52141048,31/01/2023,,102.68
52141048,03/02/2023,153.58,256.26
52141048,04/02/2023,31.94,288.20000000000005
52141048,07/02/2023,852.6,1140.8000000000002
52141048,08/02/2023,122.19,1262.99
52141048,11/02/2023,144.17,1407.16
52146995,31/01/2023,,322.52
52146995,01/02/2023,69.4,391.91999999999996
52146995,02/02/2023,507.1,899.02
52146995,02/02/2023,-71.52,827.5
52146995,05/02/2023,-49.2,778.3
52146995,05/02/2023,-108.08,670.22
52146995,07/02/2023,135.72,805.94
52146995,09/02/2023,36.71,842.65
52146995,11/02/2023,-93.53,749.12
52146995,12/02/2023,-934.0,-184.88
52146995,14/02/2023,108.65,-76.22999999999999
52203356,31/01/2023,,899.39
52203356,03/02/2023,83.25,982.64
52203356,05/02/2023,189.35,1171.99
52203356,05/02/2023,-168.74,1003.25
52203356,08/02/2023,1316.4,2319.65
52203356,11/02/2023,51.73,2371.38
52213806,31/01/2023,,597.62
52213806,12/02/2023,54.1,651.72
52213806,14/02/2023,97.06,748.78
52213806,14/02/2023,10.22,759.0
52230539,31/01/2023,,394.34
52230539,03/02/2023,-23.24,371.09999999999997
52230539,12/02/2023,197.45,568.55
52230539,13/02/2023,-149.9,418.65
52230539,14/02/2023,-87.3,331.34999999999997
52264506,31/01/2023,,934.07
52264506,02/02/2023,-12.87,921.2
52264506,05/02/2023,139.1,1060.3
52264506,06/02/2023,-105.25,955.0500000000001
52264506,08/02/2023,132.78,1087.83
52264506,09/02/2023,139.7,1227.53
52264506,09/02/2023,-57.45,1170.08
52264506,13/02/2023,-35.46,1134.6200000000001
52264506,14/02/2023,60.97,1195.59
52310499,31/01/2023,,954.51
52310499,02/02/2023,53.0,1007.51
52310499,06/02/2023,81.6,1089.11
52310499,14/02/2023,73.19,1162.3
52317175,31/01/2023,,25.94
52317175,10/02/2023,-90.04,-64.10000000000001
52317175,12/02/2023,-145.55,-209.65000000000003
52317175,12/02/2023,-1145.7,-1355.3500000000001
52317175,14/02/2023,-92.17,-1447.5200000000002
52365238,31/01/2023,,822.17
52365238,09/02/2023,85.45,907.62
52365238,12/02/2023,92.42,1000.04
52366360,31/01/2023,,465.67
52366360,02/02/2023,-61.66,404.01
52366360,03/02/2023,88.74,492.75
52366360,06/02/2023,172.68,665.4300000000001
52366360,06/02/2023,-72.88,592.55
52366360,07/02/2023,-64.41,528.14
52390463,31/01/2023,,172.82
52390463,01/02/2023,147.58,320.4
52390463,02/02/2023,-534.5,-214.10000000000002
52390463,03/02/2023,-79.16,-293.26
52390463,03/02/2023,-220.83,-514.09
52390463,04/02/2023,-30.36,-544.45
52390463,14/02/2023,-117.12,-661.57
52436120,31/01/2023,,904.47
52436120,03/02/2023,109.66,1014.13
52436120,07/02/2023,115.4,1129.53
52436120,11/02/2023,-560.2,569.3299999999999
52442629,31/01/2023,,617.92
52442629,03/02/2023,196.73,814.65
52442629,03/02/2023,-1462.8,-648.15
52442629,11/02/2023,-145.45,-793.5999999999999
52442629,12/02/2023,90.28,-703.3199999999999
52442629,14/02/2023,1290.4,587.0800000000002
52461586,31/01/2023,,596.3
52461586,02/02/2023,755.8,1352.1
52461586,06/02/2023,-59.42,1292.6799999999998
52461586,08/02/2023,101.89,1394.57
52461586,08/02/2023,-1026.8,367.77
52468167,31/01/2023,,369.42
52468167,01/02/2023,-102.76,266.66
52468167,02/02/2023,162.4,429.06
52468167,10/02/2023,48.91,477.97
52480554,31/01/2023,,263.38
52480554,04/02/2023,-130.57,132.81
52480554,06/02/2023,-629.3,-496.48999999999995
52480554,10/02/2023,-85.31,-581.8
52480554,11/02/2023,122.42,-459.37999999999994
52480554,12/02/2023,68.07,-391.30999999999995
52560688,31/01/2023,,622.16
52560688,03/02/2023,55.81,677.97
52560688,04/02/2023,115.54,793.51
52560688,10/02/2023,-1220.5,-426.99
52560688,11/02/2023,-108.41,-535.4
52560688,11/02/2023,-1058.7,-1594.1
52560688,12/02/2023,127.2,-1466.9
52560688,12/02/2023,-115.87,-1582.7700000000002
52747145,31/01/2023,,546.71
52747145,02/02/2023,-107.8,438.91
52747145,04/02/2023,163.28,602.19
52747145,09/02/2023,-155.0,447.19000000000005
52747145,11/02/2023,-107.54,339.65000000000003
52747145,12/02/2023,-165.18,174.47000000000003
52756904,31/01/2023,,428.77
52756904,04/02/2023,-118.08,310.69
52756904,05/02/2023,114.03,424.71999999999997
52756904,13/02/2023,-51.57,373.15
52756904,13/02/2023,-87.03,286.12
52756904,14/02/2023,-67.55,218.57
52805510,31/01/2023,,580.66
52805510,09/02/2023,35.39,616.05
52805510,09/02/2023,-85.32,530.73
52805510,10/02/2023,-153.19,377.53999999999996
52805510,13/02/2023,851.7,1229.24
52814597,31/01/2023,,899.39
52814597,01/02/2023,-1821.6,-922.2099999999999
52814597,06/02/2023,-25.86,-948.0699999999999
52814597,10/02/2023,-831.4,-1779.4699999999998
52814597,11/02/2023,43.89,-1735.58
52814597,11/02/2023,-1129.9,-2865.48
52814597,14/02/2023,7.09,-2858.39
52835507,31/01/2023,,306.68
52835507,01/02/2023,-86.91,219.77
52835507,03/02/2023,-32.77,187.0
52835507,05/02/2023,109.41,296.40999999999997
52835507,05/02/2023,-806.2,-509.7900000000001
52835507,08/02/2023,95.66,-414.1300000000001
52835507,10/02/2023,1098.2,684.0699999999999
52835507,13/02/2023,-262.4,421.66999999999996
52835507,14/02/2023,1053.5,1475.17
52840001,31/01/2023,,746.12
52840001,01/02/2023,88.19,834.31
52840001,04/02/2023,-101.52,732.79
52840001,07/02/2023,814.4,1547.19
52855120,31/01/2023,,880.21
52855120,01/02/2023,160.48,1040.69
52855120,02/02/2023,161.91,1202.6
52855120,04/02/2023,-72.24,1130.3600000000001
52855120,09/02/2023,105.82,1236.18
52855120,10/02/2023,-61.16,1175.02
52855120,11/02/2023,-174.19,1000.83
52855120,12/02/2023,-1640.8,-639.9699999999999
52911248,31/01/2023,,430.16
52911248,01/02/2023,-161.89,268.27000000000004
52911248,03/02/2023,-105.36,162.91000000000003
52911248,05/02/2023,-131.72,31.190000000000055
52911248,07/02/2023,-162.23,-131.03999999999994
52911248,08/02/2023,72.19,-58.84999999999994
52911248,10/02/2023,-83.95,-142.79999999999995
52911248,10/02/2023,-134.99,-277.78999999999996
52911248,10/02/2023,-951.2,-1228.99
52911248,10/02/2023,-2084.1,-3313.09
52911248,12/02/2023,-125.47,-3438.5599999999995
52911248,12/02/2023,-129.73,-3568.2899999999995
52911248,13/02/2023,63.98,-3504.3099999999995
52973634,31/01/2023,,417.09
52973634,02/02/2023,104.98,522.0699999999999
52973634,02/02/2023,80.01,602.0799999999999
52973634,03/02/2023,372.2,974.28
52973634,11/02/2023,6.54,980.8199999999999
52973634,11/02/2023,-129.35,851.47
52973634,12/02/2023,172.13,1023.5999999999999
52973634,13/02/2023,134.58,1158.18
52996436,31/01/2023,,883.35
52996436,01/02/2023,86.03,969.38
52996436,03/02/2023,-173.67,795.71
52996436,08/02/2023,-95.66,700.0500000000001
52996436,14/02/2023,-1290.4,-590.35
53006272,31/01/2023,,761.95
53006272,03/02/2023,134.35,896.3000000000001
53006272,06/02/2023,-90.64,805.6600000000001
53006272,08/02/2023,160.1,965.76
53006272,08/02/2023,-88.99,876.7700000000001
53006272,14/02/2023,157.14,1033.91
53010345,31/01/2023,,131.63
53010345,06/02/2023,-123.61,8.019999999999996
53010345,10/02/2023,169.0,177.01999999999998
53010345,10/02/2023,-145.54,31.47999999999999
53010345,14/02/2023,88.77,120.24999999999999
53046005,31/01/2023,,669.82
53046005,01/02/2023,36.43,706.25
53046005,02/02/2023,52.25,758.5
53046005,04/02/2023,-58.03,700.47
53046005,06/02/2023,-129.51,570.96
53046005,13/02/2023,157.27,728.23
53046005,13/02/2023,74.51,802.7400000000001
53046005,13/02/2023,-125.85,676.8900000000001
53059420,31/01/2023,,531.72
53059420,01/02/2023,-97.79,433.93
53059420,02/02/2023,-129.83,304.1
53059420,07/02/2023,198.21,502.31000000000006
53059420,07/02/2023,140.37,642.6800000000001
53079883,31/01/2023,,489.35
53079883,05/02/2023,-115.08,374.27000000000004
53079883,05/02/2023,-150.73,223.54000000000002
53079883,09/02/2023,-257.1,-33.56
53079883,10/02/2023,-550.8,-584.3599999999999
53079883,14/02/2023,10.57,-573.7899999999998
53085668,31/01/2023,,199.11
53085668,05/02/2023,106.54,305.65000000000003
53085668,05/02/2023,-75.06,230.59000000000003
53085668,07/02/2023,-945.2,-714.61
53085668,10/02/2023,-101.56,-816.1700000000001
53085668,11/02/2023,-117.16,-933.33
53085668,14/02/2023,41.25,-892.08
53085668,14/02/2023,-24.04,-916.12
53086727,31/01/2023,,408.74
53086727,02/02/2023,115.29,524.03
53086727,10/02/2023,-1362.1,-838.0699999999999
53089607,31/01/2023,,567.87
53089607,01/02/2023,161.89,729.76
53089607,02/02/2023,147.42,877.18
53089607,05/02/2023,-176.88,700.3
53089607,11/02/2023,161.33,861.63
53089607,12/02/2023,-137.14,724.49
53089607,13/02/2023,71.18,795.6700000000001
53091928,31/01/2023,,235.6
53091928,02/02/2023,-248.7,-13.099999999999994
53091928,06/02/2023,-128.13,-141.23
53091928,07/02/2023,1741.9,1600.67
53091928,07/02/2023,-166.24,1434.43
53091928,09/02/2023,-114.01,1320.42
53091928,11/02/2023,28.8,1349.22
53091928,12/02/2023,37.22,1386.44
53107499,31/01/2023,,237.09
53107499,01/02/2023,83.86,320.95
53107499,09/02/2023,-58.86,262.09000000000003
53107499,13/02/2023,168.68,430.77
53107499,13/02/2023,-70.54,360.23
53107499,14/02/2023,-40.13,320.1
53161068,31/01/2023,,945.53
53161068,02/02/2023,962.8,1908.33
53161068,02/02/2023,177.36,2085.69
53161068,03/02/2023,62.59,2148.2799999999997
53161068,03/02/2023,-1566.6,581.6800000000001
53161068,04/02/2023,-69.83,511.8500000000001
53161068,05/02/2023,91.56,603.4100000000001
53161068,05/02/2023,-81.18,522.23
53161068,05/02/2023,-480.6,41.63000000000005
53161068,07/02/2023,108.31,149.94000000000005
53161068,10/02/2023,107.66,257.6
53161068,10/02/2023,50.5,308.1
53170488,31/01/2023,,219.2
53170488,04/02/2023,-73.5,145.7
53170488,08/02/2023,50.31,196.01
53192110,31/01/2023,,588.04
53192110,06/02/2023,117.46,705.5
53192110,07/02/2023,-53.78,651.7199999999999
53192110,14/02/2023,-88.36,563.3599999999999
53204515,31/01/2023,,689.65
53204515,02/02/2023,83.33,772.98
53204515,04/02/2023,-136.51,636.47
53204515,06/02/2023,114.15,750.62
53211412,31/01/2023,,69.51
53211412,05/02/2023,93.57,163.07999999999998
53211412,07/02/2023,-101.5,61.58
53211412,09/02/2023,-20.18,41.4
53211412,11/02/2023,41.89,83.28999999999999
53211412,11/02/2023,-197.9,-114.61000000000001
53211412,12/02/2023,121.68,7.069999999999993
53211412,13/02/2023,902.0,909.0699999999999
53211412,13/02/2023,-50.68,858.39
53234515,31/01/2023,,854.67
53234515,01/02/2023,-70.5,784.17
53234515,02/02/2023,54.57,838.74
53234515,04/02/2023,1349.2,2187.94
53234515,05/02/2023,148.33,2336.27
53234515,06/02/2023,8.35,2344.62
53240505,31/01/2023,,188.87
53240505,03/02/2023,119.64,308.51
53240505,14/02/2023,-37.21,271.3
53240505,14/02/2023,-88.35,182.95000000000002
53260868,31/01/2023,,966.85
53260868,01/02/2023,208.23,1175.08
53260868,02/02/2023,134.24,1309.32
53260868,07/02/2023,-1429.1,-119.77999999999997
53260868,10/02/2023,97.78,-21.99999999999997
53260868,12/02/2023,-25.98,-47.979999999999976
53332086,31/01/2023,,273.51
53332086,03/02/2023,-98.44,175.07
53332086,06/02/2023,116.99,292.06
53332086,06/02/2023,114.95,407.01
53332086,09/02/2023,-85.45,321.56
53332086,12/02/2023,-79.05,242.51
53332086,14/02/2023,-59.91,182.6
53366488,31/01/2023,,337.18
53366488,01/02/2023,115.41,452.59000000000003
53366488,02/02/2023,-104.72,347.87
53366488,03/02/2023,110.54,458.41
53366488,04/02/2023,-134.24,324.17
53366488,07/02/2023,107.54,431.71000000000004
53366488,10/02/2023,-102.92,328.79
53366488,13/02/2023,76.11,404.90000000000003
53376344,31/01/2023,,228.65
53376344,02/02/2023,81.01,309.66
53376344,03/02/2023,-133.94,175.72000000000003
53376344,04/02/2023,35.52,211.24000000000004
53376344,05/02/2023,85.78,297.02000000000004
53376344,14/02/2023,1365.0,1662.02
53380359,31/01/2023,,0.81
53380359,01/02/2023,-133.29,-132.48
53380359,04/02/2023,78.39,-54.08999999999999
53380359,08/02/2023,134.23,80.14
53380359,08/02/2023,-49.6,30.54
53380359,08/02/2023,-113.92,-83.38
53380359,08/02/2023,-128.8,-212.18
53380359,13/02/2023,767.3,555.1199999999999
53380359,13/02/2023,384.8,939.9199999999998
53421312,31/01/2023,,937.86
53421312,03/02/2023,-40.39,897.47
53421312,04/02/2023,44.37,941.84
53421312,04/02/2023,-199.43,742.41
53421312,07/02/2023,-13.71,728.7
53421312,08/02/2023,135.45,864.15
53421312,11/02/2023,-69.79,794.36
53421312,12/02/2023,126.99,921.3499999999999
53496996,31/01/2023,,303.15
53496996,01/02/2023,146.28,449.42999999999995
53496996,02/02/2023,74.71,524.14
53496996,05/02/2023,-106.43,417.71
53496996,07/02/2023,95.78,513.49
53496996,11/02/2023,149.19,662.68
53496996,12/02/2023,107.03,769.7099999999999
53502347,31/01/2023,,18.89
53502347,01/02/2023,84.14,103.03
53502347,01/02/2023,-490.9,-387.87
53502347,08/02/2023,-123.06,-510.93
53502347,10/02/2023,133.46,-377.47
53502347,14/02/2023,-208.0,-585.47
53502347,14/02/2023,-1469.3,-2054.77
53513558,31/01/2023,,235.44
53513558,02/02/2023,-100.89,134.55
53513558,04/02/2023,-155.63,-21.079999999999984
53513558,05/02/2023,-700.4,-721.48
53513558,08/02/2023,161.43,-560.05
53513558,09/02/2023,59.28,-500.76999999999987
53518299,31/01/2023,,953.96
53518299,01/02/2023,-116.27,837.69
53518299,08/02/2023,46.43,884.12
53518299,10/02/2023,-134.33,749.79
53538823,31/01/2023,,750.37
53538823,05/02/2023,-78.82,671.55
53538823,06/02/2023,23.13,694.6800000000001
53538823,06/02/2023,-405.7,288.98
53538823,08/02/2023,-57.77,231.21
53634705,31/01/2023,,853.12
53634705,05/02/2023,151.27,1004.39
53634705,05/02/2023,63.21,1067.6
53634705,14/02/2023,-223.99,843.61
53665038,31/01/2023,,624.95
53665038,02/02/2023,27.52,652.47
53665038,07/02/2023,-27.75,624.72
53665038,09/02/2023,-255.62,369.1
53665038,13/02/2023,113.04,482.14000000000004
53727603,31/01/2023,,517.25
53727603,02/02/2023,124.68,641.9300000000001
53727603,04/02/2023,92.05,733.98
53727603,08/02/2023,63.18,797.16
53727603,10/02/2023,-2476.1,-1678.94
53727603,11/02/2023,-1137.9,-2816.84
53727603,13/02/2023,66.54,-2750.3
53727603,13/02/2023,-75.37,-2825.67
53753986,31/01/2023,,252.69
53753986,03/02/2023,-120.33,132.36
53753986,04/02/2023,-1059.1,-926.7399999999999
53753986,06/02/2023,-165.67,-1092.4099999999999
53753986,11/02/2023,80.75,-1011.6599999999999
53753986,12/02/2023,860.8,-150.8599999999999
53754887,31/01/2023,,162.05
53754887,02/02/2023,102.25,264.3
53754887,06/02/2023,149.07,413.37
53754887,09/02/2023,54.92,468.29
53762957,31/01/2023,,245.78
53762957,01/02/2023,-101.12,144.66
53762957,09/02/2023,-179.65,-34.99000000000001
53762957,10/02/2023,149.19,114.19999999999999
53762957,10/02/2023,-100.16,14.039999999999992
53762957,11/02/2023,134.16,148.2
53762957,11/02/2023,-108.92,39.27999999999999
53762957,11/02/2023,-142.72,-103.44000000000001
53762957,12/02/2023,-150.86,-254.3
53762957,14/02/2023,51.9,-202.4
53762957,14/02/2023,-155.82,-358.22
53764356,31/01/2023,,447.88
53764356,01/02/2023,83.37,531.25
53764356,02/02/2023,197.62,728.87
53764356,02/02/2023,-74.82,654.05
53764356,04/02/2023,136.2,790.25
53764356,04/02/2023,-75.94,714.31
53764356,07/02/2023,-84.19,630.12
53764356,08/02/2023,-144.78,485.34000000000003
53764356,10/02/2023,65.52,550.86
53764356,11/02/2023,-159.34,391.52
53764356,12/02/2023,-179.93,211.58999999999997
53831793,31/01/2023,,799.66
53831793,06/02/2023,-143.57,656.0899999999999
53831793,08/02/2023,-110.44,545.65
53831793,08/02/2023,-159.35,386.29999999999995
53831793,09/02/2023,103.19,489.49
53831793,10/02/2023,135.89,625.38
53831793,13/02/2023,1226.1,1851.48
53831793,13/02/2023,127.43,1978.91
53845552,31/01/2023,,285.52
53845552,06/02/2023,967.8,1253.32
53845552,09/02/2023,-82.54,1170.78
53845615,31/01/2023,,597.04
53845615,05/02/2023,-47.51,549.53
53845615,06/02/2023,71.0,620.53
53845615,06/02/2023,-63.7,556.8299999999999
53845615,07/02/2023,-100.78,456.04999999999995
53845615,07/02/2023,-151.21,304.84
53845615,10/02/2023,7.29,312.13
53845615,10/02/2023,-1052.9,-740.7700000000001
53858816,31/01/2023,,539.38
53858816,01/02/2023,-92.2,447.18
53858816,03/02/2023,-98.53,348.65
53858816,05/02/2023,33.32,381.96999999999997
53858816,05/02/2023,-105.91,276.06
53858816,09/02/2023,-156.03,120.03
53858816,11/02/2023,1231.3,1351.33
53858816,12/02/2023,-113.78,1237.55
53884266,31/01/2023,,21.72
53884266,12/02/2023,185.51,207.23
53884266,13/02/2023,-85.84,121.38999999999999
53884266,13/02/2023,-107.98,13.409999999999982
53884626,31/01/2023,,478.38
53884626,02/02/2023,-1413.6,-935.2199999999999
53884626,03/02/2023,115.71,-819.5099999999999
53884626,07/02/2023,-88.86,-908.3699999999999
53884626,09/02/2023,134.0,-774.3699999999999
53884626,13/02/2023,1525.2,750.8300000000002
53884626,13/02/2023,74.01,824.8400000000001
53887772,31/01/2023,,541.43
53887772,02/02/2023,65.2,606.63
53887772,02/02/2023,-109.3,497.3299999999999
53887772,04/02/2023,-136.2,361.13
53887772,06/02/2023,-55.36,305.77
53887772,06/02/2023,-114.95,190.81999999999996
53887772,11/02/2023,-42.19,148.62999999999997
53887772,11/02/2023,-142.53,6.099999999999966
53887772,14/02/2023,102.09,108.18999999999997
53959112,31/01/2023,,103.99
53959112,06/02/2023,159.06,263.05
53959112,06/02/2023,60.77,323.82
53959112,07/02/2023,135.7,459.52
53959112,07/02/2023,-71.14,388.38
53959112,08/02/2023,52.99,441.37
53959112,09/02/2023,102.59,543.96
53959112,10/02/2023,-74.94,469.02
53960481,31/01/2023,,490.82
53960481,04/02/2023,103.05,593.87
53960481,06/02/2023,102.12,695.99
53960481,08/02/2023,74.39,770.38
53971767,31/01/2023,,958.87
53971767,01/02/2023,-124.24,834.63
53971767,02/02/2023,-61.97,772.66
53977562,31/01/2023,,398.76
53977562,02/02/2023,-15.93,382.83
53977562,06/02/2023,-140.83,241.99999999999997
53977562,06/02/2023,-173.03,68.96999999999997
53977562,07/02/2023,113.03,181.99999999999997
53977562,08/02/2023,-149.31,32.68999999999997
53977562,14/02/2023,145.08,177.76999999999998
53977562,14/02/2023,-25.28,152.48999999999998
54032229,31/01/2023,,176.12
54032229,03/02/2023,-87.5,88.62
54032229,05/02/2023,148.46,237.08
54032229,08/02/2023,74.13,311.21000000000004
54032229,09/02/2023,-96.2,215.01
54032229,13/02/2023,-1503.4,-1288.39
54033811,31/01/2023,,534.83
54033811,01/02/2023,-188.33,346.5
54033811,03/02/2023,-62.89,283.61
54033811,03/02/2023,-148.95,134.66000000000003
54033811,06/02/2023,114.86,249.52000000000004
54033811,06/02/2023,28.63,278.15000000000003
54033811,08/02/2023,133.59,411.74
54033811,09/02/2023,64.47,476.21000000000004
54067346,31/01/2023,,180.91
54067346,02/02/2023,96.8,277.71
54067346,08/02/2023,91.53,369.24
54067346,10/02/2023,57.19,426.43
54067346,11/02/2023,1635.6,2062.0299999999997
54067346,11/02/2023,-158.58,1903.45
54067346,12/02/2023,-25.82,1877.6299999999999
54071589,31/01/2023,,765.81
54071589,03/02/2023,-117.22,648.5899999999999
54071589,09/02/2023,-107.22,541.3699999999999
54071589,11/02/2023,119.83,661.1999999999999
54071589,11/02/2023,58.94,720.14
54071589,11/02/2023,-726.2,-6.060000000000059
54137851,31/01/2023,,30.67
54137851,05/02/2023,-81.18,-50.510000000000005
54137851,13/02/2023,71.54,21.03
54154999,31/01/2023,,962.14
54154999,01/02/2023,107.18,1069.32
54154999,02/02/2023,-49.14,1020.18
54154999,03/02/2023,-41.91,978.27
54154999,05/02/2023,27.88,1006.15
54154999,05/02/2023,-142.79,863.36
54154999,07/02/2023,102.54,965.9
54154999,07/02/2023,39.54,1005.44
54154999,08/02/2023,35.13,1040.57
54189995,31/01/2023,,401.27
54189995,03/02/2023,-13.61,387.65999999999997
54189995,04/02/2023,97.67,485.33
54189995,09/02/2023,158.61,643.94
54189995,14/02/2023,117.23,761.17
54189995,14/02/2023,-143.03,618.14
54230889,31/01/2023,,597.31
54230889,09/02/2023,-12.69,584.6199999999999
54230889,11/02/2023,75.03,659.65
54278560,31/01/2023,,161.8
54278560,01/02/2023,-167.46,-5.659999999999997
54278560,07/02/2023,92.55,86.89
54278560,08/02/2023,-134.23,-47.33999999999999
54288062,31/01/2023,,336.75
54288062,03/02/2023,104.89,441.64
54288062,03/02/2023,-46.54,395.1
54288062,04/02/2023,153.16,548.26
54288062,04/02/2023,-1266.4,-718.1400000000001
54288062,07/02/2023,152.25,-565.8900000000001
54288062,14/02/2023,120.16,-445.73000000000013
54288062,14/02/2023,-136.73,-582.46
54300071,31/01/2023,,317.35
54300071,01/02/2023,588.3,905.65
54300071,03/02/2023,111.46,1017.11
54300071,03/02/2023,87.44,1104.55
54300071,05/02/2023,58.45,1163.0
54300071,05/02/2023,-82.64,1080.36
54300071,06/02/2023,-93.21,987.15
54300071,08/02/2023,154.2,1141.35
54300071,09/02/2023,1576.6,2717.95
54300071,12/02/2023,-117.45,2600.5
54300071,12/02/2023,-134.97,2465.5299999999997
54300071,13/02/2023,1535.7,4001.2299999999996
54300071,13/02/2023,173.36,4174.59
54301151,31/01/2023,,408.16
54301151,07/02/2023,-480.0,-71.83999999999997
54301151,12/02/2023,1619.3,1547.46
54307382,31/01/2023,,452.52
54307382,02/02/2023,97.69,550.21
54307382,03/02/2023,-160.1,390.11
54307382,07/02/2023,-114.28,275.83
54307382,07/02/2023,-153.27,122.55999999999997
54307382,13/02/2023,-535.9,-413.34000000000003
54349805,31/01/2023,,752.49
54349805,02/02/2023,-96.32,656.1700000000001
54349805,04/02/2023,99.5,755.6700000000001
54349805,07/02/2023,-115.39,640.28
54349805,08/02/2023,687.1,1327.38
54349805,09/02/2023,62.59,1389.97
54349805,09/02/2023,10.05,1400.02
54349805,09/02/2023,-148.56,1251.46
54349805,10/02/2023,-149.81,1101.65
54349805,13/02/2023,59.45,1161.1
54377130,31/01/2023,,425.86
54377130,03/02/2023,-91.66,334.20000000000005
54377130,04/02/2023,-16.51,317.69
54377130,05/02/2023,124.37,442.06
54377130,06/02/2023,123.37,565.4300000000001
54377130,08/02/2023,-1119.6,-554.1699999999998
54377130,11/02/2023,27.58,-526.5899999999998
54377130,12/02/2023,-183.41,-709.9999999999998
54377538,31/01/2023,,845.93
54377538,02/02/2023,75.99,921.92
54377538,02/02/2023,-91.57,830.3499999999999
54377538,02/02/2023,-1145.1,-314.75
54377538,07/02/2023,178.2,-136.55
54377538,11/02/2023,112.1,-24.450000000000017
54405539,31/01/2023,,397.2
54405539,03/02/2023,106.8,504.0
54405539,03/02/2023,87.6,591.6
54405539,04/02/2023,-80.75,510.84999999999997
54405539,10/02/2023,189.51,700.3599999999999
54405539,11/02/2023,-78.29,622.0699999999999
54405539,13/02/2023,-84.66,537.41
54452317,31/01/2023,,358.39
54452317,04/02/2023,-33.69,324.7
54452317,05/02/2023,56.72,381.41999999999996
54452317,06/02/2023,140.78,522.2
54452317,07/02/2023,106.48,628.68
54452317,07/02/2023,-98.66,530.02
54452317,09/02/2023,-859.1,-329.08000000000004
54452317,11/02/2023,139.14,-189.94000000000005
54458410,31/01/2023,,973.1
54458410,04/02/2023,-129.56,843.54
54458410,09/02/2023,138.8,982.34
54458410,10/02/2023,-87.63,894.71
54458410,12/02/2023,68.8,963.51
54458410,13/02/2023,-97.77,865.74
54541943,31/01/2023,,433.92
54541943,02/02/2023,156.5,590.4200000000001
54541943,03/02/2023,-77.36,513.0600000000001
54541943,08/02/2023,1686.0,2199.06
54541943,09/02/2023,-74.96,2124.1
54541943,10/02/2023,202.69,2326.79
54541943,11/02/2023,121.09,2447.88
54541943,14/02/2023,58.63,2506.5099999999998
54565625,31/01/2023,,472.76
54565625,01/02/2023,148.64,621.4
54565625,03/02/2023,-79.68,541.72
54565625,06/02/2023,1947.3,2489.02
54565625,07/02/2023,-62.17,2426.85
54565625,08/02/2023,104.18,2531.03
54565625,09/02/2023,-109.08,2421.95
54565625,10/02/2023,-152.17,2269.78
54565625,11/02/2023,42.95,2312.73
54565625,11/02/2023,-170.89,2141.84
54565625,11/02/2023,-246.42,1895.42
54565625,13/02/2023,70.85,1966.27
54565625,13/02/2023,-77.52,1888.75
54565625,14/02/2023,-100.41,1788.3400000000001
54570251,31/01/2023,,430.68
54570251,03/02/2023,109.86,540.54
54570251,03/02/2023,-79.51,461.03
54570251,04/02/2023,25.74,486.77
54570251,06/02/2023,-105.34,381.43
54570251,09/02/2023,-129.85,251.57999999999998
54570251,09/02/2023,-166.16,85.41999999999999
54570251,14/02/2023,-51.9,33.51999999999999
54589543,31/01/2023,,817.51
54589543,02/02/2023,-1117.0,-299.49
54589543,06/02/2023,977.0,677.51
54589543,08/02/2023,96.45,773.96
54589543,10/02/2023,154.39,928.3499999999999
54589543,12/02/2023,-106.92,821.43
54589543,12/02/2023,-180.17,641.26
54589543,13/02/2023,-125.92,515.34
54673873,31/01/2023,,71.58
54673873,05/02/2023,73.99,145.57
54673873,11/02/2023,55.02,200.59
54673873,11/02/2023,-32.2,168.39
54673873,14/02/2023,134.69,303.08
54720837,31/01/2023,,166.15
54720837,04/02/2023,133.55,299.70000000000005
54720837,05/02/2023,-142.54,157.16000000000003
54720837,10/02/2023,121.97,279.13
54720837,11/02/2023,-409.8,-130.66999999999996
54720837,13/02/2023,125.97,-4.69999999999996
54720837,13/02/2023,93.53,88.83000000000004
54786481,31/01/2023,,96.87
54786481,04/02/2023,-146.68,-49.81
54786481,07/02/2023,134.29,84.47999999999999
54786481,08/02/2023,68.63,153.10999999999999
54786481,09/02/2023,36.48,189.58999999999997
54786481,11/02/2023,121.25,310.84
54786481,12/02/2023,-37.05,273.78999999999996
54786481,13/02/2023,-99.06,174.72999999999996
54824933,31/01/2023,,721.47
54824933,05/02/2023,-130.71,590.76
54824933,09/02/2023,1549.1,2139.8599999999997
54824933,10/02/2023,106.03,2245.89
54824933,10/02/2023,11.9,2257.79
54824933,12/02/2023,-120.78,2137.0099999999998
54852109,31/01/2023,,521.7
54852109,09/02/2023,993.4,1515.1
54852109,13/02/2023,70.25,1585.35
54868017,31/01/2023,,789.86
54868017,06/02/2023,49.33,839.19
54868017,08/02/2023,165.57,1004.76
54868017,08/02/2023,-1024.6,-19.839999999999918
54868017,10/02/2023,158.94,139.10000000000008
54868017,11/02/2023,181.68,320.7800000000001
54868017,11/02/2023,-143.78,177.00000000000009
54868017,13/02/2023,-148.43,28.57000000000008
54878364,31/01/2023,,80.24
54878364,03/02/2023,85.24,165.48
54878364,07/02/2023,-1689.7,-1524.22
54878364,08/02/2023,63.42,-1460.8
54910290,31/01/2023,,11.12
54910290,04/02/2023,950.2,961.32
54910290,06/02/2023,-48.88,912.44
54910290,06/02/2023,-51.05,861.3900000000001
54910290,06/02/2023,-120.17,741.22
54910290,07/02/2023,-129.66,611.5600000000001
54910290,08/02/2023,85.98,697.5400000000001
54910290,09/02/2023,-62.92,634.6200000000001
54910290,12/02/2023,165.42,800.0400000000001
54932317,31/01/2023,,378.86
54932317,04/02/2023,15.32,394.18
54932317,06/02/2023,52.94,447.12
54932317,08/02/2023,10.18,457.3
54932317,09/02/2023,82.57,539.87
54932317,10/02/2023,-116.53,423.34000000000003
54932317,11/02/2023,-858.7,-435.36
54932317,13/02/2023,44.84,-390.52
54932317,14/02/2023,-158.33,-548.85
54937975,31/01/2023,,218.66
54937975,07/02/2023,-62.35,156.31
54937975,09/02/2023,-37.53,118.78
54937975,11/02/2023,-1507.4,-1388.6200000000001
54937975,14/02/2023,195.92,-1192.7
54937975,14/02/2023,96.78,-1095.92
54958511,31/01/2023,,454.61
54958511,06/02/2023,-157.18,297.43
54958511,08/02/2023,-44.34,253.09
54958511,09/02/2023,180.82,433.90999999999997
54958511,12/02/2023,-81.37,352.53999999999996
54958587,31/01/2023,,874.83
54958587,03/02/2023,-106.51,768.32
54958587,04/02/2023,-81.63,686.69
54958587,06/02/2023,-50.78,635.9100000000001
54958587,07/02/2023,-117.45,518.46
54958587,08/02/2023,110.15,628.61
54958587,08/02/2023,-50.71,577.9000000000001
54958587,14/02/2023,-112.23,465.6700000000001
54997427,31/01/2023,,825.84
54997427,02/02/2023,-37.62,788.22
54997427,08/02/2023,-110.6,677.62
55009163,31/01/2023,,435.8
55009163,05/02/2023,123.78,559.58
55009163,07/02/2023,-77.09,482.49
55009163,08/02/2023,-44.05,438.44
55009163,08/02/2023,-187.67,250.77000000000004
55009163,10/02/2023,137.34,388.11
55009163,10/02/2023,86.61,474.72
55009163,13/02/2023,-23.17,451.55000000000007
55022533,31/01/2023,,341.29
55022533,05/02/2023,-35.44,305.85
55022533,05/02/2023,-174.7,131.15000000000003
55022533,07/02/2023,140.77,271.9200000000001
55022533,09/02/2023,-98.03,173.89000000000004
55088029,31/01/2023,,920.53
55088029,01/02/2023,-152.86,767.67
55088029,03/02/2023,556.5,1324.17
55088029,11/02/2023,122.71,1446.8799999999999
55106431,31/01/2023,,460.48
55106431,04/02/2023,163.15,623.63
55106431,04/02/2023,150.02,773.6500000000001
55106431,08/02/2023,101.87,875.52
55122249,31/01/2023,,43.86
55122249,11/02/2023,-66.07,-22.209999999999994
55122249,12/02/2023,84.75,62.540000000000006
55122249,14/02/2023,152.84,215.38
55122249,14/02/2023,68.84,284.22
55168205,31/01/2023,,578.4
55168205,01/02/2023,-78.1,500.29999999999995
55168205,04/02/2023,-120.38,379.91999999999996
55168205,06/02/2023,95.11,475.03
55168205,07/02/2023,88.15,563.18
55168205,13/02/2023,66.15,629.33
55168205,14/02/2023,24.04,653.37
55168205,14/02/2023,-1137.7,-484.33000000000004
55304418,31/01/2023,,968.71
55304418,07/02/2023,-88.15,880.5600000000001
55304418,08/02/2023,-107.41,773.1500000000001
55304418,09/02/2023,57.36,830.51
55304418,10/02/2023,-1795.9,-965.3900000000001
55304418,11/02/2023,-1214.6,-2179.99
55304418,12/02/2023,158.82,-2021.17
55304418,13/02/2023,-871.5,-2892.67
55341552,31/01/2023,,768.94
55341552,02/02/2023,755.3,1524.24
55341552,02/02/2023,48.35,1572.59
55341552,04/02/2023,567.7,2140.29
55341552,09/02/2023,-168.65,1971.64
55341552,12/02/2023,-70.46,1901.18
55341552,13/02/2023,-142.04,1759.14
55353228,31/01/2023,,923.38
55353228,05/02/2023,-540.8,382.58000000000004
55353228,09/02/2023,-29.71,352.87000000000006
55353228,11/02/2023,-132.96,219.91000000000003
55353228,13/02/2023,105.18,325.09000000000003
55397453,31/01/2023,,820.88
55397453,01/02/2023,96.77,917.65
55397453,02/02/2023,1413.6,2331.25
55397453,06/02/2023,198.2,2529.45
55397453,07/02/2023,121.46,2650.91
55397453,07/02/2023,-132.91,2518.0
55397453,08/02/2023,143.22,2661.22
55397453,08/02/2023,80.46,2741.68
55397453,08/02/2023,-151.99,2589.69
55397453,14/02/2023,194.38,2784.07
55398856,31/01/2023,,663.43
55398856,01/02/2023,-645.5,17.92999999999995
55398856,02/02/2023,884.3,902.2299999999999
55398856,03/02/2023,95.54,997.7699999999999
55398856,04/02/2023,-19.13,978.6399999999999
55398856,07/02/2023,47.31,1025.9499999999998
55398856,11/02/2023,-88.16,937.79
55398856,12/02/2023,139.58,1077.37
55459151,31/01/2023,,451.21
55459151,02/02/2023,-162.1,289.11
55459151,06/02/2023,161.61,450.72
55459151,06/02/2023,-78.08,372.64
55459151,09/02/2023,-46.3,326.34000000000003
55459151,09/02/2023,-897.0,-570.66
55459151,14/02/2023,144.85,-425.80999999999995
55459151,14/02/2023,64.45,-361.35999999999996
55472786,31/01/2023,,634.29
55513887,31/01/2023,,722.45
55513887,02/02/2023,-116.43,606.02
55513887,03/02/2023,-74.5,531.52
55513887,11/02/2023,218.81,750.33
55513887,11/02/2023,-50.13,700.2
55513887,13/02/2023,116.37,816.57
55513887,14/02/2023,-76.32,740.25
55552232,31/01/2023,,953.87
55552232,01/02/2023,152.59,1106.46
55552232,06/02/2023,51.75,1158.21
55552232,06/02/2023,-167.46,990.75
55552232,10/02/2023,-679.8,310.95000000000005
55552232,12/02/2023,-149.57,161.38000000000005
55590263,31/01/2023,,605.12
55590263,01/02/2023,189.32,794.44
55590263,03/02/2023,-215.09,579.35
55590263,07/02/2023,116.74,696.09
55590263,07/02/2023,-76.2,619.89
55590263,09/02/2023,78.22,698.11
55607955,31/01/2023,,274.23
55607955,07/02/2023,-89.17,185.06
55607955,12/02/2023,-0.94,184.12
55607955,13/02/2023,53.93,238.05
55714753,31/01/2023,,703.59
55714753,03/02/2023,-64.43,639.1600000000001
55714753,06/02/2023,-30.38,608.78
55714753,07/02/2023,38.04,646.82
55714753,10/02/2023,-26.55,620.27
55753843,31/01/2023,,524.57
55753843,04/02/2023,-158.04,366.5300000000001
55753843,05/02/2023,-147.75,218.78000000000006
55753843,10/02/2023,-194.97,23.81000000000006
55753843,11/02/2023,-127.25,-103.43999999999994
55791547,31/01/2023,,758.17
55791547,07/02/2023,-85.35,672.8199999999999
55791547,08/02/2023,1565.7,2238.52
55791547,09/02/2023,58.39,2296.91
55791547,11/02/2023,-125.71,2171.2
55791547,13/02/2023,188.62,2359.82
55795603,31/01/2023,,241.17
55795603,02/02/2023,-112.16,129.01
55795603,04/02/2023,-482.7,-353.69
55795603,08/02/2023,179.3,-174.39
55795603,10/02/2023,-40.02,-214.41
55795603,12/02/2023,-272.8,-487.21000000000004
55819086,31/01/2023,,608.13
55819086,01/02/2023,209.89,818.02
55819086,01/02/2023,90.71,908.73
55819086,03/02/2023,510.1,1418.83
55819086,03/02/2023,218.15,1636.98
55819086,03/02/2023,-130.36,1506.62
55819086,04/02/2023,88.18,1594.8
55819086,09/02/2023,-135.23,1459.57
55819086,10/02/2023,98.96,1558.53
55819086,13/02/2023,-51.71,1506.82
55819086,14/02/2023,84.96,1591.78
55912413,31/01/2023,,297.61
55912413,03/02/2023,77.0,374.61
55912413,03/02/2023,-90.58,284.03000000000003
55912413,11/02/2023,-102.08,181.95000000000002
55912413,13/02/2023,97.05,279.0
55912413,13/02/2023,-25.66,253.34
55916056,31/01/2023,,377.36
55916056,06/02/2023,1338.0,1715.3600000000001
55916056,06/02/2023,143.44,1858.8000000000002
55916056,06/02/2023,-60.08,1798.72
55916056,06/02/2023,-178.4,1620.3200000000002
55916056,08/02/2023,103.03,1723.3500000000001
55916056,10/02/2023,-79.86,1643.49
55975906,31/01/2023,,112.69
55975906,03/02/2023,-94.79,17.89999999999999
55975906,04/02/2023,-44.5,-26.60000000000001
55975906,05/02/2023,74.28,47.67999999999999
55975906,14/02/2023,148.63,196.31
55986027,31/01/2023,,38.94
55986027,03/02/2023,-100.38,-61.44
55986027,05/02/2023,98.72,37.28
55986027,06/02/2023,-840.3,-803.02
55986027,09/02/2023,-94.29,-897.31
55986027,11/02/2023,-90.72,-988.03
55986027,12/02/2023,-39.77,-1027.8
55986027,13/02/2023,-1619.8,-2647.6
55986093,31/01/2023,,586.34
55986093,07/02/2023,1298.9,1885.2400000000002
55986093,08/02/2023,-88.74,1796.5000000000002
55986093,11/02/2023,139.86,1936.3600000000001
55986093,14/02/2023,-7.29,1929.0700000000002
55986093,14/02/2023,-135.61,1793.4600000000003
56041976,31/01/2023,,56.45
56041976,04/02/2023,55.94,112.39
56041976,07/02/2023,-122.99,-10.599999999999994
56041976,08/02/2023,107.83,97.23
56041976,09/02/2023,93.51,190.74
56041976,10/02/2023,-10.96,179.78
56070421,31/01/2023,,286.85
56070421,03/02/2023,-65.15,221.70000000000002
56070421,13/02/2023,113.44,335.14
56094156,31/01/2023,,531.43
56094156,07/02/2023,-140.77,390.65999999999997
56094156,08/02/2023,258.6,649.26
56094156,09/02/2023,-45.07,604.1899999999999
56094156,10/02/2023,193.16,797.35
56094156,13/02/2023,1237.4,2034.75
56116199,31/01/2023,,615.98
56116199,01/02/2023,-129.83,486.15
56116199,03/02/2023,-35.32,450.83
56116199,06/02/2023,-126.54,324.28999999999996
56116199,10/02/2023,91.04,415.33
56120063,31/01/2023,,94.32
56120063,02/02/2023,179.69,274.01
56120063,04/02/2023,-89.11,184.89999999999998
56120063,06/02/2023,137.1,322.0
56120063,07/02/2023,122.13,444.13
56120063,07/02/2023,98.42,542.55
56120063,08/02/2023,-174.24,368.31
56120063,11/02/2023,-41.23,327.08
56189750,31/01/2023,,365.48
56189750,07/02/2023,-121.65,243.83
56189750,10/02/2023,-50.54,193.29000000000002
56189750,12/02/2023,155.17,348.46000000000004
56189750,14/02/2023,2237.0,2585.46
56297850,31/01/2023,,320.47
56297850,01/02/2023,-114.68,205.79000000000002
56297850,05/02/2023,52.34,258.13
56297850,08/02/2023,30.53,288.66
56297850,12/02/2023,-21.61,267.05
56422161,31/01/2023,,990.84
56422161,07/02/2023,46.29,1037.13
56422161,08/02/2023,62.89,1100.02
56422161,09/02/2023,110.83,1210.85
56422161,10/02/2023,38.38,1249.23
56422161,14/02/2023,195.84,1445.07
56422161,14/02/2023,95.91,1540.98
56453199,31/01/2023,,605.38
56453199,01/02/2023,-71.22,534.16
56453199,08/02/2023,-105.53,428.63
56453199,08/02/2023,-697.8,-269.16999999999996
56453199,10/02/2023,-55.02,-324.18999999999994
56458213,31/01/2023,,731.3
56458213,01/02/2023,-588.3,143.0
56458213,02/02/2023,-1351.2,-1208.2
56458213,06/02/2023,-141.23,-1349.43
56458213,10/02/2023,-120.81,-1470.24
56458213,12/02/2023,-121.0,-1591.24
56458213,14/02/2023,181.24,-1410.0
56468624,31/01/2023,,655.33
56468624,03/02/2023,16.2,671.5300000000001
56468624,03/02/2023,-88.74,582.7900000000001
56468624,08/02/2023,92.38,675.1700000000001
56468624,12/02/2023,910.1,1585.27
56468624,13/02/2023,-68.93,1516.3400000000001
56483442,31/01/2023,,151.85
56483442,02/02/2023,-1298.8,-1146.95
56483442,10/02/2023,163.18,-983.77
56573058,31/01/2023,,34.66
56573058,01/02/2023,129.52,164.18
56573058,02/02/2023,-61.2,102.98
56573058,04/02/2023,163.58,266.56
56573058,04/02/2023,37.75,304.31000000000006
56573058,06/02/2023,48.88,353.19000000000005
56573058,07/02/2023,-137.57,215.62000000000003
56573058,09/02/2023,-118.82,96.80000000000004
56573058,12/02/2023,907.1,1003.9000000000001
56573058,12/02/2023,214.19,1218.0900000000001
56573058,13/02/2023,-53.93,1164.16
56609826,31/01/2023,,14.24
56609826,05/02/2023,174.96,189.20000000000002
56609826,09/02/2023,134.28,323.48
56609826,12/02/2023,-136.93,186.55
56609826,14/02/2023,87.3,273.85
56723864,31/01/2023,,246.21
56723864,01/02/2023,-128.49,117.72
56723864,02/02/2023,137.59,255.31
56723864,03/02/2023,164.36,419.67
56723864,06/02/2023,167.46,587.13
56723864,07/02/2023,-76.84,510.29
56723864,11/02/2023,117.62,627.9100000000001
56723864,11/02/2023,69.79,697.7
56723864,12/02/2023,-104.46,593.24
56723864,14/02/2023,-70.03,523.21
56751728,31/01/2023,,610.52
56751728,02/02/2023,-93.7,516.8199999999999
56751728,02/02/2023,-128.71,388.10999999999996
56751728,06/02/2023,83.83,471.93999999999994
56751728,07/02/2023,-63.12,408.81999999999994
56751728,08/02/2023,-974.3,-565.48
56751728,13/02/2023,-120.16,-685.64
56759680,31/01/2023,,479.7
56759680,11/02/2023,90.65,570.35
56760248,31/01/2023,,571.55
56760248,03/02/2023,56.89,628.4399999999999
56760248,03/02/2023,5.38,633.8199999999999
56760248,03/02/2023,-49.32,584.5
56760248,06/02/2023,111.41,695.91
56760248,06/02/2023,-109.59,586.3199999999999
56760248,06/02/2023,-173.92,412.4
56760248,08/02/2023,-38.27,374.13
56760248,09/02/2023,89.08,463.21
56760248,12/02/2023,-101.83,361.38
56760248,13/02/2023,357.3,718.6800000000001
56842874,31/01/2023,,22.02
56842874,06/02/2023,-69.2,-47.18000000000001
56842874,12/02/2023,-127.2,-174.38
56843498,31/01/2023,,509.55
56843498,01/02/2023,122.7,632.25
56843498,02/02/2023,104.79,737.04
56843498,04/02/2023,101.52,838.5600000000001
56843498,05/02/2023,-160.23,678.33
56843498,05/02/2023,-1345.1,-666.7699999999999
56843498,09/02/2023,1156.9,490.1300000000002
56843498,09/02/2023,135.23,625.3600000000002
56843498,13/02/2023,-121.9,503.4600000000002
56875373,31/01/2023,,633.79
56875373,01/02/2023,-71.73,562.06
56875373,03/02/2023,103.79,665.8499999999999
56875373,04/02/2023,-100.66,565.1899999999999
56875373,07/02/2023,-69.39,495.79999999999995
56875373,11/02/2023,159.77,655.5699999999999
56878640,31/01/2023,,846.85
56878640,03/02/2023,139.16,986.01
56878640,05/02/2023,99.24,1085.25
56878640,10/02/2023,121.71,1206.96
56878640,12/02/2023,36.64,1243.6
56878640,12/02/2023,-151.09,1092.51
56899079,31/01/2023,,445.39
56899079,09/02/2023,-827.3,-381.90999999999997
56922739,31/01/2023,,174.07
56922739,03/02/2023,-220.14,-46.06999999999999
56922739,05/02/2023,102.17,56.10000000000001
56922739,07/02/2023,-80.94,-24.83999999999999
56922739,11/02/2023,-107.01,-131.85
56936624,31/01/2023,,503.74
56936624,02/02/2023,1921.4,2425.1400000000003
56936624,03/02/2023,73.31,2498.4500000000003
56936624,03/02/2023,-101.8,2396.65
56936624,07/02/2023,105.18,2501.83
56936624,12/02/2023,125.27,2627.1
56936624,14/02/2023,-166.38,2460.7200000000003
56946115,31/01/2023,,298.13
56946115,02/02/2023,-45.22,252.91
56946115,07/02/2023,74.35,327.26
56946115,12/02/2023,-92.42,234.83999999999997
57027965,31/01/2023,,979.57
57027965,02/02/2023,103.75,1083.3200000000002
57027965,02/02/2023,-111.9,971.4200000000001
57027965,02/02/2023,-115.29,856.13
57027965,05/02/2023,-109.24,746.8900000000001
57027965,06/02/2023,-197.61,549.28
57027965,08/02/2023,-92.59,456.69000000000005
57027965,09/02/2023,54.69,511.38
57027965,10/02/2023,-210.62,300.76
57027965,11/02/2023,151.02,451.78000000000003
57027965,14/02/2023,-127.34,324.44000000000005
57043647,31/01/2023,,552.06
57043647,01/02/2023,-103.35,448.7099999999999
57043647,03/02/2023,124.18,572.89
57043647,03/02/2023,58.81,631.6999999999999
57043647,09/02/2023,-53.56,578.14
57043647,11/02/2023,152.46,730.5999999999999
57043647,12/02/2023,14.26,744.86
57043647,13/02/2023,107.17,852.03
57043647,13/02/2023,-1207.6,-355.56999999999994
57063886,31/01/2023,,384.17
57063886,04/02/2023,134.46,518.63
57063886,07/02/2023,33.98,552.61
57063886,09/02/2023,-110.14,442.47
57063886,10/02/2023,182.75,625.22
57063886,13/02/2023,-98.44,526.78
57071366,31/01/2023,,911.45
57071366,01/02/2023,80.58,992.0300000000001
57071366,01/02/2023,76.18,1068.21
57071366,03/02/2023,96.63,1164.8400000000001
57071366,03/02/2023,-19.89,1144.95
57071366,08/02/2023,88.56,1233.51
57071366,09/02/2023,-55.83,1177.68
57071366,09/02/2023,-125.68,1052.0
57071366,11/02/2023,49.96,1101.96
57084496,31/01/2023,,58.05
57084496,01/02/2023,1058.7,1116.75
57084496,01/02/2023,802.6,1919.35
57084496,04/02/2023,-121.83,1797.52
57084496,07/02/2023,18.61,1816.13
57084496,10/02/2023,8.85,1824.98
57084496,10/02/2023,-82.33,1742.65
57084496,12/02/2023,-1251.2,491.45000000000005
57084496,14/02/2023,-63.0,428.45000000000005
57096259,31/01/2023,,540.54
57096259,02/02/2023,168.98,709.52
57096259,03/02/2023,101.3,810.8199999999999
57096259,05/02/2023,77.95,888.77
57096259,05/02/2023,-907.1,-18.33000000000004
57096259,06/02/2023,-24.84,-43.170000000000044
57096259,09/02/2023,97.89,54.719999999999956
57108303,31/01/2023,,737.04
57108303,03/02/2023,118.63,855.67
57108303,04/02/2023,-1795.8,-940.13
57108303,05/02/2023,49.78,-890.35
57108303,13/02/2023,97.98,-792.37
57121657,31/01/2023,,847.9
57121657,01/02/2023,135.55,983.45
57121657,05/02/2023,54.79,1038.24
57121657,08/02/2023,796.3,1834.54
57121657,08/02/2023,100.27,1934.81
57121657,08/02/2023,-9.98,1924.83
57121657,12/02/2023,-65.93,1858.8999999999999
57121657,12/02/2023,-134.36,1724.54
57121657,13/02/2023,154.58,1879.12
57121657,14/02/2023,96.98,1976.1
57133159,31/01/2023,,734.4
57133159,09/02/2023,102.35,836.75
57133159,13/02/2023,128.11,964.86
57145139,31/01/2023,,708.46
57145139,02/02/2023,-62.33,646.13
57145139,04/02/2023,-186.01,460.12000000000006
57145139,05/02/2023,-1233.7,-773.5799999999999
57145139,07/02/2023,143.04,-630.54
57145139,07/02/2023,108.88,-521.66
57145139,07/02/2023,-81.96,-603.6199999999999
57145139,08/02/2023,-100.27,-703.8899999999999
57148382,31/01/2023,,638.49
57148382,01/02/2023,81.16,719.65
57148382,04/02/2023,-126.18,593.47
57148382,05/02/2023,-155.64,437.83000000000004
57148382,06/02/2023,-876.5,-438.66999999999996
57148382,07/02/2023,-85.25,-523.92
57148382,10/02/2023,105.08,-418.84
57148382,12/02/2023,144.16,-274.67999999999995
57160773,31/01/2023,,802.9
57160773,01/02/2023,96.2,899.1
57160773,03/02/2023,-472.5,426.59999999999997
57160773,05/02/2023,119.28,545.88
57160773,08/02/2023,-77.84,468.03999999999996
57160773,10/02/2023,167.51,635.55
57160773,13/02/2023,-45.56,589.99
57186194,31/01/2023,,824.69
57186194,01/02/2023,-106.33,718.36
57186194,02/02/2023,-109.06,609.3000000000001
57186194,05/02/2023,-111.92,497.38000000000005
57186194,09/02/2023,-181.31,316.07000000000005
57186194,13/02/2023,48.13,364.20000000000005
57186194,14/02/2023,158.38,522.58
57186194,14/02/2023,-756.9,-234.31999999999994
57224848,31/01/2023,,30.59
57224848,02/02/2023,96.85,127.44
57224848,02/02/2023,-74.5,52.94
57224848,05/02/2023,-77.0,-24.060000000000002
57224848,07/02/2023,85.73,61.67
57224848,10/02/2023,-1987.3,-1925.6299999999999
57224848,12/02/2023,-27.74,-1953.37
57224848,12/02/2023,-112.58,-2065.95
57273397,31/01/2023,,403.21
57273397,06/02/2023,154.24,557.45
57273397,06/02/2023,-134.08,423.37
57273397,09/02/2023,36.49,459.85999999999996
57273397,11/02/2023,117.16,577.02
57273397,11/02/2023,81.26,658.28
57273397,13/02/2023,-186.3,471.97999999999996
57273397,14/02/2023,-97.09,374.89
57300901,31/01/2023,,302.87
57300901,01/02/2023,-65.35,237.52
57300901,03/02/2023,108.13,345.65
57300901,03/02/2023,-72.03,273.62
57300901,04/02/2023,213.8,487.42
57300901,04/02/2023,-1320.2,-832.78
57300901,09/02/2023,-78.1,-910.88
57300901,10/02/2023,-162.36,-1073.24
57300901,12/02/2023,137.14,-936.1
57300901,12/02/2023,100.81,-835.29
57302841,31/01/2023,,341.02
57302841,01/02/2023,72.19,413.21
57302841,08/02/2023,152.99,566.2
57302841,08/02/2023,-91.11,475.09
57302841,13/02/2023,-134.97,340.12
57372684,31/01/2023,,249.26
57372684,01/02/2023,111.48,360.74
57372684,02/02/2023,237.02,597.76
57372684,06/02/2023,-141.38,456.38
57372684,08/02/2023,-52.45,403.93
57372684,10/02/2023,121.29,525.22
57372684,10/02/2023,-94.14,431.08
57372684,12/02/2023,-93.57,337.51
57395511,31/01/2023,,747.89
57395511,02/02/2023,-151.59,596.3
57395511,06/02/2023,-91.85,504.45
57395511,07/02/2023,120.5,624.95
57395511,09/02/2023,-82.57,542.38
57395511,11/02/2023,85.36,627.74
57395511,12/02/2023,-95.25,532.49
57395511,13/02/2023,123.69,656.18
57395511,14/02/2023,-83.11,573.0699999999999
57413609,31/01/2023,,219.01
57413609,08/02/2023,-30.21,188.79999999999998
57413609,12/02/2023,-68.21,120.59
57426365,31/01/2023,,606.03
57426365,01/02/2023,123.23,729.26
57426365,01/02/2023,94.29,823.55
57426365,01/02/2023,65.35,888.9
57426365,03/02/2023,52.27,941.17
57426365,05/02/2023,6.87,948.04
57426365,05/02/2023,-76.24,871.8
57426365,06/02/2023,-126.49,745.31
57426365,10/02/2023,52.93,798.24
57426365,12/02/2023,-100.61,697.63
57426365,14/02/2023,37.59,735.22
57436108,31/01/2023,,899.46
57436108,02/02/2023,49.76,949.22
57436108,02/02/2023,-98.78,850.44
57436108,04/02/2023,-1349.2,-498.76
57436108,05/02/2023,-129.49,-628.25
57436108,10/02/2023,-103.49,-731.74
57436108,13/02/2023,127.61,-604.13
57446648,31/01/2023,,542.41
57446648,02/02/2023,179.19,721.5999999999999
57446648,06/02/2023,1201.1,1922.6999999999998
57446648,09/02/2023,123.62,2046.3199999999997
57446648,12/02/2023,129.84,2176.16
57450523,31/01/2023,,609.41
57450523,03/02/2023,82.41,691.8199999999999
57450523,06/02/2023,-82.1,609.72
57450523,08/02/2023,59.47,669.1899999999999
57450523,11/02/2023,-77.75,591.4399999999999
57450523,11/02/2023,-991.6,-400.1600000000001
57450523,12/02/2023,137.83,-262.33000000000004
57507102,31/01/2023,,374.17
57507102,01/02/2023,-84.14,290.03000000000003
57507102,09/02/2023,-31.87,258.16
57507102,11/02/2023,-148.04,110.12000000000003
57507102,12/02/2023,31.75,141.87000000000003
57507102,13/02/2023,116.22,258.09000000000003
57507102,14/02/2023,74.72,332.81000000000006
57584855,31/01/2023,,37.86
57584855,01/02/2023,-83.37,-45.510000000000005
57584855,07/02/2023,-125.24,-170.75
57584855,09/02/2023,155.0,-15.75
57584855,11/02/2023,81.2,65.45
57584855,11/02/2023,-51.18,14.270000000000003
57584855,12/02/2023,-56.96,-42.69
57610201,31/01/2023,,931.52
57610201,03/02/2023,-676.5,255.01999999999998
57610201,04/02/2023,97.9,352.91999999999996
57610201,06/02/2023,-58.71,294.21
57610201,11/02/2023,-56.37,237.83999999999997
57610201,12/02/2023,25.98,263.82
57610201,12/02/2023,-145.68,118.13999999999999
57610201,13/02/2023,-158.29,-40.150000000000006
57610201,14/02/2023,64.87,24.72
57612494,31/01/2023,,499.3
57612494,05/02/2023,109.6,608.9
57612494,12/02/2023,103.32,712.22
57612494,12/02/2023,-44.09,668.13
57675131,31/01/2023,,410.85
57675131,02/02/2023,90.07,500.92
57675131,04/02/2023,112.22,613.14
57675131,07/02/2023,123.24,736.38
57675131,07/02/2023,-150.92,585.46
57687949,31/01/2023,,542.92
57687949,01/02/2023,119.2,662.12
57687949,03/02/2023,-88.02,574.0999999999999
57687949,07/02/2023,211.2,785.3
57687949,08/02/2023,-119.51,665.79
57687949,09/02/2023,682.6,1348.3899999999999
57687949,12/02/2023,143.47,1491.86
57687949,13/02/2023,-94.69,1397.17
57717550,31/01/2023,,832.39
57717550,01/02/2023,119.21,951.6
57717550,01/02/2023,-103.68,847.92
57717550,03/02/2023,-125.77,722.15
57717550,09/02/2023,61.13,783.28
57790631,31/01/2023,,893.46
57790631,01/02/2023,-105.16,788.3000000000001
57790631,09/02/2023,-71.26,717.0400000000001
57790631,11/02/2023,166.8,883.84
57790631,14/02/2023,-1139.7,-255.86
57886631,31/01/2023,,369.6
57886631,05/02/2023,61.09,430.69000000000005
57886631,06/02/2023,543.9,974.59
57886631,07/02/2023,52.98,1027.57
57886631,08/02/2023,-114.36,913.21
57886631,11/02/2023,110.5,1023.71
57886631,11/02/2023,-154.67,869.0400000000001
57886631,12/02/2023,-85.93,783.11
57886631,13/02/2023,-143.14,639.97
57897038,31/01/2023,,399.72
57897038,01/02/2023,-38.67,361.05
57897038,02/02/2023,46.31,407.36
57897038,04/02/2023,118.34,525.7
57897038,06/02/2023,119.61,645.3100000000001
57897038,09/02/2023,-1653.1,-1007.7899999999998
57897038,11/02/2023,-88.41,-1096.1999999999998
57941886,31/01/2023,,270.81
57941886,02/02/2023,224.12,494.93
57941886,02/02/2023,166.1,661.03
57941886,06/02/2023,-154.07,506.96000000000004
57941886,08/02/2023,-59.97,446.99
57941886,12/02/2023,38.42,485.41
57941886,14/02/2023,-37.37,448.04
57948925,31/01/2023,,194.11
57948925,03/02/2023,-95.29,98.82000000000001
57948925,04/02/2023,-1465.5,-1366.68
57948925,07/02/2023,182.69,-1183.99
57948925,09/02/2023,-7.12,-1191.1100000000001
57948925,09/02/2023,-96.17,-1287.28
57948925,13/02/2023,-1505.7,-2792.98
57975842,31/01/2023,,101.94
57975842,10/02/2023,181.0,282.94
58009817,31/01/2023,,887.22
58009817,02/02/2023,121.1,1008.32
58009817,03/02/2023,-144.92,863.4000000000001
58009817,04/02/2023,150.76,1014.1600000000001
58009817,05/02/2023,-56.62,957.5400000000001
58009817,06/02/2023,-64.67,892.87
58009817,08/02/2023,111.05,1003.9200000000001
58009817,08/02/2023,-22.97,980.95
58009817,12/02/2023,-1354.4,-373.45000000000005
58099419,31/01/2023,,185.74
58099419,01/02/2023,-152.29,33.45000000000002
58099419,05/02/2023,144.17,177.62
58099419,14/02/2023,-80.0,97.62
58126511,31/01/2023,,940.27
58126511,03/02/2023,76.11,1016.38
58126511,03/02/2023,-85.3,931.0799999999999
58126511,04/02/2023,1639.2,2570.2799999999997
58126511,05/02/2023,-148.33,2421.95
58126511,07/02/2023,-98.77,2323.18
58126511,08/02/2023,88.99,2412.17
58126511,09/02/2023,-45.7,2366.47
58126511,11/02/2023,-121.16,2245.31
58126511,13/02/2023,108.27,2353.58
58126511,14/02/2023,90.11,2443.69
58126511,14/02/2023,36.2,2479.89
58176810,31/01/2023,,219.07
58176810,02/02/2023,-25.85,193.22
58176810,03/02/2023,-105.11,88.10999999999999
58176810,05/02/2023,113.3,201.40999999999997
58176810,09/02/2023,-104.33,97.07999999999998
58176810,14/02/2023,133.71,230.79
58182495,31/01/2023,,223.57
58182495,05/02/2023,-949.6,-726.03
58182495,12/02/2023,-158.82,-884.8500000000001
58216756,31/01/2023,,642.13
58216756,02/02/2023,115.09,757.22
58216756,02/02/2023,51.0,808.22
58216756,03/02/2023,625.5,1433.72
58216756,06/02/2023,120.17,1553.89
58216756,09/02/2023,-79.05,1474.8400000000001
58216756,11/02/2023,-91.03,1383.81
58216756,12/02/2023,-1690.9,-307.09000000000015
58216756,13/02/2023,-167.82,-474.91000000000014
58249518,31/01/2023,,14.63
58249518,07/02/2023,56.84,71.47
58249518,12/02/2023,-84.03,-12.560000000000002
58254002,31/01/2023,,94.53
58254002,01/02/2023,-91.66,2.8700000000000045
58254002,11/02/2023,184.66,187.53
58254002,11/02/2023,161.25,348.78
58254002,11/02/2023,45.84,394.62
58254002,11/02/2023,-165.77,228.85
58254002,13/02/2023,-1258.1,-1029.25
58254002,14/02/2023,-37.59,-1066.84
58254002,14/02/2023,-141.17,-1208.01
58258401,31/01/2023,,873.05
58258401,03/02/2023,154.95,1028.0
58258401,06/02/2023,-119.58,908.42
58258401,06/02/2023,-178.88,729.54
58258401,07/02/2023,-124.51,605.03
58258401,12/02/2023,-105.2,499.8299999999999
58265755,31/01/2023,,494.05
58265755,01/02/2023,156.89,650.94
58265755,02/02/2023,-124.21,526.73
58265755,03/02/2023,178.54,705.27
58265755,03/02/2023,-127.44,577.8299999999999
58265755,07/02/2023,-114.81,463.02
58265755,08/02/2023,-173.81,289.21
58265755,14/02/2023,116.74,405.95
58290957,31/01/2023,,580.25
58290957,06/02/2023,-157.11,423.14
58290957,10/02/2023,-134.24,288.9
58304487,31/01/2023,,5.31
58304487,03/02/2023,59.2,64.51
58304487,03/02/2023,-115.75,-51.239999999999995
58304487,04/02/2023,95.13,43.89
58304487,09/02/2023,-146.33,-102.44000000000001
58304487,13/02/2023,-86.65,-189.09000000000003
58305943,31/01/2023,,970.56
58305943,01/02/2023,58.02,1028.58
58305943,02/02/2023,-164.6,863.98
58305943,04/02/2023,118.08,982.06
58305943,04/02/2023,99.93,1081.99
58305943,07/02/2023,-122.53,959.4599999999999
58305943,07/02/2023,-124.42,835.04
58305943,08/02/2023,-122.18,712.8599999999999
58305943,09/02/2023,-138.85,574.01
58305943,10/02/2023,-114.0,460.01
58306431,31/01/2023,,576.56
58306431,01/02/2023,-102.89,473.66999999999996
58306431,02/02/2023,103.47,577.14
58306431,03/02/2023,-123.38,453.75999999999993
58306431,04/02/2023,35.39,489.15
58306431,06/02/2023,742.3,1231.4499999999998
58306431,12/02/2023,-78.91,1152.54
58306431,12/02/2023,-202.22,950.3199999999999
58306431,13/02/2023,67.88,1018.1999999999999
58306431,14/02/2023,-1485.6,-467.4
58332273,31/01/2023,,299.3
58332273,06/02/2023,-179.82,119.48000000000002
58332273,09/02/2023,73.05,192.53000000000003
58332273,12/02/2023,19.96,212.49
58345258,31/01/2023,,749.07
58345258,02/02/2023,144.51,893.58
58345258,06/02/2023,561.3,1454.88
58345258,08/02/2023,-947.8,507.08000000000004
58345258,11/02/2023,69.7,576.7800000000001
58345258,13/02/2023,817.7,1394.48
58362636,31/01/2023,,89.45
58362636,06/02/2023,-39.83,49.620000000000005
58362636,07/02/2023,129.66,179.28
58362636,08/02/2023,120.31,299.59000000000003
58362636,12/02/2023,95.84,395.43
58384131,31/01/2023,,327.68
58384131,01/02/2023,158.57,486.25
58384131,05/02/2023,-72.1,414.15
58384131,09/02/2023,-70.47,343.68
58384131,09/02/2023,-147.12,196.56
58385320,31/01/2023,,693.52
58385320,05/02/2023,-89.23,604.29
58385320,05/02/2023,-121.41,482.88
58385320,05/02/2023,-197.01,285.87
58385320,06/02/2023,583.7,869.57
58385320,10/02/2023,-79.87,789.7
58400012,31/01/2023,,606.79
58400012,01/02/2023,71.73,678.52
58400012,11/02/2023,59.1,737.62
58434725,31/01/2023,,365.9
58434725,03/02/2023,-47.74,318.15999999999997
58434725,03/02/2023,-87.65,230.50999999999996
58434725,09/02/2023,-69.99,160.51999999999998
58434725,11/02/2023,62.47,222.98999999999995
58434725,14/02/2023,91.73,314.71999999999997
58458443,31/01/2023,,903.64
58458443,03/02/2023,-87.05,816.59
58458443,07/02/2023,-180.63,635.96
58489789,31/01/2023,,460.5
58489789,02/02/2023,39.87,500.37
58489789,02/02/2023,-120.72,379.65
58489789,04/02/2023,-54.57,325.08
58489789,06/02/2023,-97.09,227.99
58489789,07/02/2023,-109.32,118.67000000000002
58489789,10/02/2023,98.63,217.3
58489789,14/02/2023,-108.48,108.82000000000001
58491429,31/01/2023,,937.47
58491429,05/02/2023,-77.95,859.52
58491429,06/02/2023,-1486.9,-627.3800000000001
58491429,07/02/2023,-103.74,-731.1200000000001
58491429,10/02/2023,-93.02,-824.1400000000001
58533748,31/01/2023,,490.86
58533748,04/02/2023,-113.49,377.37
58533748,08/02/2023,-80.13,297.24
58533748,14/02/2023,90.86,388.1
58533748,14/02/2023,-139.82,248.28000000000003
58533748,14/02/2023,-321.9,-73.61999999999995
58547184,31/01/2023,,218.22
58547184,02/02/2023,1586.6,1804.82
58547184,02/02/2023,61.66,1866.48
58547184,04/02/2023,-14.63,1851.85
58547184,05/02/2023,83.83,1935.6799999999998
58547184,06/02/2023,107.61,2043.29
58547184,11/02/2023,-69.84,1973.4499999999998
58547184,11/02/2023,-142.41,1831.04
58558145,31/01/2023,,495.35
58558145,10/02/2023,-114.24,381.11
58558145,11/02/2023,-91.38,289.73
58558145,13/02/2023,91.8,381.53000000000003
58586275,31/01/2023,,916.97
58586275,07/02/2023,979.3,1896.27
58586275,07/02/2023,-41.64,1854.6299999999999
58586275,10/02/2023,-102.06,1752.57
58586275,12/02/2023,-121.68,1630.8899999999999
58668564,31/01/2023,,813.28
58668564,01/02/2023,-105.85,707.43
58668564,08/02/2023,-90.09,617.3399999999999
58668564,11/02/2023,1125.0,1742.34
58668564,12/02/2023,-108.96,1633.3799999999999
58668564,14/02/2023,57.83,1691.21
58683711,31/01/2023,,12.76
58683711,01/02/2023,-115.4,-102.64
58683711,05/02/2023,41.55,-61.09
58683711,10/02/2023,126.49,65.39999999999999
58683711,10/02/2023,88.53,153.93
58683711,14/02/2023,0.36,154.29
58703801,31/01/2023,,520.81
58703801,09/02/2023,-100.78,420.03
58703801,10/02/2023,165.41,585.4399999999999
58703801,12/02/2023,-166.9,418.53999999999996
58703801,13/02/2023,53.93,472.4699999999999
58720727,31/01/2023,,471.56
58720727,03/02/2023,-142.86,328.7
58720727,04/02/2023,108.24,436.94
58720727,05/02/2023,-62.37,374.57
58720727,08/02/2023,-92.11,282.46
58720727,11/02/2023,-49.96,232.49999999999997
58720727,11/02/2023,-142.67,89.82999999999998
58720727,12/02/2023,-113.6,-23.77000000000001
58720727,13/02/2023,-80.64,-104.41000000000001
58720727,14/02/2023,-1650.9,-1755.3100000000002
58728550,31/01/2023,,250.26
58728550,04/02/2023,-37.8,212.45999999999998
58728550,11/02/2023,114.61,327.07
58785108,31/01/2023,,473.41
58785108,01/02/2023,61.87,535.28
58785108,04/02/2023,104.53,639.8100000000001
58785108,04/02/2023,-64.43,575.38
58785108,07/02/2023,-883.6,-308.22
58785108,11/02/2023,-32.04,-340.26000000000005
58785108,13/02/2023,186.3,-153.96
58810775,31/01/2023,,747.44
58810775,01/02/2023,-62.0,685.44
58810775,05/02/2023,114.97,800.4100000000001
58810775,05/02/2023,-20.17,780.24
58810775,07/02/2023,151.21,931.45
58810775,13/02/2023,-97.59,833.86
58811985,31/01/2023,,616.7
58811985,08/02/2023,1024.6,1641.3
58811985,09/02/2023,155.76,1797.06
58811985,12/02/2023,-126.97,1670.09
58811985,14/02/2023,85.37,1755.46
58822254,31/01/2023,,79.7
58822254,02/02/2023,-1559.2,-1479.5
58822254,03/02/2023,-436.5,-1916.0
58822254,04/02/2023,129.56,-1786.44
58822254,08/02/2023,42.43,-1744.01
58822254,10/02/2023,129.11,-1614.9
58830897,31/01/2023,,834.24
58830897,02/02/2023,-22.54,811.7
58830897,04/02/2023,-55.94,755.76
58830897,05/02/2023,-110.92,644.84
58830897,06/02/2023,-117.02,527.82
58830897,11/02/2023,152.47,680.29
58830897,12/02/2023,-214.19,466.1
58830897,14/02/2023,137.92,604.02
58837121,31/01/2023,,160.48
58837121,04/02/2023,97.06,257.53999999999996
58837121,05/02/2023,-163.32,94.22
58837121,07/02/2023,75.03,169.25
58837121,08/02/2023,-80.72,88.53
58837121,11/02/2023,111.96,200.49
58837121,11/02/2023,-50.91,149.57999999999998
58837121,14/02/2023,103.18,252.76
58873428,31/01/2023,,191.58
58873428,07/02/2023,39.09,230.67000000000002
58874842,31/01/2023,,347.73
58874842,01/02/2023,-53.09,294.64
58874842,07/02/2023,-183.11,111.53
58874842,08/02/2023,106.37,217.9
58874842,09/02/2023,154.04,371.94
58874842,10/02/2023,57.64,429.58
58874842,14/02/2023,86.86,516.44
58897654,31/01/2023,,210.05
58897654,04/02/2023,113.97,324.02
58897654,05/02/2023,193.2,517.22
58925998,31/01/2023,,855.45
58925998,05/02/2023,166.03,1021.48
58925998,09/02/2023,56.12,1077.6000000000001
58925998,10/02/2023,155.67,1233.27
58925998,11/02/2023,100.88,1334.15
58925998,12/02/2023,1261.6,2595.75
58930654,31/01/2023,,661.48
58930654,03/02/2023,136.43,797.9100000000001
58930654,04/02/2023,-158.41,639.5
58930654,09/02/2023,-45.0,594.5
58930654,13/02/2023,-93.39,501.11
58930654,13/02/2023,-109.04,392.07000000000005
58937028,31/01/2023,,626.96
58937028,12/02/2023,86.73,713.69
58995891,31/01/2023,,12.92
58995891,03/02/2023,-118.76,-105.84
58995891,08/02/2023,-50.31,-156.15
58995891,09/02/2023,125.24,-30.91000000000001
58995891,10/02/2023,-106.62,-137.53000000000003
59110895,31/01/2023,,605.5
59110895,09/02/2023,-1260.0,-654.5
59128512,31/01/2023,,305.71
59128512,01/02/2023,158.92,464.63
59128512,03/02/2023,94.28,558.91
59128512,07/02/2023,1380.5,1939.4099999999999
59128512,08/02/2023,122.81,2062.22
59128512,09/02/2023,109.28,2171.5
59128512,10/02/2023,70.74,2242.24
59128512,13/02/2023,67.31,2309.5499999999997
59128512,13/02/2023,-128.0,2181.5499999999997
59135815,31/01/2023,,240.6
59135815,01/02/2023,-800.0,-559.4
59135815,04/02/2023,436.5,-122.89999999999998
59135815,06/02/2023,-108.14,-231.03999999999996
59135815,10/02/2023,-1202.5,-1433.54
59152169,31/01/2023,,148.6
59152169,01/02/2023,70.5,219.1
59152169,05/02/2023,124.52,343.62
59152169,05/02/2023,-57.18,286.44
59152169,08/02/2023,92.83,379.27
59152169,09/02/2023,-1160.0,-780.73
59152169,12/02/2023,89.7,-691.03
59167707,31/01/2023,,904.43
59167707,01/02/2023,-109.32,795.1099999999999
59167707,06/02/2023,49.47,844.5799999999999
59167707,06/02/2023,-60.85,783.7299999999999
59167707,10/02/2023,-95.08,688.65
59198134,31/01/2023,,122.62
59198134,06/02/2023,168.59,291.21000000000004
59198134,09/02/2023,-104.28,186.93
59198134,13/02/2023,-135.45,51.48000000000002
59198134,13/02/2023,-1291.4,-1239.92
59201002,31/01/2023,,780.85
59201002,01/02/2023,199.99,980.84
59201002,01/02/2023,96.35,1077.19
59201002,04/02/2023,-44.05,1033.14
59201002,08/02/2023,-163.95,869.19
59201002,12/02/2023,-742.0,127.19000000000005
59235925,31/01/2023,,647.8
59235925,01/02/2023,-66.43,581.3699999999999
59235925,04/02/2023,111.18,692.55
59235925,06/02/2023,84.1,776.65
59235925,08/02/2023,42.92,819.5699999999999
59235925,08/02/2023,-64.27,755.3
59235925,09/02/2023,-101.53,653.77
59235925,11/02/2023,152.0,805.77
59238438,31/01/2023,,105.1
59238438,01/02/2023,12.97,118.07
59238438,07/02/2023,-49.76,68.31
59238438,09/02/2023,85.32,153.63
59238438,12/02/2023,-1799.2,-1645.5700000000002
59252971,31/01/2023,,803.65
59252971,05/02/2023,85.62,889.27
59252971,07/02/2023,-1741.9,-852.6300000000001
59252971,13/02/2023,131.61,-721.0200000000001
59252971,14/02/2023,-169.73,-890.7500000000001
59265775,31/01/2023,,695.02
59265775,01/02/2023,55.85,750.87
59265775,04/02/2023,81.94,832.81
59265775,05/02/2023,74.37,907.18
59265775,11/02/2023,68.33,975.51
59265775,12/02/2023,-130.06,845.45
59265775,12/02/2023,-153.05,692.4
59265775,14/02/2023,142.86,835.26
59379884,31/01/2023,,139.54
59379884,05/02/2023,81.18,220.72
59379884,10/02/2023,-156.94,63.78
59379884,11/02/2023,-65.4,-1.6200000000000045
59379884,12/02/2023,564.4,562.78
59379884,13/02/2023,-84.91,477.87
59405362,31/01/2023,,503.89
59405362,01/02/2023,136.51,640.4
59405362,01/02/2023,76.9,717.3
59405362,05/02/2023,-144.79,572.51
59405362,08/02/2023,-195.9,376.61
59405362,09/02/2023,645.9,1022.51
59405362,10/02/2023,-66.94,955.5699999999999
59405362,11/02/2023,43.44,999.01
59432049,31/01/2023,,387.57
59432049,01/02/2023,142.99,530.56
59432049,04/02/2023,578.7,1109.26
59432049,05/02/2023,1121.5,2230.76
59432049,06/02/2023,129.93,2360.69
59432049,06/02/2023,117.11,2477.8
59432049,06/02/2023,-106.77,2371.03
59432049,08/02/2023,66.67,2437.7
59432049,08/02/2023,-125.79,2311.91
59432049,11/02/2023,-175.69,2136.22
59432049,14/02/2023,-34.07,2102.15
59450573,31/01/2023,,888.65
59450573,05/02/2023,80.26,968.91
59450573,09/02/2023,-47.96,920.9499999999999
59450573,10/02/2023,-86.27,834.68
59455653,31/01/2023,,4.64
59455653,04/02/2023,7.74,12.379999999999999
59455653,06/02/2023,-129.93,-117.55000000000001
59455653,11/02/2023,148.32,30.769999999999982
59455653,12/02/2023,-1261.7,-1230.93
59510370,31/01/2023,,523.1
59510370,03/02/2023,32.77,555.87
59510370,04/02/2023,-97.19,458.68000000000006
59510370,06/02/2023,12.77,471.45000000000005
59510370,10/02/2023,-62.26,409.19000000000005
59510370,14/02/2023,-53.96,355.23
59529922,31/01/2023,,516.09
59529922,01/02/2023,-129.91,386.18000000000006
59529922,03/02/2023,-104.89,281.29
59529922,04/02/2023,105.37,386.66
59529922,06/02/2023,104.58,491.24
59529922,07/02/2023,-1.77,489.47
59529922,09/02/2023,36.06,525.5300000000001
59529922,10/02/2023,-121.92,403.61
59529922,10/02/2023,-156.22,247.39000000000004
59529922,13/02/2023,-102.31,145.08000000000004
59529922,14/02/2023,89.67,234.75000000000006
59575867,31/01/2023,,576.66
59575867,03/02/2023,5.14,581.8
59575867,10/02/2023,-159.2,422.59999999999997
59575867,13/02/2023,103.44,526.04
59591324,31/01/2023,,509.65
59591324,05/02/2023,806.2,1315.85
59591324,05/02/2023,-181.42,1134.43
59591324,12/02/2023,53.98,1188.41
59591324,13/02/2023,156.89,1345.3
59591324,13/02/2023,135.45,1480.75
59640238,31/01/2023,,993.42
59640238,05/02/2023,129.51,1122.9299999999998
59640238,08/02/2023,-185.22,937.7099999999999
59640238,09/02/2023,-127.23,810.4799999999999
59640238,11/02/2023,137.43,947.91
59653557,31/01/2023,,649.61
59653557,04/02/2023,-106.46,543.15
59653557,06/02/2023,-37.9,505.25
59653557,06/02/2023,-1524.9,-1019.6500000000001
59653557,08/02/2023,-117.35,-1137.0
59663741,31/01/2023,,642.86
59663741,03/02/2023,68.43,711.29
59663741,05/02/2023,118.22,829.51
59663741,05/02/2023,113.1,942.61
59663741,06/02/2023,97.36,1039.97
59663741,07/02/2023,-199.41,840.56
59663741,09/02/2023,127.72,968.28
59663741,10/02/2023,-51.27,917.01
59663741,10/02/2023,-1484.2,-567.19
59663741,11/02/2023,-85.89,-653.08
59663741,14/02/2023,30.0,-623.08
59684752,31/01/2023,,14.43
59684752,01/02/2023,-119.45,-105.02000000000001
59684752,05/02/2023,-108.03,-213.05
59684752,05/02/2023,-159.46,-372.51
59684752,06/02/2023,-27.93,-400.44
59684752,06/02/2023,-154.3,-554.74
59684752,08/02/2023,108.02,-446.72
59684752,08/02/2023,-92.84,-539.5600000000001
59684752,09/02/2023,-108.23,-647.79
59684752,12/02/2023,-130.68,-778.47
59684752,13/02/2023,2359.1,1580.6299999999999
59705091,31/01/2023,,631.05
59705091,02/02/2023,1091.2,1722.25
59705091,04/02/2023,-46.93,1675.32
59705091,04/02/2023,-102.22,1573.1
59705091,07/02/2023,111.37,1684.47
59705091,08/02/2023,62.19,1746.66
59705091,08/02/2023,53.32,1799.98
59705091,11/02/2023,-1677.5,122.48000000000002
59705091,13/02/2023,-73.31,49.170000000000016
59737910,31/01/2023,,523.19
59737910,03/02/2023,99.14,622.33
59737910,09/02/2023,132.58,754.9100000000001
59737910,11/02/2023,80.51,835.4200000000001
59737910,11/02/2023,-139.86,695.5600000000001
59855808,31/01/2023,,172.54
59855808,02/02/2023,-157.41,15.129999999999995
59855808,05/02/2023,100.23,115.36
59855808,06/02/2023,-204.86,-89.50000000000001
59855808,09/02/2023,53.95,-35.55000000000001
59855808,10/02/2023,-905.0,-940.55
59855808,12/02/2023,-58.39,-998.9399999999999
59855808,13/02/2023,1397.6,398.65999999999997
59855808,14/02/2023,-179.57,219.08999999999997
59867000,31/01/2023,,62.01
59867000,02/02/2023,116.89,178.9
59867000,06/02/2023,110.54,289.44
59867000,08/02/2023,-36.78,252.66
59867000,08/02/2023,-124.32,128.34
59867000,12/02/2023,-845.0,-716.66
59876714,31/01/2023,,938.46
59876714,01/02/2023,469.6,1408.06
59876714,02/02/2023,132.84,1540.9
59876714,07/02/2023,134.11,1675.01
59876714,07/02/2023,-101.89,1573.1200000000001
59876714,11/02/2023,117.41,1690.53
59876714,12/02/2023,-166.15,1524.38
59876714,13/02/2023,-1535.7,-11.319999999999936
59933973,31/01/2023,,29.98
59933973,02/02/2023,-144.06,-114.08
59933973,07/02/2023,-148.28,-262.36
59933973,12/02/2023,65.93,-196.42999999999998
59961433,31/01/2023,,267.05
59961433,01/02/2023,47.33,314.38
59961433,01/02/2023,-177.63,136.75
59961433,05/02/2023,907.1,1043.85
59961433,09/02/2023,-77.09,966.76
59961433,14/02/2023,147.72,1114.48
59980709,31/01/2023,,781.42
59980709,01/02/2023,99.56,880.98
59980709,03/02/2023,-8.49,872.49
59980709,06/02/2023,1194.9,2067.3900000000003
59984692,31/01/2023,,818.03
59984692,03/02/2023,-913.8,-95.76999999999998
59984692,05/02/2023,33.96,-61.80999999999998
59984692,05/02/2023,-111.66,-173.46999999999997
59984692,05/02/2023,-175.68,-349.15
59984692,10/02/2023,119.92,-229.22999999999996
59984692,14/02/2023,7.29,-221.93999999999997
59989722,31/01/2023,,816.77
59989722,07/02/2023,-853.6,-36.83000000000004
59989722,09/02/2023,-78.22,-115.05000000000004
59989722,10/02/2023,672.0,556.9499999999999
60017511,31/01/2023,,859.48
60017511,03/02/2023,41.91,901.39
60017511,03/02/2023,-60.17,841.22
60017511,04/02/2023,1131.3,1972.52
60017511,04/02/2023,-131.11,1841.4099999999999
60017511,05/02/2023,678.7,2520.11
60017511,11/02/2023,1363.6,3883.71
60017511,11/02/2023,56.16,3939.87
60017511,13/02/2023,69.25,4009.12
60114464,31/01/2023,,972.56
60114464,03/02/2023,-43.75,928.81
60114464,09/02/2023,-178.61,750.1999999999999
60114464,10/02/2023,1640.4,2390.6
60114464,10/02/2023,1275.4,3666.0
60114464,10/02/2023,1188.3,4854.3
60114464,11/02/2023,-1777.8,3076.5
60114464,13/02/2023,-153.62,2922.88
60138058,31/01/2023,,686.46
60138058,03/02/2023,113.46,799.9200000000001
60138058,04/02/2023,59.13,859.0500000000001
60138058,07/02/2023,149.99,1009.0400000000001
60138058,08/02/2023,14.01,1023.0500000000001
60138058,09/02/2023,45.0,1068.05
60138058,09/02/2023,-110.11,957.94
60138058,10/02/2023,-97.78,860.1600000000001
60138058,10/02/2023,-1526.7,-666.54
60184250,31/01/2023,,70.89
60184250,03/02/2023,-146.39,-75.49999999999999
60184250,04/02/2023,106.07,30.570000000000007
60184250,05/02/2023,1526.1,1556.6699999999998
60184250,06/02/2023,80.07,1636.7399999999998
60184250,09/02/2023,-73.11,1563.6299999999999
60184250,11/02/2023,-43.44,1520.1899999999998
60184250,14/02/2023,-114.54,1405.6499999999999
60189055,31/01/2023,,814.54
60189055,02/02/2023,71.52,886.06
60189055,04/02/2023,-629.0,257.05999999999995
60189055,05/02/2023,-62.74,194.31999999999994
60189055,08/02/2023,136.06,330.37999999999994
60189055,10/02/2023,160.72,491.0999999999999
60189055,12/02/2023,129.45,620.55
60193174,31/01/2023,,740.53
60193174,02/02/2023,1327.5,2068.0299999999997
60193174,04/02/2023,-108.21,1959.82
60193174,04/02/2023,-204.89,1754.93
60193174,05/02/2023,-27.15,1727.78
60193174,10/02/2023,101.72,1829.5
60193174,10/02/2023,68.91,1898.41
60193174,12/02/2023,-127.05,1771.36
60193174,13/02/2023,51.71,1823.07
60202402,31/01/2023,,783.7
60202402,03/02/2023,-18.28,765.4200000000001
60202402,05/02/2023,-963.3,-197.87999999999988
60202402,12/02/2023,82.91,-114.96999999999989
60202402,12/02/2023,-89.48,-204.44999999999987
60202402,12/02/2023,-89.55,-293.9999999999999
60202402,13/02/2023,789.4,495.4000000000001
60220702,31/01/2023,,937.23
60220702,03/02/2023,-37.49,899.74
60220702,05/02/2023,-102.96,796.78
60220702,07/02/2023,98.61,895.39
60220702,10/02/2023,-76.48,818.9100000000001
60220702,12/02/2023,-128.94,689.97
60222199,31/01/2023,,350.4
60222199,08/02/2023,537.9,888.3
60222199,11/02/2023,83.49,971.79
60222199,12/02/2023,-893.8,77.99000000000001
60238192,31/01/2023,,307.97
60238192,02/02/2023,120.45,428.42
60238192,03/02/2023,-95.05,333.37
60238192,05/02/2023,-62.49,270.88000000000005
60238192,12/02/2023,202.22,473.1
60238192,13/02/2023,-8.94,464.16
60238192,14/02/2023,69.61,533.77
60238192,14/02/2023,58.12,591.89
60367416,31/01/2023,,754.86
60367416,03/02/2023,-164.14,590.72
60367416,04/02/2023,-96.78,493.94000000000005
60367416,05/02/2023,154.98,648.9200000000001
60367416,07/02/2023,-104.75,544.1700000000001
60367416,10/02/2023,76.15,620.32
60367416,10/02/2023,4.42,624.74
60367416,11/02/2023,165.41,790.15
60367416,11/02/2023,51.94,842.09
60371134,31/01/2023,,444.57
60371134,04/02/2023,125.07,569.64
60371134,07/02/2023,93.89,663.53
60371134,14/02/2023,-95.91,567.62
60383549,31/01/2023,,268.15
60383549,01/02/2023,38.67,306.82
60383549,06/02/2023,141.54,448.35999999999996
60383549,09/02/2023,73.11,521.4699999999999
60383549,14/02/2023,131.83,653.3
60417212,31/01/2023,,653.31
60417212,01/02/2023,-69.4,583.91
60417212,01/02/2023,-974.4,-390.49
60417212,04/02/2023,-117.96,-508.45
60417212,05/02/2023,471.4,-37.05000000000001
60417212,07/02/2023,-26.93,-63.98000000000001
60417212,09/02/2023,-9.69,-73.67000000000002
60417212,10/02/2023,-98.96,-172.63
60417212,11/02/2023,134.17,-38.460000000000036
60417212,11/02/2023,104.89,66.42999999999996
60417212,12/02/2023,82.59,149.01999999999998
60417212,13/02/2023,-145.9,3.1199999999999477
60417212,14/02/2023,-151.47,-148.35000000000005
60459342,31/01/2023,,734.15
60459342,02/02/2023,-108.85,625.3
60459342,03/02/2023,-36.57,588.73
60459342,07/02/2023,103.43,692.16
60459342,07/02/2023,77.09,769.25
60459342,10/02/2023,-145.86,623.39
60459342,11/02/2023,-134.17,489.22
60459342,12/02/2023,-134.05,355.16999999999996
60459342,13/02/2023,-30.31,324.86
60522190,31/01/2023,,965.46
60522190,02/02/2023,51.61,1017.07
60522190,08/02/2023,1589.0,2606.07
60522190,10/02/2023,-61.2,2544.8700000000003
60659147,31/01/2023,,323.85
60659147,01/02/2023,-140.1,183.75000000000003
60659147,03/02/2023,-136.92,46.83000000000004
60659147,06/02/2023,98.87,145.70000000000005
60659147,10/02/2023,103.49,249.19000000000005
60659147,11/02/2023,-99.35,149.84000000000003
60659147,13/02/2023,14.32,164.16000000000005
60659147,13/02/2023,-72.13,92.03000000000006
60667043,31/01/2023,,937.62
60667043,03/02/2023,-19.83,917.79
60667043,04/02/2023,-165.76,752.03
60667043,04/02/2023,-861.1,-109.06999999999994
60667043,06/02/2023,-308.7,-417.7699999999999
60667043,09/02/2023,96.08,-321.68999999999994
60667043,09/02/2023,88.81,-232.87999999999994
60667043,09/02/2023,-148.39,-381.2699999999999
60667043,11/02/2023,-1199.0,-1580.27
60667043,14/02/2023,122.9,-1457.37
60684197,31/01/2023,,752.92
60684197,03/02/2023,-179.13,573.79
60684197,04/02/2023,140.43,714.22
60684197,06/02/2023,76.95,791.17
60684197,11/02/2023,60.22,851.39
60684197,12/02/2023,-41.59,809.8
60707792,31/01/2023,,220.35
60707792,01/02/2023,122.51,342.86
60707792,01/02/2023,-126.01,216.85
60707792,05/02/2023,99.42,316.27
60707792,06/02/2023,-154.81,161.45999999999998
60707792,14/02/2023,-56.24,105.21999999999997
60707792,14/02/2023,-159.73,-54.51000000000002
60711202,31/01/2023,,869.92
60711202,03/02/2023,-165.39,704.53
60711202,07/02/2023,-260.82,443.71
60711202,08/02/2023,-191.64,252.07
60711202,14/02/2023,93.66,345.73
60730902,31/01/2023,,243.72
60730902,01/02/2023,-17.61,226.11
60730902,02/02/2023,-85.17,140.94
60730902,03/02/2023,-13.52,127.42
60730902,03/02/2023,-56.31,71.11
60730902,03/02/2023,-67.03,4.079999999999998
60730902,06/02/2023,-44.47,-40.39
60730902,10/02/2023,192.26,151.87
60730902,10/02/2023,-88.33,63.540000000000006
60730902,12/02/2023,-95.07,-31.529999999999987
60751083,31/01/2023,,115.23
60751083,04/02/2023,-129.92,-14.689999999999984
60751083,05/02/2023,129.71,115.02000000000002
60751083,05/02/2023,-23.88,91.14000000000003
60751083,07/02/2023,85.77,176.91000000000003
60751083,08/02/2023,782.7,959.6100000000001
60751083,09/02/2023,96.28,1055.89
60751083,10/02/2023,123.72,1179.6100000000001
60755797,31/01/2023,,207.78
60755797,03/02/2023,-164.56,43.22
60755797,07/02/2023,93.07,136.29
60755797,08/02/2023,-33.32,102.97
60755797,12/02/2023,-16.56,86.41
60755797,13/02/2023,1856.7,1943.1100000000001
60755797,14/02/2023,-64.87,1878.2400000000002
60789634,31/01/2023,,379.4
60789634,03/02/2023,174.25,553.65
60789634,05/02/2023,116.03,669.68
60789634,05/02/2023,65.25,734.93
60789634,09/02/2023,161.02,895.95
60789634,12/02/2023,146.05,1042.0
60789634,12/02/2023,-49.38,992.62
60789634,12/02/2023,-140.82,851.8
60789634,13/02/2023,-78.14,773.66
60819695,31/01/2023,,38.96
60819695,03/02/2023,92.73,131.69
60819695,04/02/2023,-121.97,9.720000000000013
60819695,04/02/2023,-207.89,-198.16999999999996
60819695,09/02/2023,-96.94,-295.10999999999996
60819695,11/02/2023,88.2,-206.90999999999997
60819695,14/02/2023,111.2,-95.70999999999995
60860851,31/01/2023,,17.96
60860851,02/02/2023,-15.19,2.7700000000000014
60860851,04/02/2023,-142.92,-140.14999999999998
60860851,07/02/2023,-1372.5,-1512.65
60860851,10/02/2023,194.97,-1317.68
60860851,10/02/2023,-114.32,-1432.0
60860851,10/02/2023,-152.92,-1584.92
60866500,31/01/2023,,523.13
60866500,03/02/2023,-77.14,445.99
60866500,05/02/2023,-116.03,329.96
60866500,06/02/2023,68.31,398.27
60866500,09/02/2023,-125.74,272.53
60866500,11/02/2023,156.49,429.02
60866500,11/02/2023,-79.43,349.59000000000003
60916657,31/01/2023,,893.41
60916657,03/02/2023,117.51,1010.92
60916657,05/02/2023,-76.57,934.35
60916657,06/02/2023,-56.09,878.26
60916657,11/02/2023,71.24,949.5
60916657,12/02/2023,50.94,1000.4399999999999
60930856,31/01/2023,,445.07
60930856,03/02/2023,-46.85,398.21999999999997
60930856,04/02/2023,-131.69,266.53
60930856,07/02/2023,-52.98,213.55
60930856,12/02/2023,123.5,337.05
60930856,12/02/2023,68.26,405.31
60930856,14/02/2023,64.87,470.18
60955647,31/01/2023,,546.28
60955647,11/02/2023,34.52,580.8
60955647,14/02/2023,126.46,707.26
60966485,31/01/2023,,774.41
60966485,01/02/2023,63.28,837.6899999999999
60966485,01/02/2023,-116.0,721.6899999999999
60966485,04/02/2023,187.19,908.88
60966485,05/02/2023,-151.29,757.5899999999999
60966485,06/02/2023,-193.24,564.3499999999999
60966485,07/02/2023,-56.84,507.51
60966485,10/02/2023,-155.39,352.12
60966485,12/02/2023,57.89,410.01
60966485,14/02/2023,149.95,559.96
60996794,31/01/2023,,27.98
60996794,04/02/2023,63.46,91.44
60996794,08/02/2023,-903.3,-811.8599999999999
60996794,11/02/2023,-66.62,-878.4799999999999
60996794,13/02/2023,-1525.2,-2403.68
61087394,31/01/2023,,112.81
61087394,01/02/2023,121.69,234.5
61087394,07/02/2023,156.4,390.9
61087394,07/02/2023,-38.29,352.61
61087394,08/02/2023,-1621.0,-1268.3899999999999
61087394,12/02/2023,-52.46,-1320.85
61087394,13/02/2023,-101.58,-1422.4299999999998
61087394,13/02/2023,-105.17,-1527.6
61087394,14/02/2023,-1879.5,-3407.1
61101757,31/01/2023,,992.2
61152319,31/01/2023,,471.31
61152319,01/02/2023,-75.45,395.86
61152319,04/02/2023,-82.25,313.61
61152319,07/02/2023,61.01,374.62
61152319,08/02/2023,57.93,432.55
61152319,13/02/2023,-79.81,352.74
61178950,31/01/2023,,104.88
61178950,04/02/2023,79.62,184.5
61178950,09/02/2023,-95.74,88.76
61178950,10/02/2023,150.39,239.14999999999998
61178950,13/02/2023,-1023.0,-783.85
61178950,14/02/2023,-685.5,-1469.35
61181609,31/01/2023,,44.55
61181609,01/02/2023,-146.28,-101.73
61181609,03/02/2023,-321.6,-423.33000000000004
61181609,04/02/2023,-114.54,-537.87
61181609,09/02/2023,-80.63,-618.5
61181609,11/02/2023,-106.62,-725.12
61181609,12/02/2023,-108.99,-834.11
61181609,14/02/2023,-89.9,-924.01
61279456,31/01/2023,,814.3
61279456,02/02/2023,-93.31,720.99
61279456,04/02/2023,133.05,854.04
61279456,04/02/2023,-72.97,781.0699999999999
61279456,06/02/2023,-22.45,758.62
61279456,09/02/2023,-180.82,577.8
61279456,11/02/2023,-94.12,483.67999999999995
61279456,12/02/2023,134.18,617.86
61279456,12/02/2023,-56.08,561.78
61279456,12/02/2023,-81.44,480.34
61279456,13/02/2023,-116.67,363.66999999999996
61279456,13/02/2023,-1406.7,-1043.0300000000002
61419726,31/01/2023,,932.41
61419726,02/02/2023,176.64,1109.05
61419726,03/02/2023,131.74,1240.79
61419726,07/02/2023,-105.53,1135.26
61419726,09/02/2023,-85.81,1049.45
61419726,09/02/2023,-149.64,899.81
61419726,10/02/2023,-213.8,686.01
61423373,31/01/2023,,87.17
61423373,09/02/2023,-411.3,-324.13
61423373,10/02/2023,-655.8,-979.93
61423373,11/02/2023,113.52,-866.41
61450849,31/01/2023,,890.19
61450849,01/02/2023,-646.2,243.99
61450849,02/02/2023,-6.47,237.52
61450849,04/02/2023,-121.04,116.48
61450849,06/02/2023,-133.12,-16.64
61450849,07/02/2023,-54.63,-71.27000000000001
61450849,08/02/2023,94.96,23.689999999999998
61450849,08/02/2023,68.6,92.28999999999999
61450849,08/02/2023,-41.56,50.72999999999999
61493381,31/01/2023,,569.94
61493381,01/02/2023,-12.97,556.97
61493381,05/02/2023,-54.53,502.44000000000005
61493381,06/02/2023,-113.47,388.97
61493381,08/02/2023,-203.33,185.64000000000004
61493381,09/02/2023,-77.58,108.06000000000004
61493381,12/02/2023,-182.63,-74.56999999999995
61493381,14/02/2023,-81.5,-156.06999999999994
61512912,31/01/2023,,328.0
61512912,08/02/2023,-138.88,189.12
61512912,11/02/2023,-38.45,150.67000000000002
61512912,11/02/2023,-165.41,-14.740000000000009
61555609,31/01/2023,,505.76
61555609,02/02/2023,-150.57,355.19
61555609,03/02/2023,-90.12,265.07
61555609,09/02/2023,77.33,342.4
61555609,13/02/2023,1503.2,1845.6
61578713,31/01/2023,,209.89
61578713,05/02/2023,88.55,298.44
61578713,05/02/2023,34.76,333.2
61578713,07/02/2023,-81.64,251.55999999999997
61578713,07/02/2023,-106.48,145.07999999999998
61578713,09/02/2023,-112.05,33.02999999999997
61578713,10/02/2023,-95.62,-62.59000000000003
61582769,31/01/2023,,325.47
61582769,02/02/2023,87.06,412.53000000000003
61582769,08/02/2023,69.56,482.09000000000003
61582769,11/02/2023,-124.32,357.77000000000004
61582769,13/02/2023,-123.64,234.13000000000005
61582769,14/02/2023,167.84,401.97
61593392,31/01/2023,,621.21
61593392,10/02/2023,-92.09,529.12
61593392,11/02/2023,-41.89,487.23
61634340,31/01/2023,,83.85
61634340,01/02/2023,-148.64,-64.78999999999999
61634340,03/02/2023,-60.33,-125.11999999999999
61634340,04/02/2023,-238.96,-364.08
61634340,07/02/2023,-109.13,-473.21000000000004
61634340,12/02/2023,-94.0,-567.21
61634340,13/02/2023,-70.25,-637.46
61642813,31/01/2023,,760.74
61642813,02/02/2023,177.88,938.62
61642813,04/02/2023,-73.67,864.95
61642813,10/02/2023,221.22,1086.17
61642813,13/02/2023,81.39,1167.56
61642813,13/02/2023,-68.67,1098.89
61644310,31/01/2023,,709.97
61644310,04/02/2023,-72.42,637.5500000000001
61644310,05/02/2023,-89.72,547.83
61644310,06/02/2023,-110.71,437.12
61644310,08/02/2023,-106.37,330.75
61644310,13/02/2023,136.4,467.15000000000003
61644310,13/02/2023,87.58,554.73
61649729,31/01/2023,,848.76
61649729,03/02/2023,-26.28,822.48
61649729,07/02/2023,156.28,978.76
61649729,10/02/2023,149.53,1128.29
61661386,31/01/2023,,524.42
61661386,07/02/2023,-125.96,398.46
61661386,11/02/2023,-126.05,272.40999999999997
61676204,31/01/2023,,88.85
61676204,04/02/2023,134.22,223.07
61676204,04/02/2023,90.09,313.15999999999997
61676204,04/02/2023,-75.65,237.51
61676204,06/02/2023,-43.35,194.16
61676204,07/02/2023,-7.57,186.58999999999997
61676204,09/02/2023,49.06,235.64999999999998
61676204,13/02/2023,89.3,324.95
61682186,31/01/2023,,959.96
61682186,02/02/2023,154.85,1114.81
61682186,10/02/2023,-26.43,1088.38
61682186,10/02/2023,-99.28,989.1
61682186,11/02/2023,659.5,1648.6
61682186,12/02/2023,-19.98,1628.6200000000001
61682186,12/02/2023,-61.6,1567.02
61682186,13/02/2023,1132.5,2699.52
61687835,31/01/2023,,739.0
61687835,03/02/2023,147.6,886.6
61687835,03/02/2023,-102.16,784.44
61687835,06/02/2023,-163.9,620.54
61687835,06/02/2023,-561.3,59.24000000000001
61687835,08/02/2023,56.13,115.37
61687835,08/02/2023,9.19,124.56000000000002
61687835,09/02/2023,652.0,776.5600000000001
61687835,10/02/2023,-212.1,564.46
61687835,11/02/2023,165.77,730.23
61687835,11/02/2023,142.29,872.5200000000001
61687835,12/02/2023,62.63,935.1500000000001
61720005,31/01/2023,,687.35
61720005,02/02/2023,-49.63,637.72
61720005,03/02/2023,-75.28,562.44
61720005,05/02/2023,72.33,634.77
61720005,05/02/2023,-0.49,634.28
61720005,08/02/2023,-107.47,526.8100000000001
61720005,09/02/2023,105.86,632.6700000000001
61720005,10/02/2023,-204.71,427.96000000000004
61720005,12/02/2023,-50.65,377.31000000000006
61720005,13/02/2023,-38.26,339.05000000000007
61724951,31/01/2023,,656.25
61724951,03/02/2023,33.4,689.65
61724951,07/02/2023,-99.73,589.92
61724951,08/02/2023,-69.75,520.17
61724951,09/02/2023,139.86,660.03
61724951,09/02/2023,65.77,725.8
61724951,10/02/2023,107.4,833.2
61724951,12/02/2023,207.6,1040.8
61724951,13/02/2023,-1127.3,-86.5
61781801,31/01/2023,,699.78
61781801,03/02/2023,71.27,771.05
61781801,07/02/2023,182.27,953.3199999999999
61781801,07/02/2023,-84.97,868.35
61781801,08/02/2023,1428.0,2296.35
61781801,08/02/2023,1051.4,3347.75
61781801,09/02/2023,49.68,3397.43
61781801,14/02/2023,81.5,3478.93
61847987,31/01/2023,,874.22
61847987,04/02/2023,75.65,949.87
61847987,06/02/2023,-86.9,862.97
61847987,08/02/2023,-2017.7,-1154.73
61847987,11/02/2023,-89.18,-1243.91
61847987,14/02/2023,67.85,-1176.06
61860337,31/01/2023,,892.77
61860337,05/02/2023,-97.37,795.4
61860337,06/02/2023,64.67,860.0699999999999
61860337,07/02/2023,-132.98,727.0899999999999
61860337,09/02/2023,-1679.2,-952.1100000000001
61860337,11/02/2023,107.49,-844.6200000000001
61860337,12/02/2023,-102.73,-947.3500000000001
61884944,31/01/2023,,123.93
61884944,03/02/2023,156.2,280.13
61884944,03/02/2023,96.42,376.55
61884944,04/02/2023,189.33,565.88
61884944,05/02/2023,-997.4,-431.52
61884944,08/02/2023,193.89,-237.63
61884944,10/02/2023,-106.29,-343.92
61884944,12/02/2023,985.9,641.98
61884944,14/02/2023,131.36,773.3399999999999
61941956,31/01/2023,,137.19
61941956,03/02/2023,-48.48,88.71000000000001
61941956,04/02/2023,-64.48,24.22999999999999
61941956,09/02/2023,52.73,76.95999999999998
61941956,09/02/2023,-181.01,-104.05000000000001
61979134,31/01/2023,,574.77
61979134,03/02/2023,-15.12,559.65
61979134,03/02/2023,-106.43,453.21999999999997
61979134,04/02/2023,-101.39,351.83
61979134,09/02/2023,143.27,495.09999999999997
61999896,31/01/2023,,788.63
61999896,05/02/2023,1475.4,2264.03
61999896,05/02/2023,106.71,2370.7400000000002
61999896,06/02/2023,739.3,3110.04
61999896,06/02/2023,-63.49,3046.55
61999896,06/02/2023,-123.77,2922.78
61999896,08/02/2023,51.04,2973.82
61999896,11/02/2023,510.2,3484.0200000000004
61999896,11/02/2023,132.76,3616.78
61999896,13/02/2023,137.58,3754.36
62077439,31/01/2023,,333.47
62077439,01/02/2023,345.3,678.77
62077439,05/02/2023,-166.03,512.74
62077439,06/02/2023,-96.82,415.9200000000001
62077439,07/02/2023,110.79,526.71
62077439,08/02/2023,-123.3,403.4100000000001
62077439,09/02/2023,-121.95,281.46000000000004
62077439,10/02/2023,-958.6,-677.14
62077439,12/02/2023,491.6,-185.53999999999996
62141083,31/01/2023,,17.63
62141083,02/02/2023,104.03,121.66
62141083,05/02/2023,168.21,289.87
62141083,07/02/2023,94.93,384.8
62141083,11/02/2023,-46.65,338.15000000000003
62141083,13/02/2023,-113.41,224.74
62147353,31/01/2023,,783.96
62147353,04/02/2023,-65.13,718.83
62147353,10/02/2023,54.73,773.5600000000001
62147353,12/02/2023,109.65,883.21
62147353,12/02/2023,-31.75,851.46
62147353,14/02/2023,-144.85,706.61
62158499,31/01/2023,,581.72
62158499,02/02/2023,89.46,671.1800000000001
62158499,04/02/2023,89.95,761.13
62158499,05/02/2023,-821.8,-60.66999999999996
62158499,08/02/2023,163.95,103.28000000000003
62158499,11/02/2023,-121.47,-18.18999999999997
62158499,13/02/2023,104.56,86.37000000000003
62158499,13/02/2023,-17.92,68.45000000000003
62158499,13/02/2023,-901.5,-833.05
62191488,31/01/2023,,652.76
62191488,01/02/2023,115.85,768.61
62191488,01/02/2023,-79.2,689.41
62191488,03/02/2023,115.62,805.03
62191488,08/02/2023,14.52,819.55
62191488,09/02/2023,112.76,932.31
62191488,09/02/2023,-4.38,927.93
62213525,31/01/2023,,45.68
62213525,01/02/2023,948.2,993.88
62213525,04/02/2023,-143.01,850.87
62213525,04/02/2023,-1702.7,-851.83
62213525,07/02/2023,336.2,-515.6300000000001
62213525,07/02/2023,-139.96,-655.59
62213525,10/02/2023,90.86,-564.73
62213525,10/02/2023,-114.59,-679.32
62222306,31/01/2023,,304.45
62222306,02/02/2023,-108.46,195.99
62222306,03/02/2023,-60.47,135.51999999999998
62222306,03/02/2023,-89.93,45.58999999999999
62222306,04/02/2023,-1639.2,-1593.6100000000001
62222306,10/02/2023,-9.75,-1603.3600000000001
62227017,31/01/2023,,177.72
62227017,02/02/2023,128.31,306.03
62227017,09/02/2023,-112.93,193.1
62227017,13/02/2023,122.16,315.26
62251465,31/01/2023,,304.55
62251465,01/02/2023,-96.35,208.20000000000002
62251465,02/02/2023,15.44,223.64000000000001
62251465,06/02/2023,187.58,411.22
62251465,07/02/2023,37.9,449.12
62251465,07/02/2023,-195.55,253.57000000000002
62251465,11/02/2023,127.25,380.82000000000005
62256127,31/01/2023,,784.39
62256127,05/02/2023,-151.27,633.12
62256127,07/02/2023,134.55,767.67
62256127,09/02/2023,-137.44,630.23
62256127,11/02/2023,-100.94,529.29
62256127,11/02/2023,-1363.6,-834.31
62256127,12/02/2023,-1491.7,-2326.01
62276269,31/01/2023,,575.1
62276269,02/02/2023,-142.26,432.84000000000003
62276269,04/02/2023,-126.83,306.01000000000005
62276269,08/02/2023,50.71,356.72
62289297,31/01/2023,,802.44
62289297,11/02/2023,-157.6,644.84
62320219,31/01/2023,,178.4
62320219,05/02/2023,141.51,319.90999999999997
62320219,05/02/2023,112.45,432.36
62320219,05/02/2023,-49.95,382.40999999999997
62320219,08/02/2023,47.37,429.78
62332278,31/01/2023,,970.66
62332278,01/02/2023,119.74,1090.3999999999999
62332278,07/02/2023,-32.06,1058.34
62332278,07/02/2023,-83.68,974.66
62332278,10/02/2023,-145.13,829.53
62332278,12/02/2023,166.15,995.68
62332278,12/02/2023,58.63,1054.31
62332278,13/02/2023,181.54,1235.85
62362650,31/01/2023,,650.79
62362650,01/02/2023,129.83,780.62
62362650,01/02/2023,-466.7,313.91999999999996
62362650,05/02/2023,118.78,432.69999999999993
62362650,05/02/2023,62.8,495.49999999999994
62362650,06/02/2023,-133.3,362.19999999999993
62362650,08/02/2023,191.5,553.6999999999999
62362650,08/02/2023,162.63,716.3299999999999
62362650,08/02/2023,138.18,854.51
62362650,08/02/2023,-85.01,769.4999999999999
62362650,11/02/2023,67.06,836.56
62362650,11/02/2023,-114.77,721.79
62362650,13/02/2023,80.64,802.43
62412215,31/01/2023,,766.15
62412215,02/02/2023,-89.46,676.6899999999999
62412215,03/02/2023,-89.33,587.36
62412215,06/02/2023,1011.5,1598.8600000000001
62412215,06/02/2023,96.82,1695.68
62412215,07/02/2023,-97.95,1597.73
62412215,12/02/2023,1278.9,2876.63
62414886,31/01/2023,,489.04
62414886,02/02/2023,-107.51,381.53000000000003
62414886,06/02/2023,-63.36,318.17
62414886,06/02/2023,-72.35,245.82000000000002
62414886,09/02/2023,-50.28,195.54000000000002
62414886,09/02/2023,-89.43,106.11000000000001
62414886,11/02/2023,-74.36,31.750000000000014
62414886,11/02/2023,-159.77,-128.01999999999998
62414886,12/02/2023,-126.93,-254.95000000000002
62414886,13/02/2023,-132.93,-387.88
62414886,13/02/2023,-789.4,-1177.28
62470872,31/01/2023,,436.81
62470872,03/02/2023,-81.28,355.53
62470872,06/02/2023,78.94,434.47
62470872,11/02/2023,60.09,494.56
62470872,13/02/2023,101.09,595.65
62470872,14/02/2023,-140.8,454.85
62477219,31/01/2023,,715.67
62477219,08/02/2023,-99.5,616.17
62511159,31/01/2023,,347.79
62511159,08/02/2023,-123.12,224.67000000000002
62511159,09/02/2023,33.68,258.35
62511159,10/02/2023,5.2,263.55
62567104,31/01/2023,,53.95
62567104,01/02/2023,-124.73,-70.78
62567104,04/02/2023,-152.48,-223.26
62567104,08/02/2023,-190.37,-413.63
62567104,14/02/2023,113.47,-300.15999999999997
62580854,31/01/2023,,421.59
62580854,05/02/2023,114.23,535.8199999999999
62580854,07/02/2023,-199.97,335.84999999999997
62584374,31/01/2023,,334.08
62584374,01/02/2023,130.11,464.19
62584374,05/02/2023,-101.23,362.96
62584374,06/02/2023,30.38,393.34
62584374,12/02/2023,-518.5,-125.16000000000003
62584374,14/02/2023,-126.17,-251.33000000000004
62671957,31/01/2023,,168.03
62671957,01/02/2023,96.51,264.54
62671957,07/02/2023,101.36,365.9
62671957,07/02/2023,-126.74,239.16000000000003
62671957,08/02/2023,119.16,358.32
62671957,09/02/2023,58.59,416.91
62671957,11/02/2023,1454.9,1871.8100000000002
62671957,12/02/2023,96.6,1968.41
62671957,12/02/2023,-51.66,1916.7500000000002
62716405,31/01/2023,,531.19
62716405,02/02/2023,84.59,615.7800000000001
62716405,03/02/2023,98.24,714.0200000000001
62716405,06/02/2023,15.22,729.24
62716405,14/02/2023,68.51,797.75
62746004,31/01/2023,,638.36
62746004,10/02/2023,97.09,735.45
62746004,11/02/2023,113.8,849.25
62756075,31/01/2023,,896.87
62756075,03/02/2023,436.5,1333.37
62756075,03/02/2023,10.53,1343.9
62756075,05/02/2023,-61.84,1282.06
62756075,06/02/2023,-11.94,1270.12
62756075,08/02/2023,14.84,1284.96
62756075,10/02/2023,-355.2,929.76
62756075,12/02/2023,196.98,1126.74
62756075,13/02/2023,142.99,1269.73
62780588,31/01/2023,,828.86
62780588,03/02/2023,-534.6,294.26
62780588,04/02/2023,72.53,366.78999999999996
62780588,06/02/2023,62.08,428.87
62780588,08/02/2023,106.62,535.49
62780588,08/02/2023,41.57,577.06
62780588,10/02/2023,109.89,686.95
62780588,11/02/2023,663.1,1350.05
62780588,12/02/2023,-233.91,1116.1399999999999
62862427,31/01/2023,,545.14
62862427,01/02/2023,-176.41,368.73
62862427,05/02/2023,19.27,388.0
62862427,06/02/2023,1069.9,1457.9
62862427,06/02/2023,-70.55,1387.3500000000001
62862427,10/02/2023,76.48,1463.8300000000002
62862427,11/02/2023,89.55,1553.38
62862427,11/02/2023,-101.6,1451.7800000000002
62862427,13/02/2023,1756.0,3207.78
62862427,14/02/2023,-76.49,3131.2900000000004
63014981,31/01/2023,,222.98
63014981,05/02/2023,-42.25,180.73
63014981,09/02/2023,-26.32,154.41
63014981,09/02/2023,-132.48,21.930000000000007
63057168,31/01/2023,,159.71
63057168,02/02/2023,104.5,264.21000000000004
63057168,09/02/2023,-16.12,248.09
63057168,10/02/2023,142.78,390.87
63057168,10/02/2023,-92.49,298.38
63102647,31/01/2023,,665.14
63102647,01/02/2023,77.81,742.95
63102647,04/02/2023,76.44,819.39
63102647,04/02/2023,-109.76,709.63
63102647,07/02/2023,113.01,822.64
63102647,07/02/2023,79.0,901.64
63102647,07/02/2023,32.06,933.7
63102647,07/02/2023,-20.07,913.63
63102647,09/02/2023,58.71,972.34
63102647,09/02/2023,-124.1,848.24
63102647,11/02/2023,158.35,1006.5899999999999
63102647,11/02/2023,-152.0,854.5899999999999
63232279,31/01/2023,,931.78
63232279,01/02/2023,118.27,1050.05
63232279,02/02/2023,129.83,1179.88
63232279,02/02/2023,-159.22,1020.66
63232279,03/02/2023,640.4,1661.06
63232279,03/02/2023,-2285.6,-624.54
63232279,07/02/2023,-146.5,-771.04
63232279,08/02/2023,56.83,-714.2099999999999
63232279,09/02/2023,-125.05,-839.26
63232279,11/02/2023,125.55,-713.7099999999999
63232279,11/02/2023,-36.36,-750.0699999999999
63265361,31/01/2023,,935.22
63265361,02/02/2023,-884.3,50.92000000000007
63265361,03/02/2023,96.77,147.69000000000005
63265361,05/02/2023,949.6,1097.29
63265361,07/02/2023,-135.72,961.57
63265361,08/02/2023,-132.99,828.58
63265361,10/02/2023,29.92,858.5000000000001
63265361,12/02/2023,136.93,995.4300000000001
63280767,31/01/2023,,836.58
63280767,02/02/2023,58.65,895.23
63280767,03/02/2023,43.75,938.98
63280767,05/02/2023,-159.79,779.19
63280767,07/02/2023,-852.6,-73.40999999999997
63280767,10/02/2023,79.87,6.460000000000036
63280767,14/02/2023,66.56,73.02000000000004
63298193,31/01/2023,,259.55
63298193,08/02/2023,1374.1,1633.6499999999999
63298193,08/02/2023,1360.9,2994.55
63298193,11/02/2023,45.02,3039.57
63298193,12/02/2023,1111.4,4150.97
63301094,31/01/2023,,532.03
63301094,03/02/2023,-159.23,372.79999999999995
63301094,04/02/2023,25.82,398.62
63301094,06/02/2023,1204.5,1603.12
63301094,07/02/2023,-93.91,1509.2099999999998
63301094,10/02/2023,116.53,1625.7399999999998
63301094,10/02/2023,-5.2,1620.54
63301094,11/02/2023,-130.33,1490.2099999999998
63381038,31/01/2023,,541.91
63381038,08/02/2023,69.06,610.97
63381038,13/02/2023,151.93,762.9
63405199,31/01/2023,,18.35
63405199,07/02/2023,102.26,120.61000000000001
63405199,07/02/2023,-178.2,-57.589999999999975
63405199,07/02/2023,-229.29,-286.88
63405199,09/02/2023,226.54,-60.339999999999975
63405199,11/02/2023,75.1,14.76000000000002
63405199,14/02/2023,-18.62,-3.8599999999999817
63405199,14/02/2023,-71.12,-74.97999999999999
63412767,31/01/2023,,715.41
63412767,03/02/2023,-18.62,696.79
63412767,03/02/2023,-87.36,609.43
63412767,03/02/2023,-153.0,456.42999999999995
63412767,05/02/2023,62.56,518.99
63412767,05/02/2023,-53.81,465.17999999999995
63412767,05/02/2023,-146.21,318.9699999999999
63412767,09/02/2023,128.5,447.4699999999999
63412767,11/02/2023,54.29,501.75999999999993
63412767,13/02/2023,-99.37,402.38999999999993
63486424,31/01/2023,,531.83
63486424,04/02/2023,-0.23,531.6
63486424,05/02/2023,167.77,699.3700000000001
63486424,07/02/2023,92.8,792.1700000000001
63486424,10/02/2023,-55.17,737.0
63486424,12/02/2023,-1224.6,-487.5999999999999
63534397,31/01/2023,,451.25
63534397,03/02/2023,-590.1,-138.85000000000002
63534397,06/02/2023,109.59,-29.26000000000002
63534397,07/02/2023,87.03,57.76999999999998
63534397,11/02/2023,-873.9,-816.13
63556863,31/01/2023,,634.4
63556863,01/02/2023,-0.5,633.9
63556863,02/02/2023,-102.25,531.65
63556863,03/02/2023,130.91,662.56
63556863,05/02/2023,-125.17,537.39
63556863,06/02/2023,1124.1,1661.4899999999998
63556863,06/02/2023,-104.85,1556.6399999999999
63556863,08/02/2023,1127.4,2684.04
63556863,09/02/2023,83.38,2767.42
63556863,09/02/2023,60.16,2827.58
63556863,11/02/2023,-213.76,2613.82
63569270,31/01/2023,,949.8
63569270,07/02/2023,-120.5,829.3
63569270,10/02/2023,30.02,859.3199999999999
63569270,11/02/2023,-1231.3,-371.98
63635633,31/01/2023,,202.35
63635633,07/02/2023,123.36,325.71
63635633,09/02/2023,109.51,435.22
63635633,10/02/2023,-60.41,374.81
63635633,13/02/2023,-74.51,300.3
63714888,31/01/2023,,632.75
63714888,01/02/2023,77.55,710.3
63714888,04/02/2023,-109.43,600.87
63714888,04/02/2023,-523.6,77.26999999999998
63714888,11/02/2023,174.19,251.45999999999998
63714888,12/02/2023,-207.81,43.64999999999998
63714888,12/02/2023,-1143.7,-1100.0500000000002
63714888,13/02/2023,44.57,-1055.48
63714888,14/02/2023,-80.39,-1135.87
63746530,31/01/2023,,874.63
63746530,05/02/2023,986.7,1861.33
63746530,06/02/2023,-57.25,1804.08
63746530,07/02/2023,764.7,2568.78
63746530,09/02/2023,1705.6,4274.38
63746530,09/02/2023,-116.81,4157.57
63746530,12/02/2023,94.08,4251.650000000001
63746530,12/02/2023,-151.29,4100.360000000001
63746530,14/02/2023,150.33,4250.6900000000005
63845700,31/01/2023,,856.95
63845700,02/02/2023,-184.44,672.51
63845700,04/02/2023,-168.29,504.22
63845700,06/02/2023,-59.16,445.06000000000006
63845700,09/02/2023,1606.6,2051.66
63845700,11/02/2023,126.05,2177.71
63845700,12/02/2023,75.56,2253.27
63863096,31/01/2023,,819.23
63863096,05/02/2023,-148.09,671.14
63863096,08/02/2023,167.77,838.9100000000001
63863096,08/02/2023,-72.17,766.74
63959769,31/01/2023,,938.58
63959769,03/02/2023,112.46,1051.04
63959769,08/02/2023,-147.81,903.23
63959769,09/02/2023,48.6,951.83
63959769,10/02/2023,54.78,1006.61
63959769,12/02/2023,-541.9,464.71000000000004
63977699,31/01/2023,,140.44
63977699,08/02/2023,-156.53,-16.090000000000003
63977699,10/02/2023,-60.14,-76.23
63977699,11/02/2023,207.88,131.64999999999998
63977699,11/02/2023,90.03,221.67999999999998
64034275,31/01/2023,,609.61
64034275,01/02/2023,42.27,651.88
64034275,01/02/2023,-55.09,596.79
64034275,01/02/2023,-71.89,524.9
64034275,10/02/2023,-84.47,440.43
64034275,11/02/2023,135.48,575.91
64034275,11/02/2023,99.93,675.84
64034275,12/02/2023,69.44,745.28
64034275,12/02/2023,66.35,811.63
64065043,31/01/2023,,245.44
64065043,06/02/2023,78.47,323.90999999999997
64065043,06/02/2023,67.45,391.36
64065043,10/02/2023,95.62,486.98
64065043,13/02/2023,1619.8,2106.7799999999997
64065043,13/02/2023,47.82,2154.6
64093529,31/01/2023,,748.57
64093529,02/02/2023,131.15,879.72
64093529,03/02/2023,151.73,1031.45
64093529,08/02/2023,155.62,1187.0700000000002
64093529,10/02/2023,93.29,1280.3600000000001
64108699,31/01/2023,,71.97
64108699,02/02/2023,-50.83,21.14
64108699,02/02/2023,-190.87,-169.73000000000002
64108699,07/02/2023,-116.74,-286.47
64108699,08/02/2023,120.11,-166.36
64108699,08/02/2023,-83.5,-249.86
64108699,09/02/2023,-34.17,-284.03000000000003
64108699,10/02/2023,111.68,-172.35000000000002
64108699,10/02/2023,-202.69,-375.04
64108699,14/02/2023,241.71,-133.33
64123632,31/01/2023,,358.39
64123632,03/02/2023,131.87,490.26
64123632,06/02/2023,54.05,544.31
64123632,07/02/2023,993.9,1538.21
64123632,07/02/2023,24.34,1562.55
64123632,10/02/2023,-193.16,1369.3899999999999
64123632,12/02/2023,85.39,1454.78
64160490,31/01/2023,,222.89
64160490,02/02/2023,115.12,338.01
64160490,03/02/2023,146.33,484.34000000000003
64160490,03/02/2023,-228.59,255.75
64160490,05/02/2023,-62.88,192.87
64160490,09/02/2023,-74.87,118.0
64160490,10/02/2023,11.9,129.9
64160490,12/02/2023,18.96,148.86
64160490,13/02/2023,-133.53,15.329999999999984
64160490,13/02/2023,-162.92,-147.59
64160490,14/02/2023,173.88,26.289999999999992
64160490,14/02/2023,85.5,111.78999999999999
64160490,14/02/2023,-122.9,-11.110000000000014
64167315,31/01/2023,,145.11
64167315,05/02/2023,69.19,214.3
64167315,06/02/2023,99.27,313.57
64167315,13/02/2023,59.69,373.26
64167315,14/02/2023,-165.55,207.70999999999998
64168292,31/01/2023,,297.09
64168292,03/02/2023,111.84,408.92999999999995
64168292,03/02/2023,-129.36,279.56999999999994
64168292,04/02/2023,101.49,381.05999999999995
64168292,06/02/2023,-59.58,321.47999999999996
64168292,08/02/2023,132.61,454.09
64168292,08/02/2023,-164.35,289.74
64168292,10/02/2023,25.17,314.90999999999997
64168292,10/02/2023,-182.87,132.03999999999996
64168292,13/02/2023,169.97,302.01
64168292,14/02/2023,1323.7,1625.71
64177019,31/01/2023,,298.31
64177019,04/02/2023,-76.94,221.37
64177019,05/02/2023,-17.88,203.49
64177019,06/02/2023,-89.28,114.21000000000001
64177019,09/02/2023,101.53,215.74
64177019,10/02/2023,116.06,331.8
64177019,10/02/2023,-101.58,230.22000000000003
64226824,31/01/2023,,794.79
64226824,05/02/2023,-112.69,682.0999999999999
64226824,11/02/2023,-104.89,577.2099999999999
64228624,31/01/2023,,508.14
64228624,02/02/2023,-150.88,357.26
64228624,04/02/2023,126.18,483.44
64228624,05/02/2023,110.97,594.41
64228624,09/02/2023,-85.88,508.53
64228624,10/02/2023,93.74,602.27
64228624,10/02/2023,-110.41,491.86
64228624,12/02/2023,1153.9,1645.7600000000002
64237458,31/01/2023,,255.48
64237458,01/02/2023,-75.62,179.85999999999999
64237458,02/02/2023,-55.08,124.77999999999999
64237458,05/02/2023,1295.5,1420.28
64237458,05/02/2023,103.17,1523.45
64237458,06/02/2023,55.36,1578.81
64237458,06/02/2023,-178.82,1399.99
64237458,09/02/2023,-158.77,1241.22
64237458,10/02/2023,59.81,1301.03
64237458,10/02/2023,-672.0,629.03
64237458,11/02/2023,2.2,631.23
64237458,12/02/2023,133.51,764.74
64237458,12/02/2023,-69.4,695.3399999999999
64237458,14/02/2023,105.98,801.3199999999999
64299012,31/01/2023,,509.56
64299012,01/02/2023,128.83,638.39
64299012,05/02/2023,90.59,728.98
64299012,06/02/2023,-47.53,681.45
64299012,08/02/2023,129.37,810.82
64299012,10/02/2023,-20.93,789.89
64299012,12/02/2023,-114.77,675.12
64299012,14/02/2023,146.71,821.83
64299012,14/02/2023,-2620.1,-1798.27
64300289,31/01/2023,,472.59
64300289,02/02/2023,-118.23,354.35999999999996
64300289,05/02/2023,29.05,383.40999999999997
64300289,06/02/2023,-78.61,304.79999999999995
64300289,09/02/2023,168.03,472.83
64300289,10/02/2023,-108.85,363.98
64300289,12/02/2023,-66.55,297.43
64300289,12/02/2023,-73.94,223.49
64303157,31/01/2023,,698.38
64303157,01/02/2023,-9.32,689.06
64303157,06/02/2023,-128.12,560.94
64303157,07/02/2023,96.55,657.49
64303157,08/02/2023,1737.4,2394.8900000000003
64305805,31/01/2023,,181.46
64305805,01/02/2023,126.64,308.1
64305805,04/02/2023,-1649.2,-1341.1
64305805,05/02/2023,-100.57,-1441.67
64305805,07/02/2023,-153.3,-1594.9700000000003
64305805,11/02/2023,102.91,-1492.0600000000002
64305805,13/02/2023,-73.97,-1566.0300000000002
64331821,31/01/2023,,519.62
64331821,05/02/2023,-145.08,374.53999999999996
64331821,07/02/2023,16.72,391.26
64331821,09/02/2023,897.0,1288.26
64331821,11/02/2023,-104.39,1183.87
64331821,11/02/2023,-148.32,1035.55
64331821,14/02/2023,479.9,1515.45
64402841,31/01/2023,,751.76
64402841,01/02/2023,-61.08,690.68
64402841,05/02/2023,109.7,800.38
64402841,07/02/2023,-133.09,667.29
64402841,11/02/2023,93.58,760.87
64402841,12/02/2023,-1411.1,-650.2299999999999
64402841,13/02/2023,52.19,-598.04
64411319,31/01/2023,,619.06
64411319,06/02/2023,128.12,747.18
64411319,08/02/2023,-128.28,618.9
64411319,10/02/2023,-58.75,560.15
64411319,11/02/2023,124.56,684.7099999999999
64411319,11/02/2023,96.47,781.18
64460080,31/01/2023,,313.37
64460080,01/02/2023,-85.99,227.38
64460080,02/02/2023,-61.09,166.29000000000002
64460080,03/02/2023,-119.02,47.27000000000001
64460080,03/02/2023,-156.41,-109.13999999999999
64460080,10/02/2023,191.56,82.42000000000002
64462046,31/01/2023,,847.04
64462046,07/02/2023,-1392.7,-545.6600000000001
64462046,10/02/2023,83.79,-461.87000000000006
64462046,10/02/2023,-715.5,-1177.3700000000001
64486954,31/01/2023,,378.0
64486954,05/02/2023,57.18,435.18
64486954,05/02/2023,-1685.4,-1250.22
64486954,08/02/2023,-117.41,-1367.63
64486954,11/02/2023,-1454.9,-2822.53
64526097,31/01/2023,,491.42
64526097,02/02/2023,61.97,553.39
64526097,03/02/2023,140.51,693.9
64526097,04/02/2023,46.96,740.86
64526097,10/02/2023,-67.56,673.3
64526097,11/02/2023,138.99,812.29
64526097,12/02/2023,28.57,840.86
64526097,13/02/2023,157.41,998.27
64533535,31/01/2023,,535.88
64533535,03/02/2023,-108.5,427.38
64533535,07/02/2023,-162.23,265.15
64533535,09/02/2023,-26.26,238.89000000000001
64533535,11/02/2023,59.16,298.05
64533535,13/02/2023,77.95,376.0
64571970,31/01/2023,,693.34
64571970,04/02/2023,809.4,1502.74
64571970,07/02/2023,-57.59,1445.15
64571970,07/02/2023,-135.14,1310.01
64571970,07/02/2023,-148.81,1161.2
64571970,08/02/2023,-71.81,1089.39
64571970,09/02/2023,-18.36,1071.03
64590882,31/01/2023,,344.01
64590882,03/02/2023,-1505.1,-1161.09
64590882,05/02/2023,71.17,-1089.9199999999998
64590882,05/02/2023,-144.77,-1234.69
64590882,07/02/2023,146.17,-1088.52
64590882,14/02/2023,75.01,-1013.51
64590882,14/02/2023,-54.0,-1067.51
64590882,14/02/2023,-140.07,-1207.58
64610632,31/01/2023,,869.95
64610632,04/02/2023,-35.39,834.5600000000001
64610632,05/02/2023,858.4,1692.96
64610632,07/02/2023,-147.04,1545.92
64610632,09/02/2023,46.29,1592.21
64610632,13/02/2023,-183.43,1408.78
64610632,13/02/2023,-199.57,1209.21
64683004,31/01/2023,,348.86
64683004,01/02/2023,614.1,962.96
64683004,04/02/2023,303.4,1266.3600000000001
64683004,04/02/2023,3.48,1269.84
64683004,05/02/2023,-183.09,1086.75
64683004,08/02/2023,2017.7,3104.45
64683004,08/02/2023,-106.98,2997.4700000000003
64683004,09/02/2023,1658.0,4655.47
64683004,11/02/2023,101.75,4757.22
64683004,13/02/2023,-188.62,4568.6
64683004,14/02/2023,147.85,4716.45
64683004,14/02/2023,107.71,4824.16
64683004,14/02/2023,-26.02,4798.14
64716185,31/01/2023,,391.53
64716185,02/02/2023,80.3,471.83
64716185,06/02/2023,-54.21,417.61999999999995
64716185,07/02/2023,1255.9,1673.52
64716185,08/02/2023,-89.88,1583.6399999999999
64716185,13/02/2023,-153.4,1430.24
64716185,14/02/2023,7.26,1437.5
64769583,31/01/2023,,598.67
64769583,02/02/2023,-115.98,482.68999999999994
64769583,04/02/2023,1705.8,2188.49
64769583,07/02/2023,115.83,2304.32
64769583,12/02/2023,-129.84,2174.48
64893719,31/01/2023,,689.59
64893719,03/02/2023,64.85,754.44
64893719,04/02/2023,-91.88,662.5600000000001
64893719,07/02/2023,126.74,789.3000000000001
64893719,08/02/2023,41.56,830.86
64893719,10/02/2023,-83.89,746.97
64893719,10/02/2023,-119.83,627.14
64901797,31/01/2023,,672.29
64901797,06/02/2023,73.11,745.4
64901797,07/02/2023,-94.93,650.4699999999999
64901797,10/02/2023,-154.39,496.08
64901797,14/02/2023,70.4,566.48
64953936,31/01/2023,,311.46
64953936,05/02/2023,226.81,538.27
64953936,08/02/2023,-34.12,504.15
64953936,11/02/2023,148.4,652.55
64953936,13/02/2023,-710.9,-58.35000000000002
64958880,31/01/2023,,840.8
64958880,01/02/2023,64.89,905.6899999999999
64958880,04/02/2023,87.56,993.25
64958880,04/02/2023,-54.34,938.91
64958880,07/02/2023,-156.28,782.6299999999999
64958880,09/02/2023,142.61,925.24
64958880,10/02/2023,50.54,975.78
64979248,31/01/2023,,202.63
64979248,02/02/2023,-168.67,33.96000000000001
64979248,05/02/2023,46.87,80.83000000000001
64979248,10/02/2023,15.31,96.14
64979248,12/02/2023,622.0,718.14
64979248,13/02/2023,136.67,854.81
64979248,14/02/2023,-44.4,810.41
64990799,31/01/2023,,480.33
64990799,02/02/2023,-102.4,377.92999999999995
64990799,03/02/2023,-62.98,314.95
64990799,10/02/2023,-67.2,247.74999999999997
64990799,12/02/2023,272.8,520.55
64990799,12/02/2023,-52.16,468.39
64990799,12/02/2023,-966.7,-498.31000000000006
65009032,31/01/2023,,984.64
65009032,03/02/2023,220.14,1204.78
65009032,04/02/2023,-128.21,1076.57
65009032,06/02/2023,-140.67,935.9
65009032,09/02/2023,143.28,1079.18
65009032,09/02/2023,95.74,1174.92
65009032,10/02/2023,99.74,1274.6599999999999
65009032,10/02/2023,93.37,1368.03
65009032,14/02/2023,97.59,1465.62
65033625,31/01/2023,,186.26
65033625,01/02/2023,117.4,303.65999999999997
65033625,01/02/2023,80.88,384.53999999999996
65033625,05/02/2023,104.89,489.43
65033625,06/02/2023,-107.96,381.47
65052411,31/01/2023,,877.5
65052411,05/02/2023,-80.22,797.28
65052411,06/02/2023,177.63,974.91
65052411,10/02/2023,48.54,1023.45
65052411,11/02/2023,159.34,1182.79
65052411,12/02/2023,463.1,1645.8899999999999
65052411,14/02/2023,169.73,1815.62
65097827,31/01/2023,,526.75
65097827,02/02/2023,-133.34,393.40999999999997
65097827,03/02/2023,-64.91,328.5
65097827,04/02/2023,-27.43,301.07
65097827,05/02/2023,109.24,410.31
65097827,06/02/2023,738.2,1148.51
65097827,09/02/2023,102.14,1250.65
65097827,09/02/2023,93.18,1343.83
65125795,31/01/2023,,632.35
65125795,02/02/2023,15.19,647.5400000000001
65125795,08/02/2023,38.13,685.6700000000001
65125795,14/02/2023,-66.29,619.38
65143384,31/01/2023,,227.08
65143384,04/02/2023,117.79,344.87
65143384,04/02/2023,8.85,353.72
65143384,06/02/2023,-122.9,230.82
65143384,07/02/2023,-109.89,120.93
65143384,07/02/2023,-119.45,1.480000000000004
65143384,07/02/2023,-1516.3,-1514.82
65143384,09/02/2023,139.36,-1375.46
65143384,11/02/2023,-67.21,-1442.6699999999998
65143384,12/02/2023,-45.77,-1488.4399999999998
65159654,31/01/2023,,761.19
65159654,05/02/2023,-148.44,612.75
65159654,08/02/2023,-123.43,489.32000000000005
65159654,10/02/2023,113.36,602.6800000000001
65159654,12/02/2023,-221.72,380.96000000000004
65159654,14/02/2023,37.21,418.17
65159654,14/02/2023,-665.3,-247.12999999999994
65199307,31/01/2023,,68.09
65199307,01/02/2023,161.85,229.94
65199307,01/02/2023,142.91,372.85
65199307,02/02/2023,1097.6,1470.4499999999998
65199307,06/02/2023,89.47,1559.9199999999998
65199307,10/02/2023,-58.45,1501.4699999999998
65199307,12/02/2023,96.4,1597.87
65199307,13/02/2023,63.47,1661.34
65200379,31/01/2023,,4.27
65200379,03/02/2023,37.15,41.42
65200379,04/02/2023,-68.44,-27.019999999999996
65200379,05/02/2023,66.67,39.650000000000006
65200379,06/02/2023,-101.4,-61.75
65200379,08/02/2023,-116.58,-178.32999999999998
65200379,10/02/2023,193.12,14.79000000000002
65200379,10/02/2023,158.38,173.17000000000002
65200379,10/02/2023,-83.52,89.65000000000002
65200379,11/02/2023,-171.55,-81.89999999999999
65200379,12/02/2023,-66.35,-148.25
65200379,12/02/2023,-1682.4,-1830.65
65220738,31/01/2023,,873.56
65220738,01/02/2023,-89.8,783.76
65220738,03/02/2023,-1121.6,-337.8399999999999
65220738,04/02/2023,158.98,-178.85999999999993
65220738,05/02/2023,-1533.5,-1712.36
65220738,06/02/2023,633.0,-1079.36
65220738,11/02/2023,-663.1,-1742.46
65225040,31/01/2023,,826.42
65225040,05/02/2023,-102.18,724.24
65225040,06/02/2023,146.22,870.4599999999999
65225040,06/02/2023,106.0,976.4599999999999
65225040,09/02/2023,188.3,1164.76
65225040,10/02/2023,-55.08,1109.68
65280102,31/01/2023,,2.17
65280102,06/02/2023,131.6,133.76999999999998
65280102,06/02/2023,-5.35,128.42
65280102,11/02/2023,203.67,332.09
65280102,11/02/2023,-134.09,197.99999999999997
65280102,14/02/2023,701.1,899.1
65280102,14/02/2023,126.17,1025.27
65321237,31/01/2023,,425.42
65321237,03/02/2023,616.4,1041.82
65321237,04/02/2023,-35.68,1006.1400000000001
65321237,05/02/2023,148.44,1154.58
65321237,08/02/2023,107.42,1262.0
65321237,11/02/2023,1293.9,2555.9
65321237,12/02/2023,100.61,2656.51
65380590,31/01/2023,,683.96
65380590,02/02/2023,-31.96,652.0
65380590,05/02/2023,70.44,722.44
65380590,07/02/2023,73.26,795.7
65380590,12/02/2023,-123.38,672.32
65380590,14/02/2023,18.54,690.86
65429379,31/01/2023,,232.83
65429379,01/02/2023,78.22,311.05
65429379,01/02/2023,54.5,365.55
65429379,07/02/2023,-155.73,209.82000000000002
65429379,09/02/2023,118.21,328.03000000000003
65429379,09/02/2023,24.12,352.15000000000003
65429379,09/02/2023,-133.43,218.72
65429379,10/02/2023,60.14,278.86
65429379,13/02/2023,133.53,412.39
65534206,31/01/2023,,274.89
65534206,01/02/2023,62.95,337.84
65534206,01/02/2023,-173.01,164.82999999999998
65534206,04/02/2023,35.8,200.63
65534206,09/02/2023,-124.56,76.06999999999998
65534206,13/02/2023,40.95,117.01999999999998
65534206,14/02/2023,133.43,250.45
65579734,31/01/2023,,928.08
65579734,07/02/2023,97.26,1025.3400000000001
65579734,10/02/2023,163.3,1188.64
65579734,10/02/2023,134.33,1322.97
65579734,10/02/2023,-123.19,1199.78
65579734,11/02/2023,130.27,1330.0500000000002
65579734,12/02/2023,-156.13,1173.92
65579734,13/02/2023,1085.6,2259.52
65579734,13/02/2023,-115.9,2143.62
65583532,31/01/2023,,542.09
65583532,03/02/2023,-80.54,461.55
65583532,04/02/2023,57.41,518.96
65583532,05/02/2023,209.45,728.4100000000001
65583532,09/02/2023,107.84,836.25
65583532,09/02/2023,-196.47,639.78
65589565,31/01/2023,,321.99
65589565,07/02/2023,-84.83,237.16000000000003
65589565,07/02/2023,-93.93,143.23000000000002
65589565,12/02/2023,-1761.1,-1617.87
65596186,31/01/2023,,254.28
65596186,03/02/2023,98.67,352.95
65596186,04/02/2023,-111.74,241.21
65596186,06/02/2023,-121.72,119.49000000000001
65596186,14/02/2023,-37.22,82.27000000000001
65603779,31/01/2023,,652.83
65603779,01/02/2023,-121.46,531.37
65603779,02/02/2023,1145.1,1676.4699999999998
65603779,02/02/2023,-108.49,1567.9799999999998
65603779,02/02/2023,-599.3,968.6799999999998
65603779,14/02/2023,201.83,1170.5099999999998
65606472,31/01/2023,,405.1
65606472,12/02/2023,-65.91,339.19000000000005
65606472,14/02/2023,-142.57,196.62000000000003
65606472,14/02/2023,-302.9,-106.27999999999994
65721172,31/01/2023,,221.49
65721172,04/02/2023,-155.79,65.70000000000002
65721172,05/02/2023,-66.67,-0.9699999999999847
65721172,05/02/2023,-190.77,-191.74
65721172,07/02/2023,-57.31,-249.04999999999998
65721172,09/02/2023,-154.04,-403.09
65721172,13/02/2023,-39.15,-442.23999999999995
65724980,31/01/2023,,307.93
65724980,01/02/2023,66.43,374.36
65724980,06/02/2023,1138.4,1512.7600000000002
65724980,06/02/2023,-133.2,1379.5600000000002
65724980,06/02/2023,-155.01,1224.5500000000002
65724980,07/02/2023,-134.59,1089.9600000000003
65724980,08/02/2023,-157.28,932.6800000000003
65724980,12/02/2023,-1.29,931.3900000000002
65754176,31/01/2023,,716.55
65754176,01/02/2023,174.19,890.74
65754176,03/02/2023,-218.15,672.5899999999999
65754176,09/02/2023,-1045.1,-372.51
65754176,10/02/2023,-106.77,-479.28
65754176,12/02/2023,180.46,-298.82
65754176,13/02/2023,-105.95,-404.77
65782923,31/01/2023,,193.43
65782923,05/02/2023,118.02,311.45
65782923,06/02/2023,-38.61,272.84000000000003
65782923,10/02/2023,-148.09,124.75
65782923,11/02/2023,70.39,195.14
65782923,14/02/2023,-87.88,107.26
65804470,31/01/2023,,454.38
65804470,02/02/2023,-129.45,324.93
65804470,03/02/2023,220.83,545.76
65804470,08/02/2023,117.35,663.11
65804470,11/02/2023,167.02,830.13
65804470,11/02/2023,-90.36,739.77
65804470,13/02/2023,62.13,801.9
65804470,14/02/2023,61.34,863.24
65815967,31/01/2023,,0.43
65815967,03/02/2023,84.7,85.13000000000001
65815967,07/02/2023,43.28,128.41000000000003
65815967,07/02/2023,-149.99,-21.579999999999984
65815967,09/02/2023,110.14,88.56000000000002
65815967,09/02/2023,63.99,152.55
65926576,31/01/2023,,73.48
65926576,02/02/2023,97.47,170.95
65926576,10/02/2023,82.23,253.18
65926576,12/02/2023,158.57,411.75
65926576,13/02/2023,110.4,522.15
65926576,14/02/2023,-143.6,378.55
65988118,31/01/2023,,647.81
65988118,02/02/2023,56.84,704.65
65988118,08/02/2023,-14.01,690.64
65988118,10/02/2023,55.13,745.77
65988118,10/02/2023,-117.56,628.2099999999999
65988118,11/02/2023,108.59,736.8
65988118,12/02/2023,157.46,894.26
66008535,31/01/2023,,398.99
66008535,01/02/2023,63.11,462.1
66008535,08/02/2023,105.76,567.86
66022888,31/01/2023,,757.14
66022888,01/02/2023,57.37,814.51
66022888,02/02/2023,-24.05,790.46
66022888,03/02/2023,98.38,888.8399999999999
66022888,03/02/2023,-50.38,838.4599999999999
66022888,03/02/2023,-91.37,747.0899999999999
66022888,07/02/2023,126.32,873.41
66022888,08/02/2023,-159.05,714.3599999999999
66022888,09/02/2023,63.95,778.31
66022888,14/02/2023,81.21,859.52
66044567,31/01/2023,,596.13
66044567,02/02/2023,183.83,779.96
66044567,03/02/2023,11.36,791.32
66044567,05/02/2023,159.59,950.9100000000001
66044567,12/02/2023,95.14,1046.05
66152145,31/01/2023,,83.45
66152145,02/02/2023,150.88,234.32999999999998
66152145,03/02/2023,55.63,289.96
66152145,03/02/2023,-616.4,-326.44
66152145,05/02/2023,-83.4,-409.84000000000003
66152145,07/02/2023,-1760.8,-2170.64
66152145,08/02/2023,59.97,-2110.67
66152145,09/02/2023,-73.42,-2184.09
66152145,14/02/2023,685.5,-1498.5900000000001
66152145,14/02/2023,107.51,-1391.0800000000002
66168472,31/01/2023,,29.89
66168472,03/02/2023,221.11,251.0
66168472,03/02/2023,-79.25,171.75
66168472,03/02/2023,-196.95,-25.19999999999999
66168472,05/02/2023,98.07,72.87
66168472,09/02/2023,96.2,169.07
66168472,09/02/2023,20.18,189.25
66168472,12/02/2023,-88.2,101.05000000000001
66175264,31/01/2023,,765.91
66175264,06/02/2023,123.31,889.22
66175264,09/02/2023,74.87,964.0899999999999
66175264,10/02/2023,1134.6,2098.6899999999996
66175264,12/02/2023,67.31,2166.0
66175264,13/02/2023,-161.21,2004.7899999999997
66175264,14/02/2023,117.68,2122.47
66187843,31/01/2023,,535.34
66187843,01/02/2023,-112.17,423.17
66187843,03/02/2023,163.12,586.29
66239954,31/01/2023,,181.14
66239954,02/02/2023,93.88,275.02
66239954,03/02/2023,267.7,542.72
66239954,05/02/2023,83.4,626.12
66239954,07/02/2023,-140.1,486.02
66239954,12/02/2023,-48.67,437.34999999999997
66239954,12/02/2023,-57.42,379.92999999999995
66239954,14/02/2023,130.84,510.77
66239954,14/02/2023,80.39,591.16
66239954,14/02/2023,-1478.2,-887.0400000000001
66257438,31/01/2023,,818.57
66257438,01/02/2023,78.4,896.97
66257438,04/02/2023,84.59,981.5600000000001
66257438,05/02/2023,-28.46,953.1
66257438,07/02/2023,-6.03,947.07
66257438,09/02/2023,71.12,1018.19
66257438,12/02/2023,1799.2,2817.3900000000003
66257438,12/02/2023,-108.0,2709.3900000000003
66283493,31/01/2023,,612.88
66283493,06/02/2023,49.21,662.09
66283493,07/02/2023,1370.6,2032.69
66332583,31/01/2023,,241.29
66332583,05/02/2023,-184.86,56.42999999999998
66332583,06/02/2023,-83.89,-27.460000000000022
66332583,07/02/2023,151.7,124.23999999999997
66332583,09/02/2023,-121.13,3.109999999999971
66332583,12/02/2023,-128.81,-125.70000000000003
66332583,12/02/2023,-198.39,-324.09000000000003
66341438,31/01/2023,,685.06
66341438,05/02/2023,-1625.6,-940.54
66341438,06/02/2023,113.63,-826.91
66341438,13/02/2023,-81.39,-908.3
66341438,13/02/2023,-1013.4,-1921.6999999999998
66390683,31/01/2023,,52.77
66390683,01/02/2023,-104.47,-51.699999999999996
66390683,03/02/2023,-103.29,-154.99
66390683,05/02/2023,83.99,-71.0
66390683,05/02/2023,-165.42,-236.42
66390683,09/02/2023,90.79,-145.63
66390683,11/02/2023,-77.62,-223.25
66390683,13/02/2023,-157.55,-380.8
66390683,14/02/2023,65.5,-315.3
66390683,14/02/2023,-133.19,-448.49
66390683,14/02/2023,-146.71,-595.2
66416254,31/01/2023,,166.4
66416254,03/02/2023,131.54,297.94
66416254,03/02/2023,-38.14,259.8
66416254,03/02/2023,-63.29,196.51
66416254,03/02/2023,-159.42,37.09
66416254,04/02/2023,-93.96,-56.86999999999999
66416254,05/02/2023,812.6,755.73
66416254,05/02/2023,-159.34,596.39
66416254,06/02/2023,1095.4,1691.79
66416254,10/02/2023,174.77,1866.56
66416254,10/02/2023,-68.78,1797.78
66416254,11/02/2023,142.67,1940.45
66416254,12/02/2023,-89.64,1850.81
66416254,13/02/2023,837.4,2688.21
66445304,31/01/2023,,153.78
66445304,01/02/2023,174.0,327.78
66445304,05/02/2023,184.78,512.56
66445304,05/02/2023,-108.92,403.64
66445304,08/02/2023,-94.29,309.35
66449974,31/01/2023,,795.59
66449974,05/02/2023,65.31,860.9000000000001
66449974,11/02/2023,102.91,963.8100000000001
66449974,12/02/2023,-80.44,883.37
66449974,12/02/2023,-1265.1,-381.7299999999999
66504443,31/01/2023,,618.97
66504443,02/02/2023,-217.51,401.46000000000004
66504443,05/02/2023,-45.47,355.99
66504443,12/02/2023,-127.6,228.39000000000004
66521788,31/01/2023,,201.43
66521788,01/02/2023,-127.41,74.02000000000001
66521788,05/02/2023,90.66,164.68
66521788,05/02/2023,-73.78,90.9
66521788,13/02/2023,-67.31,23.590000000000003
66556141,31/01/2023,,688.37
66556141,05/02/2023,-33.96,654.41
66556141,07/02/2023,45.83,700.24
66556141,10/02/2023,206.97,907.21
66556141,13/02/2023,-96.51,810.7
66586860,31/01/2023,,938.51
66586860,01/02/2023,1072.7,2011.21
66586860,06/02/2023,-143.42,1867.79
66586860,07/02/2023,-106.1,1761.69
66586860,08/02/2023,-145.66,1616.03
66586860,10/02/2023,116.33,1732.3600000000001
66586860,11/02/2023,-86.77,1645.5900000000001
66586860,11/02/2023,-148.74,1496.8500000000001
66586860,12/02/2023,-1764.4,-267.54999999999995
66586860,13/02/2023,-56.41,-323.9599999999999
66601462,31/01/2023,,361.46
66601462,11/02/2023,62.18,423.64
66601462,13/02/2023,-115.86,307.78
66624477,31/01/2023,,521.98
66624477,10/02/2023,-1271.5,-749.52
66624477,13/02/2023,-70.58,-820.1
66667727,31/01/2023,,431.31
66667727,01/02/2023,145.77,577.08
66667727,04/02/2023,146.82,723.9
66667727,04/02/2023,-201.15,522.75
66667727,05/02/2023,-104.58,418.17
66667727,06/02/2023,-106.31,311.86
66681692,31/01/2023,,712.12
66681692,03/02/2023,644.3,1356.42
66681692,03/02/2023,-102.01,1254.4099999999999
66681692,09/02/2023,1246.4,2500.81
66681692,11/02/2023,99.6,2600.41
66681692,14/02/2023,-150.42,2449.99
66700123,31/01/2023,,175.15
66700123,01/02/2023,-106.46,68.69000000000001
66700123,02/02/2023,-1180.2,-1111.51
66700123,08/02/2023,-39.85,-1151.36
66700123,11/02/2023,125.31,-1026.05
66700123,12/02/2023,-62.68,-1088.73
66704269,31/01/2023,,915.51
66704269,03/02/2023,110.38,1025.8899999999999
66704269,04/02/2023,124.72,1150.61
66704269,04/02/2023,64.92,1215.53
66704269,05/02/2023,159.34,1374.87
66704269,07/02/2023,-10.31,1364.56
66704269,08/02/2023,-157.04,1207.52
66704269,11/02/2023,94.59,1302.1100000000001
66704269,12/02/2023,-124.55,1177.56
66704269,14/02/2023,658.2,1835.7600000000002
66704269,14/02/2023,87.55,1923.3100000000002
66706067,31/01/2023,,1.98
66706067,02/02/2023,-233.36,-231.38000000000002
66706067,04/02/2023,111.13,-120.25000000000003
66706067,07/02/2023,-180.28,-300.53000000000003
66706067,08/02/2023,-12.95,-313.48
66706067,08/02/2023,-1006.9,-1320.38
66706067,10/02/2023,1202.5,-117.88000000000011
66706067,10/02/2023,96.87,-21.010000000000105
66706067,10/02/2023,-140.57,-161.5800000000001
66706067,11/02/2023,-52.74,-214.3200000000001
66706067,12/02/2023,166.9,-47.4200000000001
66729131,31/01/2023,,100.8
66729131,04/02/2023,-24.31,76.49
66729131,04/02/2023,-95.6,-19.11
66729131,04/02/2023,-146.89,-166.0
66729131,05/02/2023,87.07,-78.93
66896515,31/01/2023,,842.82
66896515,04/02/2023,535.8,1378.62
66896515,05/02/2023,91.73,1470.35
66896515,05/02/2023,-104.2,1366.15
66896515,05/02/2023,-190.01,1176.14
66896515,09/02/2023,101.53,1277.67
66896515,11/02/2023,222.05,1499.72
66896515,11/02/2023,-99.6,1400.1200000000001
66914990,31/01/2023,,764.75
66914990,01/02/2023,-98.33,666.42
66914990,05/02/2023,137.98,804.4
66914990,09/02/2023,-125.11,679.29
66914990,13/02/2023,-229.21,450.08
66914990,14/02/2023,65.19,515.27
66914990,14/02/2023,-133.67,381.6
66930564,31/01/2023,,398.03
66930564,02/02/2023,-83.72,314.30999999999995
66930564,05/02/2023,-174.96,139.34999999999997
66930564,06/02/2023,115.81,255.15999999999997
66930564,11/02/2023,-96.9,158.25999999999996
66930564,13/02/2023,114.54,272.79999999999995
66954664,31/01/2023,,620.1
66954664,04/02/2023,49.52,669.62
66954664,04/02/2023,-57.49,612.13
66954664,05/02/2023,-202.11,410.02
66954664,08/02/2023,-62.89,347.13
66954664,12/02/2023,-153.75,193.38
66954664,13/02/2023,-48.57,144.81
66954664,14/02/2023,-781.5,-636.69
67029298,31/01/2023,,255.53
67029298,01/02/2023,-60.58,194.95
67029298,02/02/2023,786.6,981.55
67029298,02/02/2023,68.12,1049.67
67029298,02/02/2023,28.3,1077.97
67029298,02/02/2023,-90.07,987.9000000000001
67029298,07/02/2023,21.61,1009.5100000000001
67029298,08/02/2023,-107.83,901.6800000000001
67029298,14/02/2023,-93.35,808.33
67056187,31/01/2023,,392.51
67056187,02/02/2023,-101.39,291.12
67056187,08/02/2023,-92.86,198.26
67056187,09/02/2023,-163.99,34.26999999999998
67056187,11/02/2023,-1370.2,-1335.93
67056187,14/02/2023,-47.83,-1383.76
67056187,14/02/2023,-106.34,-1490.1000000000001
67090449,31/01/2023,,724.35
67090449,04/02/2023,-31.07,693.28
67090449,07/02/2023,-84.46,608.82
67090449,07/02/2023,-788.3,-179.4799999999999
67090449,09/02/2023,-143.28,-322.7599999999999
67090449,10/02/2023,103.55,-219.20999999999992
67090449,10/02/2023,-59.66,-278.8699999999999
67090449,11/02/2023,62.9,-215.9699999999999
67090449,14/02/2023,72.94,-143.02999999999992
67090449,14/02/2023,-1145.9,-1288.93
67102224,31/01/2023,,852.71
67102224,01/02/2023,103.68,956.3900000000001
67102224,03/02/2023,-107.3,849.09
67104073,31/01/2023,,476.04
67104073,03/02/2023,46.54,522.58
67104073,07/02/2023,-184.95,337.63
67104073,13/02/2023,-69.73,267.90000000000003
67147649,31/01/2023,,3.28
67147649,02/02/2023,1499.9,1503.18
67147649,03/02/2023,-121.77,1381.41
67147649,05/02/2023,106.43,1487.8400000000001
67147649,08/02/2023,27.23,1515.0700000000002
67147649,10/02/2023,72.61,1587.68
67147649,14/02/2023,98.34,1686.02
67153119,31/01/2023,,454.81
67153119,01/02/2023,117.6,572.41
67153119,01/02/2023,-99.45,472.96
67153119,02/02/2023,190.87,663.8299999999999
67153119,03/02/2023,8.49,672.3199999999999
67153119,08/02/2023,-53.25,619.0699999999999
67153119,12/02/2023,91.62,710.69
67153119,14/02/2023,-171.69,539.0
67157564,31/01/2023,,562.42
67157564,01/02/2023,1153.0,1715.42
67157564,02/02/2023,74.82,1790.24
67157564,03/02/2023,89.03,1879.27
67157564,04/02/2023,-160.12,1719.15
67157564,08/02/2023,-122.19,1596.96
67157564,10/02/2023,-58.74,1538.22
67157564,10/02/2023,-72.18,1466.04
67157564,12/02/2023,71.93,1537.97
67190209,31/01/2023,,567.61
67190209,01/02/2023,74.4,642.01
67270354,31/01/2023,,805.28
67270354,04/02/2023,-130.37,674.91
67270354,05/02/2023,-139.91,535.0
67270354,10/02/2023,1124.9,1659.9
67270354,12/02/2023,-68.07,1591.8300000000002
67283010,31/01/2023,,872.4
67283010,02/02/2023,72.58,944.98
67283010,04/02/2023,126.98,1071.96
67283010,05/02/2023,143.73,1215.69
67283010,08/02/2023,-7.94,1207.75
67283010,11/02/2023,-75.12,1132.6299999999999
67392638,31/01/2023,,519.61
67392638,04/02/2023,905.4,1425.01
67392638,05/02/2023,184.06,1609.07
67392638,05/02/2023,-95.35,1513.72
67392638,06/02/2023,-93.75,1419.97
67400117,31/01/2023,,769.45
67400117,02/02/2023,-114.44,655.01
67400117,03/02/2023,158.72,813.73
67400117,10/02/2023,121.7,935.4300000000001
67400117,10/02/2023,-130.32,805.1100000000001
67400117,14/02/2023,-658.2,146.91000000000008
67434874,31/01/2023,,399.94
67434874,02/02/2023,108.49,508.43
67434874,03/02/2023,94.57,603.0
67434874,04/02/2023,72.83,675.8299999999999
67434874,05/02/2023,80.66,756.49
67434874,07/02/2023,-123.67,632.8199999999999
67434874,09/02/2023,110.11,742.93
67434874,11/02/2023,-88.2,654.73
67434874,12/02/2023,-85.9,568.8299999999999
67464890,31/01/2023,,81.27
67464890,13/02/2023,-565.6,-484.33000000000004
67464890,14/02/2023,-114.72,-599.0500000000001
67466632,31/01/2023,,350.06
67466632,01/02/2023,126.75,476.81
67466632,05/02/2023,-1317.7,-840.8900000000001
67466632,06/02/2023,179.1,-661.7900000000001
67466632,06/02/2023,48.43,-613.3600000000001
67466632,09/02/2023,144.14,-469.22000000000014
67466632,11/02/2023,83.01,-386.2100000000001
67466632,11/02/2023,-196.49,-582.7
67466632,13/02/2023,-66.5,-649.2
67466632,14/02/2023,-147.38,-796.5800000000002
67489489,31/01/2023,,219.39
67489489,01/02/2023,-118.62,100.76999999999998
67489489,04/02/2023,88.31,189.07999999999998
67489489,04/02/2023,68.1,257.17999999999995
67489489,06/02/2023,112.02,369.2
67489489,06/02/2023,91.86,461.05999999999995
67489489,09/02/2023,-7.44,453.61999999999995
67489489,09/02/2023,-264.6,189.01999999999992
67489489,14/02/2023,85.38,274.3999999999999
67490657,31/01/2023,,588.58
67490657,04/02/2023,-158.56,430.02000000000004
67490657,05/02/2023,-18.89,411.13000000000005
67490657,06/02/2023,-146.96,264.17
67490657,08/02/2023,59.4,323.57
67490657,10/02/2023,123.76,447.33000000000004
67490657,11/02/2023,-954.4,-507.06999999999994
67490657,12/02/2023,-850.1,-1357.17
67490657,14/02/2023,99.88,-1257.29
67502738,31/01/2023,,185.72
67502738,08/02/2023,170.5,356.22
67502738,10/02/2023,-104.93,251.29
67502738,12/02/2023,-84.83,166.45999999999998
67532228,31/01/2023,,805.91
67532228,03/02/2023,936.3,1742.21
67532228,04/02/2023,-163.15,1579.06
67532228,05/02/2023,117.8,1696.86
67532228,05/02/2023,-139.34,1557.52
67532228,07/02/2023,153.27,1710.79
67532228,10/02/2023,-92.13,1618.6599999999999
67541253,31/01/2023,,985.49
67541253,02/02/2023,-555.5,429.99
67541253,05/02/2023,81.2,511.19
67541253,09/02/2023,-38.71,472.48
67541253,10/02/2023,139.35,611.83
67561762,31/01/2023,,469.23
67561762,01/02/2023,170.35,639.58
67561762,04/02/2023,-192.0,447.58000000000004
67561762,07/02/2023,-52.55,395.03000000000003
67561762,09/02/2023,-140.61,254.42000000000002
67561762,11/02/2023,-1136.3,-881.8799999999999
67561762,14/02/2023,114.68,-767.1999999999998
67571676,31/01/2023,,491.88
67571676,09/02/2023,151.22,643.1
67571676,09/02/2023,-7.96,635.14
67571676,10/02/2023,-11.9,623.24
67571676,14/02/2023,-85.15,538.09
67635951,31/01/2023,,692.02
67635951,01/02/2023,167.46,859.48
67635951,01/02/2023,77.61,937.09
67635951,04/02/2023,133.61,1070.7
67635951,04/02/2023,-109.45,961.25
67635951,04/02/2023,-174.55,786.7
67635951,08/02/2023,174.24,960.94
67635951,08/02/2023,-89.09,871.85
67635951,08/02/2023,-258.6,613.25
67674594,31/01/2023,,126.16
67674594,01/02/2023,61.16,187.32
67674594,07/02/2023,-169.03,18.289999999999992
67674594,08/02/2023,153.92,172.20999999999998
67674594,08/02/2023,-135.45,36.75999999999999
67674594,09/02/2023,-56.53,-19.77000000000001
67674594,11/02/2023,151.65,131.88
67674594,12/02/2023,-76.15,55.72999999999999
67679622,31/01/2023,,631.03
67679622,01/02/2023,142.37,773.4
67679622,08/02/2023,-54.11,719.29
67679622,08/02/2023,-93.74,625.55
67679622,09/02/2023,813.0,1438.55
67679622,10/02/2023,-111.68,1326.87
67679622,10/02/2023,-190.89,1135.98
67679622,12/02/2023,-163.83,972.15
67716893,31/01/2023,,250.99
67716893,02/02/2023,93.16,344.15
67716893,05/02/2023,69.16,413.31
67716893,07/02/2023,-126.45,286.86
67716893,07/02/2023,-1500.0,-1213.1399999999999
67716893,08/02/2023,-10.18,-1223.32
67716893,08/02/2023,-73.68,-1297.0
67716893,09/02/2023,166.7,-1130.3
67805276,31/01/2023,,431.12
67805276,08/02/2023,88.85,519.97
67805276,09/02/2023,79.05,599.02
67805276,09/02/2023,-182.8,416.21999999999997
67805276,10/02/2023,103.06,519.28
67805276,11/02/2023,104.82,624.0999999999999
67805276,14/02/2023,-10.57,613.53
67837998,31/01/2023,,246.4
67837998,02/02/2023,154.06,400.46000000000004
67837998,04/02/2023,-87.56,312.9
67837998,05/02/2023,63.7,376.6
67837998,10/02/2023,682.2,1058.8000000000002
67862200,31/01/2023,,944.49
67862200,04/02/2023,-121.95,822.54
67862200,06/02/2023,-7.07,815.47
67862200,09/02/2023,1131.6,1947.07
67862200,11/02/2023,1655.3,3602.37
67862200,12/02/2023,-860.8,2741.5699999999997
67902154,31/01/2023,,669.79
67902154,01/02/2023,65.61,735.4
67902154,01/02/2023,-86.21,649.1899999999999
67902154,01/02/2023,-546.3,102.88999999999999
67902154,03/02/2023,-3.24,99.64999999999999
67902154,03/02/2023,-58.81,40.83999999999998
67902154,04/02/2023,126.83,167.67
67902154,06/02/2023,188.27,355.93999999999994
67902154,06/02/2023,-85.9,270.03999999999996
67902154,08/02/2023,118.58,388.61999999999995
67902154,12/02/2023,158.11,546.73
67902154,14/02/2023,-91.53,455.19999999999993
67902154,14/02/2023,-1100.7,-645.5000000000001
67909830,31/01/2023,,589.68
67909830,03/02/2023,168.82,758.5
67909830,03/02/2023,-118.95,639.55
67909830,06/02/2023,-157.94,481.60999999999996
67909830,07/02/2023,86.52,568.13
67909830,11/02/2023,170.72,738.8499999999999
67911201,31/01/2023,,762.17
67911201,01/02/2023,65.26,827.43
67911201,04/02/2023,-120.19,707.24
67911201,09/02/2023,-1558.7,-851.46
67911201,10/02/2023,170.08,-681.38
67911201,11/02/2023,-52.48,-733.86
67911201,11/02/2023,-107.06,-840.9200000000001
67911677,31/01/2023,,725.9
67911677,04/02/2023,149.2,875.0999999999999
67911677,09/02/2023,-73.05,802.05
67938929,31/01/2023,,868.04
67938929,01/02/2023,-125.38,742.66
67938929,03/02/2023,110.43,853.0899999999999
67938929,03/02/2023,-61.92,791.17
67938929,06/02/2023,122.9,914.0699999999999
67938929,09/02/2023,158.5,1072.57
67938929,09/02/2023,-135.47,937.1
67938929,10/02/2023,90.78,1027.88
67938929,10/02/2023,58.74,1086.62
67938929,10/02/2023,-20.05,1066.57
67938929,11/02/2023,-73.62,992.95
67938929,13/02/2023,121.3,1114.25
67961706,31/01/2023,,569.5
67961706,05/02/2023,95.84,665.34
67961706,09/02/2023,182.8,848.14
67961706,11/02/2023,832.5,1680.6399999999999
67961706,12/02/2023,-98.2,1582.44
67961706,14/02/2023,104.45,1686.8899999999999
67987326,31/01/2023,,161.67
67987326,01/02/2023,-151.18,10.48999999999998
67987326,06/02/2023,175.36,185.85
67987326,07/02/2023,-138.63,47.22
67987326,10/02/2023,83.95,131.17000000000002
67987326,12/02/2023,224.14,355.31
68051701,31/01/2023,,911.6
68051701,03/02/2023,-197.64,713.96
68051701,03/02/2023,-774.8,-60.83999999999992
68051701,04/02/2023,-34.22,-95.05999999999992
68051701,11/02/2023,89.5,-5.559999999999917
68051701,12/02/2023,128.28,122.72000000000008
68051701,13/02/2023,-184.92,-62.1999999999999
68104946,31/01/2023,,925.71
68104946,08/02/2023,109.29,1035.0
68153614,31/01/2023,,927.95
68153614,02/02/2023,118.22,1046.17
68153614,10/02/2023,-170.08,876.09
68153614,11/02/2023,-659.5,216.59000000000003
68153614,13/02/2023,-99.78,116.81000000000003
68189902,31/01/2023,,448.56
68189902,02/02/2023,-61.7,386.86
68189902,05/02/2023,125.05,511.90999999999997
68189902,05/02/2023,-153.59,358.32
68189902,06/02/2023,145.42,503.74
68189902,07/02/2023,101.79,605.53
68198696,31/01/2023,,979.46
68198696,05/02/2023,27.36,1006.82
68198696,07/02/2023,159.97,1166.79
68198696,08/02/2023,-96.45,1070.34
68198696,09/02/2023,56.02,1126.3600000000001
68198696,09/02/2023,-37.14,1089.22
68198696,09/02/2023,-60.16,1029.06
68198696,11/02/2023,-16.59,1012.47
68198696,12/02/2023,1149.0,2161.4700000000003
68239576,31/01/2023,,64.42
68239576,01/02/2023,121.83,186.25
68239576,01/02/2023,94.97,281.22
68239576,01/02/2023,21.82,303.04
68239576,05/02/2023,100.33,403.37
68239576,09/02/2023,85.04,488.41
68239576,09/02/2023,-129.19,359.22
68262083,31/01/2023,,899.79
68262083,04/02/2023,-141.71,758.0799999999999
68262083,11/02/2023,-57.11,700.9699999999999
68262083,14/02/2023,120.31,821.28
68275028,31/01/2023,,918.44
68275028,01/02/2023,-120.92,797.5200000000001
68275028,03/02/2023,106.67,904.19
68275028,04/02/2023,-35.52,868.6700000000001
68275028,07/02/2023,1002.5,1871.17
68275028,07/02/2023,192.3,2063.4700000000003
68275028,09/02/2023,-107.22,1956.25
68294036,31/01/2023,,184.64
68294036,02/02/2023,119.55,304.19
68294036,06/02/2023,67.41,371.59999999999997
68294036,06/02/2023,-50.84,320.76
68294036,08/02/2023,-157.52,163.23999999999995
68294036,08/02/2023,-162.49,0.7499999999999432
68294036,09/02/2023,411.3,412.04999999999995
68294036,10/02/2023,165.63,577.68
68294645,31/01/2023,,306.18
68294645,01/02/2023,33.51,339.69
68294645,02/02/2023,83.72,423.40999999999997
68294645,06/02/2023,126.54,549.95
68294645,12/02/2023,-72.46,477.49
68311266,31/01/2023,,87.08
68311266,01/02/2023,-239.72,-152.64
68311266,03/02/2023,130.74,-21.900000000000006
68311266,05/02/2023,139.91,118.00999999999999
68311266,06/02/2023,1253.1,1371.11
68311266,10/02/2023,114.74,1485.85
68311266,12/02/2023,-96.87,1388.9799999999998
68311266,14/02/2023,108.48,1497.4599999999998
68311266,14/02/2023,27.68,1525.1399999999999
68315462,31/01/2023,,769.16
68315462,01/02/2023,152.29,921.4499999999999
68315462,02/02/2023,118.55,1040.0
68315462,03/02/2023,198.29,1238.29
68315462,05/02/2023,-10.32,1227.97
68315462,05/02/2023,-19.27,1208.7
68315462,09/02/2023,1410.1,2618.8
68315462,10/02/2023,104.86,2723.66
68315462,10/02/2023,63.58,2787.24
68315462,10/02/2023,-74.29,2712.95
68315462,13/02/2023,-40.65,2672.2999999999997
68346907,31/01/2023,,752.88
68346907,01/02/2023,-844.6,-91.72000000000003
68346907,05/02/2023,74.21,-17.510000000000034
68346907,06/02/2023,-100.09,-117.60000000000004
68346907,07/02/2023,-129.86,-247.46000000000004
68346907,08/02/2023,43.89,-203.57000000000005
68346907,09/02/2023,-78.9,-282.47
68346907,12/02/2023,-841.7,-1124.17
68346907,13/02/2023,92.64,-1031.53
68393439,31/01/2023,,783.05
68393439,01/02/2023,137.75,920.8
68393439,02/02/2023,-174.74,746.06
68393439,05/02/2023,104.42,850.4799999999999
68393439,09/02/2023,115.06,965.54
68393439,10/02/2023,-130.57,834.97
68393439,12/02/2023,40.07,875.04
68393439,12/02/2023,-67.66,807.38
68393439,13/02/2023,-72.65,734.73
68393439,13/02/2023,-125.61,609.12
68393439,13/02/2023,-152.83,456.28999999999996
68423238,31/01/2023,,972.94
68423238,05/02/2023,80.22,1053.16
68423238,11/02/2023,-107.4,945.76
68423238,12/02/2023,128.4,1074.16
68423238,12/02/2023,84.4,1158.56
68423238,13/02/2023,175.32,1333.88
68483071,31/01/2023,,25.88
68483071,04/02/2023,-2122.7,-2096.8199999999997
68483071,05/02/2023,-1580.8,-3677.62
68483071,07/02/2023,166.87,-3510.7499999999995
68484031,31/01/2023,,853.99
68484031,02/02/2023,52.86,906.85
68484031,05/02/2023,18.89,925.74
68484031,05/02/2023,-1463.6,-537.8599999999999
68484031,11/02/2023,1672.7,1134.8400000000001
68484031,11/02/2023,-26.87,1107.9700000000003
68552857,31/01/2023,,309.92
68552857,02/02/2023,156.04,465.96000000000004
68552857,02/02/2023,-106.6,359.36
68552857,08/02/2023,-68.6,290.76
68552994,31/01/2023,,516.25
68552994,01/02/2023,-62.95,453.3
68552994,08/02/2023,-1608.4,-1155.1000000000001
68552994,09/02/2023,-88.81,-1243.91
68552994,14/02/2023,781.5,-462.4100000000001
68558850,31/01/2023,,281.5
68558850,01/02/2023,80.81,362.31
68558850,04/02/2023,1395.3,1757.61
68558850,06/02/2023,-182.96,1574.6499999999999
68558850,07/02/2023,-111.95,1462.6999999999998
68558850,10/02/2023,-70.74,1391.9599999999998
68558850,12/02/2023,-69.85,1322.11
68579203,31/01/2023,,149.39
68680764,31/01/2023,,200.27
68680764,03/02/2023,886.6,1086.8700000000001
68680764,09/02/2023,-81.22,1005.65
68683403,31/01/2023,,674.5
68683403,05/02/2023,63.32,737.82
68683403,13/02/2023,535.9,1273.72
68689742,31/01/2023,,45.41
68689742,07/02/2023,121.67,167.07999999999998
68689742,07/02/2023,56.42,223.5
68689742,14/02/2023,-123.36,100.14
68708795,31/01/2023,,399.11
68708795,03/02/2023,-102.85,296.26
68708795,04/02/2023,-140.43,155.83
68708795,04/02/2023,-255.0,-99.16999999999999
68708795,05/02/2023,-109.76,-208.93
68708795,07/02/2023,-115.4,-324.33
68708795,08/02/2023,-134.23,-458.56
68708795,09/02/2023,-49.06,-507.62
68708795,10/02/2023,-138.8,-646.4200000000001
68708795,14/02/2023,-1297.2,-1943.6200000000001
68721707,31/01/2023,,900.45
68721707,03/02/2023,113.78,1014.23
68721707,09/02/2023,69.99,1084.22
68721707,10/02/2023,-113.56,970.6600000000001
68775529,31/01/2023,,531.87
68775529,03/02/2023,1266.7,1798.5700000000002
68775529,07/02/2023,-113.79,1684.78
68775529,08/02/2023,-48.01,1636.77
68775529,09/02/2023,512.3,2149.0699999999997
68775529,09/02/2023,124.1,2273.17
68775529,10/02/2023,129.33,2402.5
68775529,11/02/2023,60.41,2462.91
68775529,12/02/2023,178.37,2641.2799999999997
68786878,31/01/2023,,512.06
68786878,03/02/2023,44.25,556.31
68786878,12/02/2023,79.12,635.43
68786878,12/02/2023,66.27,701.6999999999999
68786878,14/02/2023,-58.68,643.02
68793483,31/01/2023,,581.36
68793483,02/02/2023,-983.3,-401.93999999999994
68793483,03/02/2023,185.02,-216.91999999999993
68793483,03/02/2023,119.95,-96.96999999999993
68793483,08/02/2023,68.31,-28.659999999999926
68793483,08/02/2023,-110.48,-139.13999999999993
68793483,09/02/2023,140.49,1.3500000000000796
68793483,09/02/2023,-123.28,-121.92999999999992
68793483,10/02/2023,116.54,-5.389999999999915
68793483,11/02/2023,-626.6,-631.9899999999999
68793483,13/02/2023,99.13,-532.8599999999999
68793483,14/02/2023,130.44,-402.4199999999999
68793483,14/02/2023,-59.81,-462.2299999999999
68793483,14/02/2023,-131.83,-594.06
68798691,31/01/2023,,819.33
68798691,01/02/2023,-112.52,706.8100000000001
68798691,04/02/2023,-7.74,699.07
68798691,05/02/2023,-124.83,574.24
68798691,07/02/2023,123.45,697.69
68798691,07/02/2023,53.14,750.83
68798691,11/02/2023,-33.64,717.19
68798691,11/02/2023,-36.07,681.12
68798691,12/02/2023,-147.45,533.6700000000001
68798691,14/02/2023,71.41,605.08
68798691,14/02/2023,47.84,652.9200000000001
68798691,14/02/2023,-56.66,596.2600000000001
68800062,31/01/2023,,749.65
68800062,04/02/2023,165.76,915.41
68800062,04/02/2023,-668.8,246.61
68800062,05/02/2023,149.41,396.02
68800062,05/02/2023,-276.4,119.62
68800062,06/02/2023,-73.11,46.510000000000005
68800062,08/02/2023,164.35,210.86
68800062,08/02/2023,-116.37,94.48999999999998
68800062,09/02/2023,109.08,203.57
68800062,09/02/2023,100.36,303.92999999999995
68800062,13/02/2023,123.49,427.41999999999996
68836810,31/01/2023,,171.96
68836810,02/02/2023,-128.3,43.66
68836810,04/02/2023,89.11,132.76999999999998
68891568,31/01/2023,,844.06
68891568,02/02/2023,-58.4,785.66
68891568,03/02/2023,121.82,907.4799999999999
68891568,09/02/2023,-12.23,895.2499999999999
68891568,13/02/2023,38.13,933.3799999999999
68891568,13/02/2023,-30.41,902.9699999999999
68891568,13/02/2023,-77.23,825.7399999999999
68928221,31/01/2023,,502.06
68928221,02/02/2023,236.79,738.85
68928221,02/02/2023,-82.11,656.74
68928221,04/02/2023,-104.53,552.21
68928221,06/02/2023,171.3,723.51
68928221,08/02/2023,106.98,830.49
68928221,09/02/2023,46.08,876.5699999999999
68928221,11/02/2023,-70.39,806.18
68928221,12/02/2023,99.99,906.17
68928221,14/02/2023,150.77,1056.94
68928221,14/02/2023,63.0,1119.94
68962066,31/01/2023,,304.46
68962066,02/02/2023,699.5,1003.96
68962066,03/02/2023,-61.91,942.0500000000001
68962066,06/02/2023,197.61,1139.66
68962066,06/02/2023,-441.4,698.2600000000001
68962066,07/02/2023,141.05,839.3100000000002
68962066,08/02/2023,220.34,1059.65
68962066,09/02/2023,-103.84,955.8100000000002
68962066,09/02/2023,-125.24,830.5700000000002
68962066,12/02/2023,-36.02,794.5500000000001
68962066,12/02/2023,-45.23,749.3200000000002
68962066,14/02/2023,-75.98,673.3400000000001
68973836,31/01/2023,,634.67
68973836,01/02/2023,116.57,751.24
68973836,03/02/2023,955.4,1706.6399999999999
68973836,04/02/2023,-157.26,1549.3799999999999
68973836,05/02/2023,115.12,1664.5
68973836,05/02/2023,82.33,1746.83
68973836,10/02/2023,-62.01,1684.82
68973836,11/02/2023,1273.1,2957.92
68973836,13/02/2023,-72.81,2885.1099999999997
69008969,31/01/2023,,716.37
69008969,02/02/2023,-128.03,588.34
69008969,03/02/2023,-157.15,431.19
69008969,07/02/2023,-88.5,342.69
69008969,09/02/2023,58.69,401.38
69008969,10/02/2023,-143.62,257.76
69008969,11/02/2023,-60.41,197.35
69008969,14/02/2023,67.7,265.05
69090518,31/01/2023,,473.87
69090518,04/02/2023,-124.74,349.13
69090518,05/02/2023,-59.47,289.66
69090518,07/02/2023,127.45,417.11
69090518,09/02/2023,99.11,516.22
69090518,10/02/2023,20.05,536.27
69090518,13/02/2023,-157.27,379.0
69118170,31/01/2023,,109.35
69118170,01/02/2023,151.41,260.76
69118170,02/02/2023,-56.3,204.45999999999998
69118170,06/02/2023,-1161.4,-956.94
69118170,07/02/2023,86.51,-870.4300000000001
69118170,08/02/2023,110.44,-759.99
69118170,10/02/2023,-180.0,-939.99
69118170,11/02/2023,-130.27,-1070.26
69118170,14/02/2023,439.8,-630.46
69153577,31/01/2023,,402.52
69153577,05/02/2023,-112.45,290.07
69153577,07/02/2023,136.09,426.15999999999997
69302678,31/01/2023,,568.08
69302678,05/02/2023,62.49,630.57
69302678,10/02/2023,86.78,717.35
69302678,11/02/2023,213.76,931.11
69302678,12/02/2023,132.03,1063.14
69302678,13/02/2023,62.72,1125.8600000000001
69306093,31/01/2023,,189.46
69306093,05/02/2023,161.46,350.92
69306093,12/02/2023,-20.96,329.96000000000004
69307050,31/01/2023,,623.84
69307050,02/02/2023,-62.13,561.71
69307050,02/02/2023,-86.31,475.40000000000003
69307050,09/02/2023,60.37,535.77
69307050,09/02/2023,49.28,585.0500000000001
69307050,11/02/2023,73.66,658.71
69307050,12/02/2023,103.74,762.45
69307050,14/02/2023,122.88,885.33
69315008,31/01/2023,,923.08
69315008,01/02/2023,1052.6,1975.6799999999998
69315008,01/02/2023,-72.79,1902.8899999999999
69315008,02/02/2023,180.4,2083.29
69315008,05/02/2023,101.45,2184.74
69315008,07/02/2023,-85.76,2098.98
69315008,09/02/2023,-190.82,1908.1599999999999
69315008,12/02/2023,139.75,2047.9099999999999
69344396,31/01/2023,,304.19
69344396,02/02/2023,1190.9,1495.0900000000001
69344396,03/02/2023,97.42,1592.5100000000002
69344396,05/02/2023,-138.9,1453.6100000000001
69344396,06/02/2023,840.3,2293.91
69344396,10/02/2023,87.07,2380.98
69344396,11/02/2023,160.29,2541.27
69344396,11/02/2023,78.29,2619.56
69344396,12/02/2023,210.36,2829.92
69344396,12/02/2023,118.77,2948.69
69344396,12/02/2023,-44.88,2903.81
69344396,14/02/2023,98.11,3001.92
69362270,31/01/2023,,410.6
69362270,02/02/2023,-179.0,231.60000000000002
69362270,05/02/2023,-17.25,214.35000000000002
69362270,10/02/2023,26.55,240.90000000000003
69362270,11/02/2023,133.78,374.68000000000006
69362270,14/02/2023,-126.46,248.22000000000003
69446767,31/01/2023,,672.47
69446767,02/02/2023,83.44,755.9100000000001
69446767,06/02/2023,22.45,778.36
69446767,07/02/2023,101.82,880.1800000000001
69446767,09/02/2023,107.86,988.04
69446767,10/02/2023,-137.34,850.7
69446767,11/02/2023,-113.8,736.9
69446767,14/02/2023,-141.48,595.4200000000001
69447534,31/01/2023,,68.02
69447534,01/02/2023,-105.36,-37.34
69447534,03/02/2023,-121.82,-159.16
69447534,11/02/2023,-68.33,-227.49
69447534,12/02/2023,101.4,-126.08999999999999
69447534,13/02/2023,-38.04,-164.13
69468071,31/01/2023,,652.9
69468071,04/02/2023,-81.16,571.74
69468071,05/02/2023,111.92,683.66
69468071,06/02/2023,1791.9,2475.56
69468071,06/02/2023,137.34,2612.9
69468071,06/02/2023,-67.45,2545.45
69468071,07/02/2023,69.39,2614.84
69468071,08/02/2023,166.6,2781.44
69468071,09/02/2023,-36.71,2744.73
69468071,12/02/2023,-16.68,2728.0499999999997
69468071,13/02/2023,98.15,2826.2
69492532,31/01/2023,,581.23
69492532,04/02/2023,-119.25,461.98
69492532,11/02/2023,-84.22,377.76
69492532,12/02/2023,-200.04,177.72000000000003
69533742,31/01/2023,,812.2
69533742,01/02/2023,1397.4,2209.6000000000004
69533742,01/02/2023,-12.21,2197.3900000000003
69533742,01/02/2023,-96.51,2100.88
69533742,03/02/2023,-175.55,1925.3300000000002
69533742,04/02/2023,-82.56,1842.7700000000002
69533742,05/02/2023,112.73,1955.5000000000002
69533742,06/02/2023,129.51,2085.01
69533742,07/02/2023,-98.42,1986.5900000000001
69533742,11/02/2023,-65.15,1921.44
69533742,11/02/2023,-75.14,1846.3000000000002
69540137,31/01/2023,,351.36
69540137,02/02/2023,109.28,460.64
69540137,06/02/2023,473.7,934.34
69540137,06/02/2023,51.71,986.0500000000001
69540137,07/02/2023,173.55,1159.6000000000001
69540137,07/02/2023,141.99,1301.5900000000001
69540137,11/02/2023,32.04,1333.63
69540137,14/02/2023,1314.7,2648.33
69556322,31/01/2023,,785.03
69556322,01/02/2023,102.91,887.9399999999999
69556322,02/02/2023,24.87,912.81
69556322,03/02/2023,112.15,1024.96
69556322,03/02/2023,66.67,1091.6299999999999
69556322,06/02/2023,68.0,1159.6299999999999
69556322,12/02/2023,-125.48,1034.15
69556322,13/02/2023,-62.36,971.79
69556322,14/02/2023,1478.2,2449.99
69556322,14/02/2023,1145.9,3595.8900000000003
69561077,31/01/2023,,318.31
69561077,01/02/2023,125.38,443.69
69561077,03/02/2023,23.5,467.19
69561077,04/02/2023,37.8,504.99
69561077,05/02/2023,1917.1,2422.09
69561077,08/02/2023,-167.35,2254.74
69561077,09/02/2023,-56.02,2198.72
69561077,10/02/2023,75.83,2274.5499999999997
69561077,11/02/2023,132.56,2407.11
69561077,11/02/2023,-104.82,2302.29
69561077,12/02/2023,143.91,2446.2
69588947,31/01/2023,,732.72
69588947,08/02/2023,-66.6,666.12
69588947,09/02/2023,-97.55,568.57
69588947,09/02/2023,-114.45,454.12
69588947,10/02/2023,-8.85,445.27000000000004
69617552,31/01/2023,,853.9
69617552,03/02/2023,-89.23,764.67
69617552,06/02/2023,-96.79,667.88
69617552,08/02/2023,-61.4,606.48
69617552,09/02/2023,108.57,715.05
69617552,14/02/2023,-188.3,526.75
69647833,31/01/2023,,765.74
69647833,01/02/2023,84.44,850.1800000000001
69647833,03/02/2023,54.41,904.59
69647833,06/02/2023,-160.08,744.51
69647833,07/02/2023,170.65,915.16
69647833,07/02/2023,-136.97,778.19
69647833,13/02/2023,115.44,893.63
69647833,13/02/2023,-107.16,786.47
69648759,31/01/2023,,693.39
69648759,01/02/2023,80.92,774.31
69648759,10/02/2023,-155.67,618.64
69648759,13/02/2023,-1503.2,-884.5600000000001
69648759,14/02/2023,163.34,-721.22
69648759,14/02/2023,-126.03,-847.25
69664627,31/01/2023,,897.76
69664627,01/02/2023,-130.78,766.98
69664627,07/02/2023,218.78,985.76
69664627,10/02/2023,28.25,1014.01
69664627,12/02/2023,1482.9,2496.91
69664627,13/02/2023,-163.99,2332.92
69665438,31/01/2023,,417.78
69665438,01/02/2023,-99.56,318.21999999999997
69665438,01/02/2023,-158.57,159.64999999999998
69665438,05/02/2023,-75.94,83.70999999999998
69683385,31/01/2023,,519.63
69683385,04/02/2023,54.37,574.0
69683385,07/02/2023,-102.9,471.1
69730266,31/01/2023,,732.61
69730266,04/02/2023,-95.37,637.24
69730266,07/02/2023,-105.66,531.58
69730266,09/02/2023,102.69,634.27
69730266,12/02/2023,-79.75,554.52
69796371,31/01/2023,,649.23
69796371,02/02/2023,-94.57,554.6600000000001
69796371,03/02/2023,60.17,614.83
69796371,04/02/2023,1412.5,2027.33
69796371,05/02/2023,109.76,2137.09
69796371,06/02/2023,182.28,2319.37
69796371,11/02/2023,166.3,2485.67
69796371,14/02/2023,2002.7,4488.37
69806946,31/01/2023,,971.49
69806946,07/02/2023,87.82,1059.31
69806946,08/02/2023,-183.05,876.26
69939682,31/01/2023,,854.18
69939682,01/02/2023,94.91,949.0899999999999
69939682,01/02/2023,-120.13,828.9599999999999
69939682,08/02/2023,-5.73,823.2299999999999
69939682,09/02/2023,-143.77,679.4599999999999
69939682,11/02/2023,-214.9,464.55999999999995
70010970,31/01/2023,,114.23
70010970,06/02/2023,-128.7,-14.469999999999985
70010970,08/02/2023,-69.02,-83.48999999999998
70010970,11/02/2023,-181.68,-265.16999999999996
70013367,31/01/2023,,38.86
70013367,04/02/2023,-70.76,-31.900000000000006
70013367,06/02/2023,660.3,628.4
70013367,06/02/2023,138.83,767.23
70013367,09/02/2023,140.35,907.5799999999999
70013367,13/02/2023,-96.06,811.52
70034563,31/01/2023,,723.18
70034563,01/02/2023,149.8,872.98
70034563,02/02/2023,-122.42,750.56
70034563,04/02/2023,96.09,846.65
70034563,05/02/2023,-137.98,708.67
70034563,13/02/2023,-182.14,526.53
70049609,31/01/2023,,226.63
70049609,07/02/2023,89.73,316.36
70049609,07/02/2023,75.13,391.49
70049609,10/02/2023,-84.17,307.32
70049609,10/02/2023,-109.89,197.43
70049609,13/02/2023,101.66,299.09
70049609,14/02/2023,103.89,402.98
70123664,31/01/2023,,483.12
70123664,01/02/2023,-122.51,360.61
70123664,02/02/2023,-127.28,233.32999999999998
70123664,03/02/2023,-114.58,118.75
70123664,04/02/2023,24.31,143.06
70123664,08/02/2023,-209.01,-65.94999999999999
70129567,31/01/2023,,886.92
70129567,01/02/2023,52.32,939.24
70129567,03/02/2023,-98.67,840.5699999999999
70129567,04/02/2023,-133.05,707.52
70129567,06/02/2023,100.59,808.1099999999999
70129567,08/02/2023,-149.26,658.8499999999999
70129567,09/02/2023,175.39,834.24
70129567,10/02/2023,65.29,899.53
70129567,10/02/2023,-47.22,852.31
70129567,11/02/2023,214.9,1067.21
70129567,11/02/2023,-125.65,941.56
70129567,12/02/2023,35.17,976.73
70163139,31/01/2023,,674.14
70163139,01/02/2023,85.94,760.0799999999999
70163139,05/02/2023,116.16,876.24
70163139,06/02/2023,-31.91,844.3299999999999
70163139,07/02/2023,121.65,965.98
70163139,11/02/2023,158.58,1124.56
70163139,11/02/2023,100.86,1225.42
70163139,11/02/2023,55.33,1280.75
70163139,12/02/2023,170.4,1451.15
70163139,12/02/2023,64.23,1515.38
70163139,14/02/2023,48.39,1563.77
70185446,31/01/2023,,863.26
70185446,08/02/2023,191.64,1054.9
70185446,09/02/2023,97.29,1152.19
70185446,11/02/2023,96.92,1249.11
70214700,31/01/2023,,152.79
70214700,01/02/2023,-1255.3,-1102.51
70214700,02/02/2023,-84.59,-1187.1
70214700,06/02/2023,-1498.3,-2685.3999999999996
70214700,07/02/2023,-89.15,-2774.5499999999997
70214700,12/02/2023,127.0,-2647.5499999999997
70214700,14/02/2023,33.09,-2614.46
70214700,14/02/2023,-102.53,-2716.99
70217229,31/01/2023,,705.69
70217229,02/02/2023,190.9,896.59
70217229,02/02/2023,167.22,1063.81
70217229,03/02/2023,-127.58,936.23
70217229,06/02/2023,59.52,995.7500000000001
70217229,12/02/2023,129.61,1125.3600000000001
70217229,12/02/2023,-491.6,633.76
70217229,14/02/2023,-46.61,587.1500000000001
70221848,31/01/2023,,550.83
70221848,01/02/2023,69.91,620.74
70221848,03/02/2023,175.55,796.2900000000001
70221848,05/02/2023,23.13,819.4200000000001
70221848,08/02/2023,149.26,968.6800000000001
70231750,31/01/2023,,749.6
70231750,02/02/2023,187.19,936.79
70231750,03/02/2023,-2128.4,-1191.6100000000001
70231750,04/02/2023,-148.06,-1339.67
70231750,04/02/2023,-1618.2,-2957.87
70231750,09/02/2023,112.38,-2845.4900000000002
70231750,10/02/2023,-192.08,-3037.57
70231750,11/02/2023,100.04,-2937.53
70331285,31/01/2023,,537.34
70331285,08/02/2023,-74.39,462.95000000000005
70331285,09/02/2023,121.13,584.08
70331285,10/02/2023,56.59,640.6700000000001
70331285,14/02/2023,-105.11,535.5600000000001
70351135,31/01/2023,,169.6
70351135,01/02/2023,3.89,173.48999999999998
70351135,05/02/2023,128.72,302.21
70351135,13/02/2023,-167.52,134.68999999999997
70375931,31/01/2023,,980.21
70375931,05/02/2023,92.89,1073.1000000000001
70375931,07/02/2023,-152.96,920.1400000000001
70375931,11/02/2023,87.16,1007.3000000000001
70375931,13/02/2023,159.46,1166.76
70384410,31/01/2023,,718.99
70384410,04/02/2023,122.2,841.19
70384410,04/02/2023,-129.64,711.55
70384410,09/02/2023,969.7,1681.25
70384410,11/02/2023,-55.38,1625.87
70384410,13/02/2023,153.4,1779.27
70385129,31/01/2023,,252.45
70385129,01/02/2023,121.46,373.90999999999997
70385129,08/02/2023,25.37,399.28
70385129,10/02/2023,134.99,534.27
70409852,31/01/2023,,662.8
70409852,04/02/2023,-81.35,581.4499999999999
70409852,06/02/2023,137.14,718.5899999999999
70409852,09/02/2023,-67.33,651.26
70409852,10/02/2023,25.41,676.67
70409852,11/02/2023,102.16,778.8299999999999
70469258,31/01/2023,,868.53
70469258,04/02/2023,-71.39,797.14
70469258,05/02/2023,2112.8,2909.94
70469258,08/02/2023,80.16,2990.1
70469258,09/02/2023,-171.71,2818.39
70469258,10/02/2023,-1575.6,1242.7900000000002
70469258,14/02/2023,-47.11,1195.6800000000003
70505401,31/01/2023,,138.85
70505401,04/02/2023,113.98,252.82999999999998
70505401,04/02/2023,-113.98,138.85
70505401,11/02/2023,123.81,262.65999999999997
70505401,11/02/2023,-58.36,204.3
70505401,14/02/2023,-884.5,-680.2
70554021,31/01/2023,,44.26
70554021,05/02/2023,129.49,173.75
70554021,06/02/2023,-116.65,57.099999999999994
70554021,10/02/2023,-1188.3,-1131.2
70554021,11/02/2023,126.09,-1005.11
70554021,11/02/2023,78.25,-926.86
70554021,12/02/2023,63.69,-863.1700000000001
70567557,31/01/2023,,984.3
70567557,07/02/2023,41.64,1025.94
70567557,08/02/2023,185.22,1211.1599999999999
70567557,08/02/2023,-87.73,1123.43
70567557,13/02/2023,129.32,1252.75
70567557,14/02/2023,113.78,1366.53
70571486,31/01/2023,,573.26
70571486,01/02/2023,-52.17,521.09
70571486,07/02/2023,-639.3,-118.20999999999992
70571486,10/02/2023,-39.45,-157.6599999999999
70571486,11/02/2023,115.25,-42.409999999999926
70571486,12/02/2023,47.25,4.8400000000000745
70624878,31/01/2023,,328.5
70624878,01/02/2023,-158.51,169.99
70624878,03/02/2023,825.8,995.79
70624878,05/02/2023,190.77,1186.56
70624878,08/02/2023,190.88,1377.44
70624878,08/02/2023,-94.34,1283.1
70624878,08/02/2023,-1051.3,231.79999999999995
70643766,31/01/2023,,143.86
70643766,03/02/2023,-192.08,-48.22
70643766,07/02/2023,-140.14,-188.35999999999999
70652524,31/01/2023,,342.86
70652524,05/02/2023,81.18,424.04
70652524,05/02/2023,76.23,500.27000000000004
70652524,07/02/2023,61.37,561.64
70652524,11/02/2023,89.98,651.62
70652524,12/02/2023,104.46,756.08
70665892,31/01/2023,,856.22
70665892,01/02/2023,-165.66,690.5600000000001
70665892,04/02/2023,45.03,735.59
70665892,08/02/2023,113.92,849.51
70665892,09/02/2023,1365.7,2215.21
70665892,11/02/2023,-43.12,2172.09
70665892,12/02/2023,245.7,2417.79
70719064,31/01/2023,,752.97
70719064,02/02/2023,1805.5,2558.4700000000003
70719064,02/02/2023,-198.45,2360.02
70719064,04/02/2023,-163.96,2196.06
70719064,06/02/2023,965.2,3161.26
70719064,08/02/2023,145.4,3306.6600000000003
70719064,11/02/2023,40.22,3346.88
70749706,31/01/2023,,963.82
70749706,01/02/2023,-119.88,843.94
70749706,04/02/2023,-122.23,721.71
70749706,07/02/2023,-137.51,584.2
70749706,09/02/2023,-150.23,433.97
70749706,10/02/2023,58.75,492.72
70749706,12/02/2023,-91.93,400.7900000000001
70905083,31/01/2023,,623.65
70905083,02/02/2023,131.53,755.18
70905083,02/02/2023,119.89,875.0699999999999
70905083,03/02/2023,133.41,1008.48
70905083,07/02/2023,103.35,1111.83
70920653,31/01/2023,,577.7
70920653,02/02/2023,-88.8,488.90000000000003
70920653,04/02/2023,-97.81,391.09000000000003
70920653,10/02/2023,123.77,514.86
70925461,31/01/2023,,260.33
70925461,01/02/2023,-66.84,193.48999999999998
70925461,03/02/2023,97.5,290.99
70925461,06/02/2023,134.68,425.66999999999996
70925461,06/02/2023,46.16,471.83
70925461,06/02/2023,-126.83,345.0
70925461,07/02/2023,-154.41,190.58999999999997
70925461,08/02/2023,121.98,312.57
70925461,08/02/2023,-103.89,208.67999999999998
70925461,09/02/2023,201.62,410.29999999999995
70925461,09/02/2023,-287.8,122.5
70925461,12/02/2023,-100.25,22.25
70925461,12/02/2023,-907.1,-884.85
70954264,31/01/2023,,331.51
70954264,01/02/2023,-142.91,188.6
70954264,02/02/2023,-81.2,107.39999999999999
70954264,08/02/2023,-35.81,71.58999999999999
70954264,10/02/2023,113.81,185.39999999999998
70954264,10/02/2023,-64.46,120.94
70954264,10/02/2023,-90.32,30.620000000000005
70954264,12/02/2023,-76.6,-45.97999999999999
70954264,12/02/2023,-82.91,-128.89
70954264,13/02/2023,-101.48,-230.37
70989002,31/01/2023,,220.06
70989002,03/02/2023,-134.37,85.69
70989002,04/02/2023,134.48,220.17
70989002,04/02/2023,-111.19,108.97999999999999
70989002,05/02/2023,298.3,407.28
70989002,05/02/2023,102.18,509.46000000000004
70989002,06/02/2023,116.65,626.11
70989002,12/02/2023,-87.73,538.38
70989002,13/02/2023,156.04,694.4200000000001
71014167,31/01/2023,,654.16
71014167,01/02/2023,58.05,712.2099999999999
71014167,02/02/2023,72.72,784.93
71014167,04/02/2023,-118.37,666.56
71014167,06/02/2023,-46.33,620.23
71014167,07/02/2023,122.53,742.76
71014167,12/02/2023,-84.75,658.01
71014167,14/02/2023,80.98,738.99
71045135,31/01/2023,,98.76
71045135,11/02/2023,-43.47,55.290000000000006
71045135,11/02/2023,-989.3,-934.01
71045135,12/02/2023,54.92,-879.09
71045135,14/02/2023,-133.71,-1012.8
71051904,31/01/2023,,48.92
71051904,02/02/2023,-93.84,-44.92
71051904,06/02/2023,102.1,57.17999999999999
71051904,08/02/2023,117.36,174.54
71051904,13/02/2023,-2.26,172.28
71082437,31/01/2023,,717.98
71082437,04/02/2023,111.19,829.1700000000001
71082437,06/02/2023,-51.53,777.64
71082437,11/02/2023,111.11,888.75
71082437,11/02/2023,-122.42,766.33
71082437,12/02/2023,96.6,862.9300000000001
71082437,13/02/2023,-76.11,786.82
71135606,31/01/2023,,728.32
71135606,02/02/2023,-99.44,628.8800000000001
71135606,02/02/2023,-104.5,524.3800000000001
71135606,04/02/2023,-47.16,477.22
71135606,08/02/2023,-65.06,412.1600000000001
71135606,09/02/2023,159.05,571.21
71135606,09/02/2023,66.83,638.0400000000001
71135606,12/02/2023,-26.59,611.45
71135606,12/02/2023,-116.83,494.62000000000006
71135606,13/02/2023,73.19,567.8100000000001
71137421,31/01/2023,,65.44
71137421,01/02/2023,61.08,126.52
71137421,02/02/2023,109.29,235.81
71137421,02/02/2023,-27.44,208.37
71137421,07/02/2023,53.78,262.15
71137421,07/02/2023,-79.99,182.16000000000003
71137421,07/02/2023,-949.2,-767.04
71137421,08/02/2023,190.12,-576.92
71137421,14/02/2023,-123.69,-700.6099999999999
71161073,31/01/2023,,861.98
71161073,01/02/2023,-99.52,762.46
71161073,02/02/2023,-94.2,668.26
71161073,09/02/2023,191.29,859.55
71183710,31/01/2023,,989.68
71183710,02/02/2023,-77.54,912.14
71183710,03/02/2023,5.31,917.4499999999999
71183710,03/02/2023,-65.8,851.65
71183710,04/02/2023,-143.95,707.6999999999999
71183710,06/02/2023,-68.0,639.6999999999999
71183710,07/02/2023,-86.52,553.18
71183710,08/02/2023,68.68,621.86
71183710,13/02/2023,-77.91,543.9499999999999
71213535,31/01/2023,,686.81
71213535,07/02/2023,83.34,770.15
71213535,08/02/2023,218.9,989.05
71213535,08/02/2023,136.73,1125.78
71247681,31/01/2023,,955.43
71247681,03/02/2023,-114.47,840.9599999999999
71247681,11/02/2023,-130.08,710.8799999999999
71247681,14/02/2023,-93.52,617.3599999999999
71264941,31/01/2023,,195.49
71264941,01/02/2023,170.89,366.38
71264941,01/02/2023,160.38,526.76
71264941,01/02/2023,92.64,619.4
71264941,06/02/2023,-33.32,586.08
71264941,10/02/2023,19.72,605.8
71264941,11/02/2023,196.49,802.29
71264941,11/02/2023,101.84,904.13
71264941,11/02/2023,-6.42,897.71
71264941,11/02/2023,-222.05,675.66
71266283,31/01/2023,,496.77
71266283,04/02/2023,1218.0,1714.77
71266283,05/02/2023,134.86,1849.63
71266283,07/02/2023,-151.33,1698.3
71266283,09/02/2023,105.21,1803.51
71266283,09/02/2023,-61.15,1742.36
71266283,13/02/2023,138.97,1881.33
71266283,13/02/2023,18.04,1899.37
71266283,13/02/2023,-223.88,1675.49
71280775,31/01/2023,,427.44
71280775,03/02/2023,65.8,493.24
71280775,03/02/2023,-124.88,368.36
71280775,04/02/2023,148.06,516.4200000000001
71280775,05/02/2023,-114.23,402.19
71280775,06/02/2023,127.87,530.0600000000001
71280775,06/02/2023,91.85,621.91
71280775,06/02/2023,-1176.9,-554.9900000000001
71280775,09/02/2023,112.69,-442.3000000000001
71293250,31/01/2023,,686.0
71293250,04/02/2023,-5.86,680.14
71293250,06/02/2023,120.15,800.29
71293250,08/02/2023,90.09,890.38
71293250,11/02/2023,-99.36,791.02
71332337,31/01/2023,,661.23
71332337,07/02/2023,-1434.3,-773.0699999999999
71332337,08/02/2023,113.65,-659.42
71332337,08/02/2023,-195.95,-855.3699999999999
71332337,10/02/2023,88.33,-767.04
71332337,12/02/2023,120.12,-646.92
71332337,14/02/2023,-95.87,-742.79
71381278,31/01/2023,,592.79
71381278,03/02/2023,-66.67,526.12
71381278,09/02/2023,82.1,608.2199999999999
71381278,11/02/2023,1243.0,1851.2199999999998
71381278,11/02/2023,-190.18,1661.0399999999997
71381278,12/02/2023,-245.7,1415.3399999999997
71381278,14/02/2023,125.94,1541.2799999999997
71383376,31/01/2023,,448.26
71383376,01/02/2023,-170.96,277.29999999999995
71383376,03/02/2023,1619.6,1896.8999999999999
71383376,04/02/2023,-884.9,1011.9999999999999
71383376,07/02/2023,92.7,1104.6999999999998
71383376,09/02/2023,-105.71,998.9899999999999
71383376,10/02/2023,94.14,1093.1299999999999
71383376,11/02/2023,39.58,1132.7099999999998
71394875,31/01/2023,,778.77
71394875,01/02/2023,-112.34,666.43
71394875,03/02/2023,165.51,831.9399999999999
71394875,04/02/2023,40.15,872.0899999999999
71394875,05/02/2023,68.75,940.8399999999999
71394875,06/02/2023,-144.68,796.16
71394875,13/02/2023,158.03,954.1899999999999
71394875,14/02/2023,-67.36,886.8299999999999
71444662,31/01/2023,,276.78
71444662,01/02/2023,-101.08,175.7
71444662,02/02/2023,-116.0,59.699999999999974
71444662,04/02/2023,-1131.3,-1071.6
71444662,07/02/2023,87.19,-984.4099999999999
71444662,12/02/2023,-67.65,-1052.06
71444662,13/02/2023,181.51,-870.55
71444662,14/02/2023,-124.76,-995.31
71469803,31/01/2023,,14.79
71469803,05/02/2023,151.15,165.94
71469803,05/02/2023,-118.02,47.92
71469803,11/02/2023,-191.93,-144.01
71469803,14/02/2023,141.49,-2.519999999999982
71469803,14/02/2023,-64.89,-67.40999999999998
71536854,31/01/2023,,42.99
71536854,06/02/2023,-93.96,-50.96999999999999
71536854,10/02/2023,-181.0,-231.97
71536854,11/02/2023,142.47,-89.5
71536854,11/02/2023,-112.1,-201.6
71562080,31/01/2023,,352.05
71562080,04/02/2023,63.81,415.86
71562080,09/02/2023,101.51,517.37
71562080,14/02/2023,-135.72,381.65000000000003
71594658,31/01/2023,,392.66
71594658,07/02/2023,67.95,460.61
71594658,10/02/2023,-93.37,367.24
71594658,11/02/2023,36.36,403.6
71594658,11/02/2023,-102.91,300.69000000000005
71594658,12/02/2023,108.19,408.88
71594658,12/02/2023,81.87,490.75
71594658,14/02/2023,-7.26,483.49
71643841,31/01/2023,,232.5
71643841,03/02/2023,161.37,393.87
71643841,06/02/2023,-113.63,280.24
71643841,12/02/2023,71.39,351.63
71643841,13/02/2023,125.16,476.79
71643841,14/02/2023,-1308.6,-831.81
71675127,31/01/2023,,353.48
71675127,02/02/2023,143.95,497.43
71675127,07/02/2023,-171.53,325.9
71675127,11/02/2023,82.38,408.28
71718483,31/01/2023,,747.34
71718483,01/02/2023,1089.6,1836.94
71718483,02/02/2023,1193.3,3030.24
71718483,02/02/2023,94.57,3124.81
71718483,02/02/2023,-100.61,3024.2
71718483,02/02/2023,-112.35,2911.85
71718483,09/02/2023,42.25,2954.1
71718483,12/02/2023,90.33,3044.43
71718483,13/02/2023,167.52,3211.95
71791483,31/01/2023,,873.44
71791483,03/02/2023,99.93,973.3700000000001
71791483,04/02/2023,-34.64,938.73
71791483,12/02/2023,-86.27,852.46
71792376,31/01/2023,,4.39
71792376,02/02/2023,-50.71,-46.32
71792376,03/02/2023,-76.87,-123.19
71792376,07/02/2023,74.77,-48.42
71792376,09/02/2023,-68.62,-117.04
71792376,09/02/2023,-160.1,-277.14
71792376,11/02/2023,52.48,-224.66000000000003
71792376,11/02/2023,-84.08,-308.74
71792376,14/02/2023,90.48,-218.26
71825742,31/01/2023,,665.75
71825742,02/02/2023,198.28,864.03
71825742,08/02/2023,-968.8,-104.76999999999998
71852263,31/01/2023,,676.77
71852263,10/02/2023,42.14,718.91
71852263,14/02/2023,163.23,882.14
71868471,31/01/2023,,474.32
71868471,05/02/2023,-1315.1,-840.78
71868471,07/02/2023,189.62,-651.16
71868471,08/02/2023,196.25,-454.90999999999997
71868471,11/02/2023,-121.25,-576.16
71868471,12/02/2023,7.59,-568.5699999999999
71913103,31/01/2023,,5.42
71913103,02/02/2023,117.49,122.91
71913103,06/02/2023,121.13,244.04
71913103,07/02/2023,127.37,371.40999999999997
71913103,08/02/2023,40.97,412.38
71934515,31/01/2023,,340.99
71934515,05/02/2023,59.47,400.46000000000004
71934515,06/02/2023,-1011.5,-611.04
71934515,08/02/2023,150.55,-460.48999999999995
71934515,08/02/2023,-358.9,-819.3899999999999
71934515,09/02/2023,-82.1,-901.4899999999999
71939863,31/01/2023,,116.31
71939863,01/02/2023,136.22,252.53
71939863,05/02/2023,110.09,362.62
71939863,06/02/2023,995.2,1357.8200000000002
71939863,11/02/2023,102.84,1460.66
72008772,31/01/2023,,725.22
72008772,01/02/2023,-110.9,614.32
72008772,03/02/2023,1791.6,2405.92
72008772,04/02/2023,-112.22,2293.7000000000003
72008772,06/02/2023,95.71,2389.41
72008772,06/02/2023,60.85,2450.26
72008772,09/02/2023,83.64,2533.9
72008772,09/02/2023,-175.39,2358.51
72008772,13/02/2023,81.86,2440.37
72008772,14/02/2023,-113.47,2326.9
72050477,31/01/2023,,95.87
72050477,03/02/2023,-106.6,-10.72999999999999
72050477,08/02/2023,156.86,146.13000000000002
72055977,31/01/2023,,172.73
72055977,09/02/2023,624.2,796.9300000000001
72055977,09/02/2023,108.23,905.1600000000001
72055977,10/02/2023,-178.01,727.1500000000001
72055977,11/02/2023,78.66,805.8100000000001
72087700,31/01/2023,,359.55
72087700,06/02/2023,160.25,519.8
72087700,07/02/2023,229.29,749.09
72087700,09/02/2023,25.58,774.67
72087700,12/02/2023,-109.9,664.77
72087700,13/02/2023,125.92,790.69
72120467,31/01/2023,,340.15
72120467,04/02/2023,-75.25,264.9
72120467,11/02/2023,-125.55,139.34999999999997
72164482,31/01/2023,,535.39
72164482,02/02/2023,-83.79,451.59999999999997
72164482,09/02/2023,-951.0,-499.40000000000003
72164482,10/02/2023,-89.11,-588.51
72164482,12/02/2023,643.6,55.09000000000003
72176895,31/01/2023,,109.78
72176895,03/02/2023,64.91,174.69
72176895,09/02/2023,160.54,335.23
72176895,09/02/2023,-38.14,297.09
72176895,13/02/2023,150.38,447.46999999999997
72176895,13/02/2023,-837.4,-389.93
72208029,31/01/2023,,11.37
72208029,01/02/2023,0.5,11.87
72208029,02/02/2023,-181.62,-169.75
72208029,05/02/2023,-139.1,-308.85
72208029,06/02/2023,66.16,-242.69
72208029,06/02/2023,-1024.2,-1266.89
72208029,09/02/2023,-140.11,-1407.0
72208029,09/02/2023,-173.88,-1580.88
72208029,10/02/2023,-80.36,-1661.24
72208029,13/02/2023,-102.22,-1763.46
72208029,14/02/2023,-141.62,-1905.0800000000002
72230395,31/01/2023,,773.55
72230395,03/02/2023,155.02,928.5699999999999
72230395,03/02/2023,-130.74,797.8299999999999
72230395,09/02/2023,-53.95,743.88
72230395,11/02/2023,-86.69,657.1899999999999
72230395,13/02/2023,-518.3,138.89
72230395,14/02/2023,-597.7,-458.81000000000006
72268811,31/01/2023,,694.68
72268811,02/02/2023,-62.04,632.64
72268811,02/02/2023,-151.37,481.27
72268811,03/02/2023,133.85,615.1199999999999
72268811,08/02/2023,70.08,685.1999999999999
72268811,09/02/2023,-134.21,550.99
72268811,11/02/2023,132.94,683.93
72268811,12/02/2023,84.13,768.06
72289791,31/01/2023,,502.96
72289791,02/02/2023,130.94,633.9
72289791,07/02/2023,185.39,819.29
72289791,07/02/2023,11.99,831.28
72289791,10/02/2023,-1046.8,-215.51999999999998
72289791,11/02/2023,-63.8,-279.32
72292735,31/01/2023,,723.43
72292735,01/02/2023,-50.95,672.4799999999999
72292735,01/02/2023,-153.65,518.8299999999999
72292735,04/02/2023,-122.2,396.62999999999994
72292735,09/02/2023,128.31,524.9399999999999
72292735,09/02/2023,-54.57,470.36999999999995
72292735,10/02/2023,-88.62,381.74999999999994
72292735,12/02/2023,19.98,401.72999999999996
72292735,14/02/2023,54.0,455.72999999999996
72309641,31/01/2023,,386.61
72309641,05/02/2023,179.34,565.95
72309641,06/02/2023,-96.4,469.55
72309641,07/02/2023,-0.83,468.72
72309641,11/02/2023,-2.2,466.52000000000004
72309641,13/02/2023,-138.24,328.28
72309641,14/02/2023,-1323.7,-995.4200000000001
72323206,31/01/2023,,372.97
72323206,06/02/2023,71.4,444.37
72323206,09/02/2023,-135.68,308.69000000000005
72323206,11/02/2023,-126.09,182.60000000000002
72323206,13/02/2023,132.93,315.53000000000003
72354216,31/01/2023,,852.23
72354216,02/02/2023,118.23,970.46
72354216,05/02/2023,-81.6,888.86
72354216,07/02/2023,-145.86,743.0
72354216,10/02/2023,-62.94,680.06
72354216,11/02/2023,-165.48,514.58
72354216,12/02/2023,742.0,1256.58
72354216,13/02/2023,1127.3,2383.88
72354216,13/02/2023,-147.05,2236.83
72354216,14/02/2023,-2010.0,226.83000000000015
72446758,31/01/2023,,893.64
72446758,08/02/2023,67.6,961.24
72446758,08/02/2023,-153.92,807.3199999999999
72446758,08/02/2023,-196.25,611.0699999999999
72446758,12/02/2023,-58.82,552.25
72446758,14/02/2023,-141.49,410.76
72450129,31/01/2023,,905.61
72450129,01/02/2023,-208.23,697.38
72450129,02/02/2023,90.38,787.76
72450129,03/02/2023,130.7,918.46
72450129,03/02/2023,98.53,1016.99
72450129,10/02/2023,156.28,1173.27
72450129,14/02/2023,112.23,1285.5
72466733,31/01/2023,,580.24
72466733,03/02/2023,474.7,1054.94
72466733,08/02/2023,-61.29,993.65
72466733,09/02/2023,138.48,1132.13
72466733,10/02/2023,-78.83,1053.3
72526383,31/01/2023,,885.37
72526383,07/02/2023,853.6,1738.97
72526383,08/02/2023,93.74,1832.71
72526383,08/02/2023,-13.55,1819.16
72526383,08/02/2023,-166.6,1652.56
72526383,12/02/2023,895.2,2547.76
72526383,13/02/2023,-93.82,2453.94
72558185,31/01/2023,,793.9
72558185,08/02/2023,77.8,871.6999999999999
72600465,31/01/2023,,595.44
72600465,03/02/2023,108.6,704.0400000000001
72600465,09/02/2023,-197.63,506.4100000000001
72623919,31/01/2023,,610.63
72623919,03/02/2023,119.56,730.19
72623919,07/02/2023,644.8,1374.99
72623919,07/02/2023,-65.6,1309.39
72623919,08/02/2023,-72.15,1237.24
72623919,12/02/2023,-803.9,433.34000000000003
72623919,13/02/2023,98.45,531.7900000000001
72627756,31/01/2023,,473.02
72627756,02/02/2023,63.42,536.4399999999999
72627756,04/02/2023,44.62,581.06
72627756,05/02/2023,94.48,675.54
72627756,05/02/2023,-98.07,577.47
72627756,12/02/2023,49.53,627.0
72627756,12/02/2023,-54.92,572.08
72716288,31/01/2023,,167.69
72716288,05/02/2023,-118.55,49.14
72716288,07/02/2023,1282.4,1331.5400000000002
72716288,09/02/2023,-36.48,1295.0600000000002
72771982,31/01/2023,,501.76
72771982,02/02/2023,-95.09,406.66999999999996
72771982,05/02/2023,-74.98,331.69
72771982,06/02/2023,-94.32,237.37
72771982,12/02/2023,81.63,319.0
72771982,13/02/2023,-86.2,232.79999999999998
72784766,31/01/2023,,181.69
72784766,01/02/2023,161.31,343.0
72784766,01/02/2023,-142.14,200.86
72784766,09/02/2023,1288.6,1489.46
72784766,11/02/2023,482.1,1971.56
72784766,11/02/2023,131.61,2103.17
72784766,14/02/2023,170.29,2273.46
72799297,31/01/2023,,614.69
72799297,04/02/2023,-45.45,569.24
72809561,31/01/2023,,270.68
72809561,02/02/2023,156.52,427.20000000000005
72809561,02/02/2023,-62.51,364.69
72809561,03/02/2023,111.35,476.04
72809561,09/02/2023,-69.0,407.04
72809561,10/02/2023,-151.75,255.29000000000002
72809943,31/01/2023,,870.72
72809943,02/02/2023,71.36,942.08
72809943,02/02/2023,-91.97,850.11
72809943,03/02/2023,-111.24,738.87
72809943,06/02/2023,-57.47,681.4000000000001
72809943,06/02/2023,-96.19,585.21
72809943,07/02/2023,-113.01,472.20000000000005
72809943,07/02/2023,-125.73,346.47
72809943,08/02/2023,-93.19,253.28000000000003
72809943,09/02/2023,-118.62,134.66000000000003
72809943,12/02/2023,99.3,233.96000000000004
72809943,14/02/2023,1297.2,1531.16
72809943,14/02/2023,116.09,1647.25
72812647,31/01/2023,,351.84
72812647,01/02/2023,-134.43,217.40999999999997
72812647,02/02/2023,-73.15,144.25999999999996
72812647,06/02/2023,20.39,164.64999999999998
72812647,07/02/2023,74.77,239.41999999999996
72812647,08/02/2023,209.9,449.31999999999994
72812647,11/02/2023,-159.08,290.23999999999995
72856610,31/01/2023,,576.08
72856610,01/02/2023,103.99,680.07
72856610,02/02/2023,107.47,787.5400000000001
72856610,05/02/2023,8.72,796.26
72856610,05/02/2023,-76.11,720.1500000000001
72856610,06/02/2023,140.03,860.1800000000001
72856610,08/02/2023,114.69,974.87
72856610,13/02/2023,-74.01,900.86
72894034,31/01/2023,,74.8
72894034,01/02/2023,164.31,239.11
72894034,04/02/2023,79.24,318.35
72894034,12/02/2023,-57.16,261.19
72925782,31/01/2023,,351.64
72925782,02/02/2023,121.58,473.21999999999997
72925782,04/02/2023,761.9,1235.12
72925782,05/02/2023,-12.23,1222.89
72925782,09/02/2023,-99.11,1123.78
72925782,11/02/2023,-149.84,973.94
72934756,31/01/2023,,829.55
72934756,01/02/2023,856.5,1686.05
72934756,01/02/2023,12.83,1698.8799999999999
72934756,01/02/2023,-127.57,1571.31
72934756,02/02/2023,-94.69,1476.62
72934756,03/02/2023,28.47,1505.09
72934756,04/02/2023,-1080.2,424.8899999999999
72934756,07/02/2023,66.78,491.66999999999985
72934756,14/02/2023,-63.85,427.8199999999999
72971287,31/01/2023,,890.23
72971287,01/02/2023,67.52,957.75
72971287,01/02/2023,-65.26,892.49
72971287,02/02/2023,122.23,1014.72
72971287,10/02/2023,-1038.8,-24.079999999999927
72971287,11/02/2023,-87.08,-111.15999999999993
72971287,13/02/2023,109.33,-1.8299999999999272
72986897,31/01/2023,,603.23
72986897,04/02/2023,-42.74,560.49
72986897,07/02/2023,-182.69,377.8
72986897,08/02/2023,72.05,449.85
72986897,09/02/2023,69.41,519.26
72986897,12/02/2023,1682.4,2201.66
72986897,14/02/2023,86.1,2287.76
72995062,31/01/2023,,506.73
72995062,01/02/2023,321.2,827.9300000000001
72995062,03/02/2023,121.77,949.7
72995062,03/02/2023,-105.23,844.47
72995062,05/02/2023,-175.88,668.59
72995062,08/02/2023,173.81,842.4
72995062,09/02/2023,-73.82,768.58
72995062,14/02/2023,321.9,1090.48
72996601,31/01/2023,,730.27
72996601,03/02/2023,-50.42,679.85
72996601,03/02/2023,-201.14,478.71
72996601,04/02/2023,-84.53,394.17999999999995
72996601,07/02/2023,78.2,472.38
72996601,08/02/2023,157.52,629.9
72996601,10/02/2023,93.87,723.77
72996601,10/02/2023,-989.8,-266.03
72996601,11/02/2023,-113.52,-379.54999999999995
72996601,13/02/2023,-106.08,-485.63
73009461,31/01/2023,,938.52
73009461,04/02/2023,-89.19,849.3299999999999
73009461,09/02/2023,125.67,975.0
73009461,10/02/2023,97.88,1072.8799999999999
73009461,13/02/2023,-26.0,1046.8799999999999
73009461,14/02/2023,88.67,1135.55
73015538,31/01/2023,,634.94
73015538,01/02/2023,249.75,884.69
73015538,02/02/2023,-526.8,357.8900000000001
73015538,03/02/2023,-37.15,320.7400000000001
73015538,07/02/2023,-1190.8,-870.0599999999998
73015538,08/02/2023,903.3,33.24000000000012
73015538,09/02/2023,107.47,140.71000000000012
73015538,10/02/2023,85.7,226.41000000000014
73015538,11/02/2023,557.0,783.4100000000001
73039019,31/01/2023,,360.0
73039019,05/02/2023,175.88,535.88
73039019,09/02/2023,-176.56,359.32
73039019,11/02/2023,-35.07,324.25
73059951,31/01/2023,,955.01
73059951,02/02/2023,128.13,1083.1399999999999
73059951,03/02/2023,53.78,1136.92
73059951,04/02/2023,198.37,1335.29
73059951,07/02/2023,65.96,1401.25
73059951,12/02/2023,206.28,1607.53
73080553,31/01/2023,,880.06
73080553,04/02/2023,-79.24,800.8199999999999
73080553,10/02/2023,59.44,860.26
73080553,11/02/2023,79.43,939.6899999999999
73080553,11/02/2023,-120.19,819.5
73124762,31/01/2023,,110.47
73124762,01/02/2023,-49.48,60.99
73124762,01/02/2023,-50.33,10.660000000000004
73124762,06/02/2023,-24.38,-13.719999999999995
73124762,07/02/2023,87.94,74.22
73124762,09/02/2023,196.64,270.86
73124762,09/02/2023,177.2,448.05999999999995
73124762,11/02/2023,-51.94,396.12
73124762,12/02/2023,78.65,474.77
73208971,31/01/2023,,107.97
73208971,02/02/2023,-185.26,-77.28999999999999
73208971,07/02/2023,484.1,406.81000000000006
73208971,12/02/2023,95.07,501.88000000000005
73234341,31/01/2023,,811.71
73234341,04/02/2023,101.3,913.01
73234341,11/02/2023,107.95,1020.96
73234341,11/02/2023,-2044.6,-1023.6399999999999
73269307,31/01/2023,,485.86
73269307,04/02/2023,98.27,584.13
73269307,04/02/2023,42.73,626.86
73275714,31/01/2023,,924.88
73275714,04/02/2023,-173.75,751.13
73275714,06/02/2023,-123.09,628.04
73275714,11/02/2023,135.38,763.42
73282074,31/01/2023,,220.48
73282074,01/02/2023,-61.23,159.25
73282074,04/02/2023,-97.9,61.349999999999994
73282074,07/02/2023,-105.38,-44.03
73282074,07/02/2023,-147.36,-191.39000000000001
73282074,09/02/2023,-239.1,-430.49
73282074,11/02/2023,-54.29,-484.78000000000003
73282074,13/02/2023,-71.18,-555.96
73321391,31/01/2023,,100.12
73321391,03/02/2023,-174.25,-74.13
73321391,04/02/2023,-18.25,-92.38
73321391,11/02/2023,-80.85,-173.23
73321391,12/02/2023,-61.95,-235.18
73321391,13/02/2023,-80.74,-315.91999999999996
73321391,14/02/2023,78.83,-237.08999999999997
73328955,31/01/2023,,404.7
73328955,06/02/2023,-30.45,374.25
73328955,07/02/2023,-1819.0,-1444.75
73328955,09/02/2023,149.44,-1295.31
73328955,10/02/2023,-50.5,-1345.81
73328955,13/02/2023,77.1,-1268.71
73410227,31/01/2023,,820.36
73410227,01/02/2023,-219.71,600.65
73410227,06/02/2023,52.84,653.49
73410227,09/02/2023,38.14,691.63
73410227,12/02/2023,-107.09,584.54
73439131,31/01/2023,,863.01
73439131,02/02/2023,-54.93,808.08
73439131,02/02/2023,-71.36,736.72
73439131,02/02/2023,-88.1,648.62
73439131,03/02/2023,-149.58,499.03999999999996
73439131,04/02/2023,107.38,606.42
73439131,04/02/2023,-123.49,482.93
73439131,06/02/2023,-1069.0,-586.0699999999999
73439131,07/02/2023,69.6,-516.4699999999999
73439131,09/02/2023,-98.98,-615.4499999999999
73439131,14/02/2023,105.25,-510.19999999999993
73439131,14/02/2023,-53.79,-563.9899999999999
73510067,31/01/2023,,895.82
73510067,04/02/2023,135.72,1031.54
73510067,07/02/2023,-135.77,895.77
73510067,14/02/2023,22.59,918.36
73512834,31/01/2023,,424.59
73512834,01/02/2023,103.58,528.17
73512834,02/02/2023,110.43,638.6
73512834,04/02/2023,-578.7,59.89999999999998
73512834,05/02/2023,-6.73,53.16999999999997
73512834,06/02/2023,113.54,166.70999999999998
73512834,09/02/2023,54.35,221.05999999999997
73512834,09/02/2023,-176.84,44.21999999999997
73512834,10/02/2023,123.35,167.56999999999996
73512834,11/02/2023,-31.41,136.15999999999997
73512834,11/02/2023,-110.11,26.04999999999997
73512834,12/02/2023,121.0,147.04999999999995
73512834,14/02/2023,163.28,310.33
73534143,31/01/2023,,804.34
73534143,12/02/2023,-85.27,719.07
73538236,31/01/2023,,231.93
73538236,01/02/2023,60.58,292.51
73538236,13/02/2023,-99.01,193.5
73604500,31/01/2023,,689.4
73604500,02/02/2023,-186.07,503.33
73604500,06/02/2023,193.27,696.6
73604500,12/02/2023,140.65,837.25
73642628,31/01/2023,,300.06
73642628,06/02/2023,1042.0,1342.06
73642628,06/02/2023,-128.02,1214.04
73642628,07/02/2023,109.32,1323.36
73642628,08/02/2023,128.53,1451.8899999999999
73642628,09/02/2023,105.05,1556.9399999999998
73642628,14/02/2023,109.13,1666.07
73652359,31/01/2023,,80.58
73652359,08/02/2023,68.73,149.31
73652359,12/02/2023,135.05,284.36
73652359,14/02/2023,12.8,297.16
73668192,31/01/2023,,371.47
73668192,02/02/2023,1495.8,1867.27
73668192,04/02/2023,-153.96,1713.31
73668192,05/02/2023,149.4,1862.71
73668192,05/02/2023,37.76,1900.47
73668192,07/02/2023,-93.03,1807.44
73668192,10/02/2023,111.12,1918.56
73668192,10/02/2023,-11.9,1906.66
73668192,13/02/2023,-62.93,1843.73
73700087,31/01/2023,,274.17
73700087,04/02/2023,116.66,390.83000000000004
73700087,04/02/2023,-44.37,346.46000000000004
73700087,06/02/2023,-106.53,239.93
73700087,08/02/2023,70.5,310.43
73700087,10/02/2023,70.11,380.54
73700087,12/02/2023,-84.72,295.82
73744504,31/01/2023,,270.6
73744504,05/02/2023,-54.49,216.11
73744504,07/02/2023,-52.52,163.59000000000003
73744504,08/02/2023,51.75,215.34000000000003
73744504,09/02/2023,-70.71,144.63000000000002
73744504,10/02/2023,-69.64,74.99000000000002
73744504,10/02/2023,-127.34,-52.34999999999998
73744504,11/02/2023,89.18,36.83000000000003
73744504,11/02/2023,-69.64,-32.809999999999974
73744504,12/02/2023,-128.61,-161.42
73744504,13/02/2023,165.67,4.25
73744504,13/02/2023,-137.58,-133.33
73762750,31/01/2023,,221.12
73762750,01/02/2023,-66.19,154.93
73762750,03/02/2023,1505.1,1660.03
73762750,05/02/2023,-129.71,1530.32
73762750,06/02/2023,106.97,1637.29
73762750,08/02/2023,156.53,1793.82
73782061,31/01/2023,,891.9
73782061,02/02/2023,-58.23,833.67
73782061,13/02/2023,-69.25,764.42
73782061,13/02/2023,-164.0,600.42
73878828,31/01/2023,,845.19
73878828,01/02/2023,-58.02,787.1700000000001
73878828,04/02/2023,-973.3,-186.12999999999988
73878828,06/02/2023,42.82,-143.3099999999999
73878828,09/02/2023,117.9,-25.409999999999883
73878828,10/02/2023,74.6,49.19000000000011
73878828,10/02/2023,-7.29,41.90000000000011
73878828,13/02/2023,86.65,128.55000000000013
73878828,13/02/2023,-62.41,66.14000000000013
73983591,31/01/2023,,292.39
73983591,01/02/2023,117.31,409.7
73983591,05/02/2023,72.56,482.26
73983591,06/02/2023,-124.22,358.03999999999996
73983591,07/02/2023,7.57,365.61
73983591,08/02/2023,-1668.5,-1302.8899999999999
73983591,10/02/2023,-83.3,-1386.1899999999998
73983591,11/02/2023,-152.46,-1538.6499999999999
73983591,13/02/2023,-83.87,-1622.52
73983601,31/01/2023,,617.23
73983601,04/02/2023,-186.59,430.64
73983601,06/02/2023,-111.97,318.67
73983601,08/02/2023,62.88,381.55
73983601,10/02/2023,-136.73,244.82000000000002
73983601,11/02/2023,81.42,326.24
73983601,12/02/2023,-37.22,289.02000000000004
73983601,13/02/2023,-140.52,148.5
73983601,14/02/2023,82.4,230.9
74012560,31/01/2023,,414.56
74012560,08/02/2023,-51.04,363.52
74012560,10/02/2023,2476.1,2839.62
74012560,10/02/2023,75.51,2915.13
74012560,10/02/2023,-70.94,2844.19
74012560,10/02/2023,-71.14,2773.0499999999997
74012560,10/02/2023,-150.3,2622.75
74012560,14/02/2023,-96.98,2525.77
74154906,31/01/2023,,743.84
74154906,09/02/2023,32.68,776.52
74163559,31/01/2023,,45.76
74163559,02/02/2023,100.89,146.65
74163559,02/02/2023,-105.59,41.05999999999999
74163559,07/02/2023,84.66,125.71999999999998
74163559,09/02/2023,-91.85,33.86999999999999
74163559,10/02/2023,-108.57,-74.7
74163559,11/02/2023,-80.75,-155.45
74218001,31/01/2023,,133.02
74218001,05/02/2023,68.53,201.55
74218001,09/02/2023,898.2,1099.75
74218001,09/02/2023,-7.4,1092.35
74252410,31/01/2023,,278.47
74252410,01/02/2023,37.94,316.41
74252410,01/02/2023,-105.25,211.16000000000003
74252410,01/02/2023,-117.31,93.85000000000002
74252410,03/02/2023,126.21,220.06
74252410,03/02/2023,-145.42,74.64000000000004
74252410,08/02/2023,-32.44,42.200000000000045
74252410,10/02/2023,1531.0,1573.2
74252410,11/02/2023,-1207.7,365.5
74252410,13/02/2023,99.01,464.51
74252410,14/02/2023,625.3,1089.81
74255305,31/01/2023,,3.7
74255305,02/02/2023,162.41,166.10999999999999
74255305,03/02/2023,106.51,272.62
74255305,06/02/2023,93.96,366.58
74255305,07/02/2023,85.44,452.02
74255305,11/02/2023,-167.02,285.0
74255305,11/02/2023,-1672.7,-1387.7
74281404,31/01/2023,,678.89
74281404,01/02/2023,-456.2,222.69
74281404,04/02/2023,139.28,361.97
74281404,08/02/2023,89.88,451.85
74281404,11/02/2023,-145.81,306.03999999999996
74304084,31/01/2023,,883.35
74304084,01/02/2023,131.58,1014.9300000000001
74304084,08/02/2023,570.9,1585.83
74304084,10/02/2023,89.61,1675.44
74304084,14/02/2023,-122.61,1552.83
74365725,31/01/2023,,518.04
74365725,03/02/2023,-97.42,420.61999999999995
74365725,06/02/2023,24.84,445.46
74365725,10/02/2023,81.71,527.17
74365725,13/02/2023,163.71,690.88
74367877,31/01/2023,,818.92
74367877,01/02/2023,45.64,864.56
74367877,02/02/2023,-104.03,760.53
74367877,03/02/2023,472.5,1233.03
74367877,08/02/2023,-70.08,1162.95
74367877,10/02/2023,-118.64,1044.31
74367877,13/02/2023,48.97,1093.28
74387481,31/01/2023,,883.93
74387481,02/02/2023,-117.73,766.1999999999999
74387481,04/02/2023,106.46,872.66
74387481,07/02/2023,88.5,961.16
74387481,07/02/2023,-87.94,873.2199999999999
74387481,07/02/2023,-644.8,228.41999999999996
74387481,08/02/2023,162.49,390.90999999999997
74387481,09/02/2023,-163.2,227.70999999999998
74387481,10/02/2023,-91.88,135.82999999999998
74387481,13/02/2023,-61.95,73.87999999999998
74441123,31/01/2023,,833.24
74441123,01/02/2023,-143.97,689.27
74441123,02/02/2023,61.45,750.72
74441123,08/02/2023,-124.5,626.22
74441123,09/02/2023,-128.5,497.72
74441123,10/02/2023,-139.35,358.37
74441123,13/02/2023,-1154.7,-796.33
74539170,31/01/2023,,417.58
74539170,04/02/2023,143.01,560.5899999999999
74539170,04/02/2023,-74.02,486.57
74539170,07/02/2023,-142.95,343.62
74539170,10/02/2023,-126.49,217.13
74539170,11/02/2023,84.22,301.35
74539170,11/02/2023,-1.71,299.64
74539170,12/02/2023,-20.81,278.83
74544582,31/01/2023,,407.96
74544582,01/02/2023,-58.96,349.0
74544582,06/02/2023,107.8,456.79999999999995
74544582,07/02/2023,89.17,545.97
74544582,08/02/2023,-1010.6,-464.63
74544582,10/02/2023,-122.82,-587.45
74544582,11/02/2023,-16.09,-603.54
74544582,11/02/2023,-28.8,-632.34
74544582,13/02/2023,-46.08,-678.42
74544582,13/02/2023,-196.46,-874.88
74604471,31/01/2023,,661.57
74604471,03/02/2023,-21.47,640.1
74604471,11/02/2023,1199.0,1839.1
74604471,11/02/2023,1096.1,2935.2
74662976,31/01/2023,,782.3
74662976,01/02/2023,1634.7,2417.0
74662976,06/02/2023,213.44,2630.44
74662976,09/02/2023,-105.05,2525.39
74662976,11/02/2023,-111.96,2413.43
74662976,14/02/2023,-69.61,2343.82
74703933,31/01/2023,,321.42
74703933,01/02/2023,239.72,561.14
74703933,02/02/2023,-68.12,493.02
74703933,04/02/2023,58.74,551.76
74703933,04/02/2023,-157.05,394.71000000000004
74703933,07/02/2023,949.2,1343.91
74703933,11/02/2023,-152.17,1191.74
74703933,13/02/2023,81.27,1273.01
74709026,31/01/2023,,465.39
74709026,04/02/2023,-119.96,345.43
74709026,05/02/2023,-53.54,291.89
74709026,09/02/2023,58.09,349.98
74709026,11/02/2023,-152.47,197.51
74709026,14/02/2023,162.35,359.86
74768567,31/01/2023,,557.15
74768567,04/02/2023,39.82,596.97
74768567,08/02/2023,-58.95,538.02
74768567,10/02/2023,-103.06,434.96
74768567,11/02/2023,-119.83,315.13
74770758,31/01/2023,,643.52
74770758,01/02/2023,143.86,787.38
74770758,02/02/2023,645.8,1433.1799999999998
74770758,02/02/2023,-507.1,926.0799999999999
74770758,05/02/2023,-23.74,902.3399999999999
74770758,07/02/2023,155.73,1058.07
74770758,07/02/2023,27.88,1085.9499999999998
74770758,07/02/2023,-115.83,970.1199999999999
74770758,10/02/2023,119.83,1089.9499999999998
74770758,11/02/2023,-62.47,1027.48
74770758,13/02/2023,180.81,1208.29
74770758,13/02/2023,39.74,1248.03
74770758,14/02/2023,90.79,1338.82
74770758,14/02/2023,-97.35,1241.4699999999998
74770758,14/02/2023,-541.0,700.4699999999999
74822001,31/01/2023,,673.61
74822001,03/02/2023,113.25,786.86
74822001,04/02/2023,84.91,871.77
74822001,06/02/2023,157.11,1028.88
74822001,08/02/2023,-42.88,986.0
75000628,31/01/2023,,117.33
75000628,03/02/2023,-102.49,14.840000000000003
75000628,06/02/2023,-967.8,-952.9599999999999
75000628,07/02/2023,111.95,-841.0099999999999
75000628,07/02/2023,23.9,-817.1099999999999
75000628,09/02/2023,119.86,-697.2499999999999
75000628,11/02/2023,160.56,-536.6899999999999
75000628,11/02/2023,-102.03,-638.7199999999999
75000628,12/02/2023,24.74,-613.9799999999999
75000628,14/02/2023,-122.88,-736.8599999999999
75004471,31/01/2023,,435.54
75004471,06/02/2023,-90.19,345.35
75004471,07/02/2023,-71.12,274.23
75004471,09/02/2023,161.19,435.42
75004471,10/02/2023,-54.73,380.69
75027308,31/01/2023,,307.44
75027308,05/02/2023,70.81,378.25
75027308,13/02/2023,-21.73,356.52
75027308,14/02/2023,-42.03,314.49
75068844,31/01/2023,,852.47
75068844,07/02/2023,32.26,884.73
75068844,09/02/2023,-174.92,709.8100000000001
75068844,10/02/2023,-205.21,504.6
75068844,13/02/2023,56.42,561.02
75094093,31/01/2023,,478.09
75094093,08/02/2023,-66.58,411.51
75094093,10/02/2023,-86.39,325.12
75094093,14/02/2023,-120.62,204.49999999999997
75134291,31/01/2023,,903.25
75134291,07/02/2023,905.3,1808.55
75134291,08/02/2023,-137.66,1670.8899999999999
75134291,10/02/2023,145.13,1816.02
75134291,11/02/2023,1677.5,3493.52
75134291,11/02/2023,63.08,3556.6
75134291,12/02/2023,-1261.6,2295.0
75134291,13/02/2023,138.85,2433.85
75164598,31/01/2023,,569.4
75164598,01/02/2023,84.96,654.36
75164598,03/02/2023,1529.4,2183.76
75164598,13/02/2023,83.87,2267.63
75164598,14/02/2023,-130.44,2137.19
75172199,31/01/2023,,955.0
75172199,01/02/2023,800.0,1755.0
75172199,05/02/2023,-110.09,1644.91
75172199,10/02/2023,-108.6,1536.31
75172199,14/02/2023,-41.12,1495.19
75205767,31/01/2023,,113.75
75205767,01/02/2023,12.5,126.25
75205767,03/02/2023,-59.01,67.24000000000001
75205767,08/02/2023,-26.82,40.42
75205767,09/02/2023,117.38,157.8
75205767,10/02/2023,964.8,1122.6
75205767,11/02/2023,52.74,1175.34
75205767,12/02/2023,-195.95,979.3899999999999
75216128,31/01/2023,,671.26
75216128,05/02/2023,848.7,1519.96
75216128,05/02/2023,-51.76,1468.2
75216128,06/02/2023,-50.86,1417.3400000000001
75216128,10/02/2023,-113.81,1303.53
75216128,11/02/2023,136.0,1439.53
75216128,13/02/2023,145.9,1585.43
75216128,13/02/2023,37.31,1622.74
75216128,14/02/2023,-110.13,1512.6100000000001
75223089,31/01/2023,,557.48
75223089,02/02/2023,-97.37,460.11
75223089,06/02/2023,140.76,600.87
75223089,08/02/2023,0.47,601.34
75223089,10/02/2023,71.41,672.75
75258542,31/01/2023,,772.67
75258542,06/02/2023,59.16,831.8299999999999
75331062,31/01/2023,,117.81
75331062,01/02/2023,124.73,242.54000000000002
75331062,02/02/2023,192.68,435.22
75331062,02/02/2023,153.2,588.4200000000001
75331062,09/02/2023,-103.8,484.62
75331062,10/02/2023,76.32,560.94
75331062,12/02/2023,182.63,743.5699999999999
75331062,12/02/2023,168.57,912.14
75355842,31/01/2023,,621.95
75355842,02/02/2023,-107.62,514.33
75355842,08/02/2023,-167.23,347.1
75355842,13/02/2023,36.43,383.53000000000003
75355842,13/02/2023,-65.62,317.9100000000001
75394177,31/01/2023,,191.04
75394177,01/02/2023,212.26,403.29999999999995
75394177,01/02/2023,-189.07,214.23
75394177,05/02/2023,84.35,298.58
75394177,07/02/2023,-96.08,202.5
75394177,09/02/2023,-67.76,134.73999999999998
75394177,13/02/2023,-12.26,122.47999999999998
75428657,31/01/2023,,455.8
75428657,01/02/2023,96.14,551.94
75428657,04/02/2023,72.24,624.1800000000001
75428657,06/02/2023,-89.47,534.71
75428657,06/02/2023,-107.32,427.39
75428657,07/02/2023,-166.06,261.33000000000004
75428657,12/02/2023,-133.04,128.29000000000002
75468090,31/01/2023,,984.92
75468090,02/02/2023,-94.47,890.4499999999999
75468090,03/02/2023,-110.96,779.49
75468090,05/02/2023,143.3,922.79
75468090,06/02/2023,-28.36,894.43
75468090,09/02/2023,82.14,976.5699999999999
75468090,13/02/2023,2264.3,3240.87
75468090,14/02/2023,86.73,3327.6
75468090,14/02/2023,-156.02,3171.58
75551521,31/01/2023,,538.64
75551521,01/02/2023,-170.89,367.75
75551521,10/02/2023,-175.95,191.8
75551521,11/02/2023,-40.81,150.99
75553043,31/01/2023,,669.59
75553043,01/02/2023,-124.86,544.73
75553043,02/02/2023,-66.42,478.31000000000006
75553043,07/02/2023,-46.14,432.17
75553043,08/02/2023,45.54,477.71000000000004
75553043,12/02/2023,150.22,627.9300000000001
75553043,12/02/2023,87.33,715.26
75553043,13/02/2023,172.54,887.8
75553043,13/02/2023,-126.86,760.94
75553043,13/02/2023,-156.04,604.9000000000001
75569387,31/01/2023,,249.27
75569387,01/02/2023,1775.6,2024.87
75569387,03/02/2023,-177.23,1847.6399999999999
75569387,05/02/2023,76.31,1923.9499999999998
75569387,08/02/2023,-137.97,1785.98
75569387,08/02/2023,-155.15,1630.83
75569387,09/02/2023,173.2,1804.03
75569387,10/02/2023,-177.19,1626.84
75569387,12/02/2023,95.61,1722.4499999999998
75573750,31/01/2023,,159.92
75573750,01/02/2023,-57.37,102.54999999999998
75573750,01/02/2023,-614.1,-511.55000000000007
75573750,11/02/2023,95.68,-415.87000000000006
75687743,31/01/2023,,668.39
75687743,02/02/2023,-77.04,591.35
75687743,02/02/2023,-121.53,469.82
75687743,06/02/2023,68.98,538.8
75687743,08/02/2023,710.3,1249.1
75687743,13/02/2023,-101.21,1147.8899999999999
75687743,13/02/2023,-124.44,1023.4499999999999
75692380,31/01/2023,,477.28
75692380,07/02/2023,13.71,490.98999999999995
75692380,12/02/2023,76.48,567.47
75696521,31/01/2023,,660.34
75696521,02/02/2023,151.37,811.71
75696521,04/02/2023,-113.97,697.74
75696521,09/02/2023,124.33,822.07
75696521,12/02/2023,-443.1,378.97
75696521,13/02/2023,105.96,484.93
75747094,31/01/2023,,289.48
75747094,01/02/2023,-108.17,181.31
75747094,02/02/2023,-111.34,69.97000000000001
75747094,03/02/2023,-88.14,-18.169999999999987
75747094,03/02/2023,-170.7,-188.86999999999998
75747094,06/02/2023,-179.08,-367.95
75747094,07/02/2023,-69.34,-437.28999999999996
75747094,09/02/2023,125.74,-311.55
75747094,09/02/2023,-24.49,-336.04
75747094,12/02/2023,198.39,-137.65
75747094,12/02/2023,119.08,-18.570000000000007
75747094,12/02/2023,-1314.3,-1332.87
75747094,14/02/2023,51.36,-1281.51
75762044,31/01/2023,,980.08
75762044,03/02/2023,-117.47,862.61
75762044,05/02/2023,617.7,1480.31
75762044,05/02/2023,80.83,1561.14
75762044,07/02/2023,-79.53,1481.6100000000001
75762044,07/02/2023,-1107.6,374.0100000000002
75762044,08/02/2023,-238.9,135.1100000000002
75762044,09/02/2023,84.51,219.62000000000023
75762044,12/02/2023,-64.23,155.3900000000002
75762044,12/02/2023,-94.0,61.390000000000214
75762044,14/02/2023,-87.33,-25.939999999999785
75782714,31/01/2023,,105.34
75782714,02/02/2023,182.71,288.05
75782714,04/02/2023,93.96,382.01
75782714,07/02/2023,97.29,479.3
75782714,08/02/2023,-58.82,420.48
75782714,11/02/2023,53.59,474.07
75839704,31/01/2023,,202.34
75839704,06/02/2023,59.6,261.94
75839704,11/02/2023,-157.05,104.88999999999999
75839704,12/02/2023,44.96,149.85
75893682,31/01/2023,,573.74
75893682,03/02/2023,104.78,678.52
75893682,04/02/2023,102.31,780.83
75893682,08/02/2023,-105.88,674.95
75893682,09/02/2023,148.56,823.51
75925793,31/01/2023,,425.69
75925793,01/02/2023,107.97,533.66
75925793,03/02/2023,-50.4,483.26
75925793,04/02/2023,-87.65,395.61
75925793,11/02/2023,77.62,473.23
75925793,11/02/2023,-143.15,330.08
75946768,31/01/2023,,103.05
75946768,02/02/2023,158.32,261.37
75946768,03/02/2023,-121.58,139.79000000000002
75946768,04/02/2023,-85.27,54.52000000000001
75946768,11/02/2023,157.4,211.92000000000002
75954317,31/01/2023,,583.28
75954317,02/02/2023,92.9,676.18
75954317,05/02/2023,41.21,717.39
75954317,11/02/2023,129.66,847.05
75954317,13/02/2023,760.4,1607.4499999999998
75954317,13/02/2023,122.87,1730.32
75954317,14/02/2023,85.66,1815.98
75969874,31/01/2023,,454.25
75969874,05/02/2023,325.0,779.25
75969874,05/02/2023,165.42,944.67
75969874,08/02/2023,-42.92,901.75
75969874,09/02/2023,48.05,949.8
76078639,31/01/2023,,318.17
76078639,01/02/2023,9.8,327.97
76078639,06/02/2023,154.69,482.66
76078639,08/02/2023,109.06,591.72
76078639,09/02/2023,-25.58,566.14
76096120,31/01/2023,,996.6
76096120,01/02/2023,-115.85,880.75
76096120,02/02/2023,142.28,1023.03
76096120,02/02/2023,101.22,1124.25
76096120,03/02/2023,85.29,1209.54
76096120,05/02/2023,-142.12,1067.42
76096120,06/02/2023,99.42,1166.84
76096120,13/02/2023,-90.4,1076.44
76099143,31/01/2023,,525.4
76099143,02/02/2023,-118.6,406.79999999999995
76099143,05/02/2023,61.09,467.89
76099143,13/02/2023,-53.33,414.56
76122310,31/01/2023,,985.6
76122310,10/02/2023,-616.1,369.5
76122310,11/02/2023,32.2,401.7
76122310,13/02/2023,148.74,550.44
76146870,31/01/2023,,414.24
76146870,03/02/2023,1278.2,1692.44
76146870,06/02/2023,-165.65,1526.79
76146870,07/02/2023,168.17,1694.96
76146870,07/02/2023,141.27,1836.23
76146870,08/02/2023,-86.36,1749.8700000000001
76146870,11/02/2023,101.6,1851.47
76146870,14/02/2023,88.1,1939.57
76146870,14/02/2023,-104.18,1835.39
76146870,14/02/2023,-1053.5,781.8900000000001
76169332,31/01/2023,,615.46
76169332,02/02/2023,83.79,699.25
76169332,02/02/2023,-1695.5,-996.25
76169332,03/02/2023,-28.0,-1024.25
76169332,07/02/2023,84.19,-940.06
76206810,31/01/2023,,887.63
76206810,01/02/2023,-128.78,758.85
76206810,05/02/2023,-104.42,654.43
76206810,12/02/2023,108.81,763.24
76206810,12/02/2023,104.78,868.02
76206810,14/02/2023,37.74,905.76
76245103,31/01/2023,,814.75
76245103,07/02/2023,171.4,986.15
76245103,08/02/2023,-72.19,913.96
76245103,10/02/2023,-108.64,805.32
76245103,11/02/2023,-126.42,678.9
76245103,11/02/2023,-194.38,484.52
76245103,14/02/2023,64.58,549.1
76256026,31/01/2023,,36.71
76256026,01/02/2023,114.21,150.92
76256026,02/02/2023,-122.54,28.379999999999995
76256026,03/02/2023,-65.14,-36.760000000000005
76256026,05/02/2023,76.57,39.80999999999999
76256026,06/02/2023,-91.5,-51.69000000000001
76256026,06/02/2023,-583.7,-635.3900000000001
76256026,07/02/2023,-62.85,-698.2400000000001
76256026,08/02/2023,154.47,-543.7700000000001
76256026,09/02/2023,125.05,-418.7200000000001
76256026,12/02/2023,1251.2,832.48
76256026,12/02/2023,1145.7,1978.18
76256026,12/02/2023,-107.03,1871.15
76257915,31/01/2023,,795.66
76257915,04/02/2023,87.08,882.74
76257915,05/02/2023,108.03,990.77
76257915,07/02/2023,-1236.7,-245.93000000000006
76257915,14/02/2023,51.78,-194.15000000000006
76273831,31/01/2023,,866.62
76273831,02/02/2023,49.14,915.76
76273831,03/02/2023,-113.59,802.17
76273831,07/02/2023,109.58,911.75
76273831,08/02/2023,99.77,1011.52
76273831,12/02/2023,-110.79,900.73
76273831,13/02/2023,-124.45,776.28
76273831,14/02/2023,129.25,905.53
76318330,31/01/2023,,710.56
76318330,01/02/2023,-960.8,-250.24
76318330,03/02/2023,-1.03,-251.27
76318330,04/02/2023,41.13,-210.14000000000001
76318330,04/02/2023,-49.52,-259.66
76318330,04/02/2023,-165.42,-425.08
76318330,06/02/2023,405.7,-19.379999999999995
76318330,06/02/2023,128.02,108.64000000000001
76318330,14/02/2023,156.27,264.91
76336076,31/01/2023,,288.71
76336076,07/02/2023,109.43,398.14
76336076,13/02/2023,-96.98,301.15999999999997
76336076,14/02/2023,-1376.0,-1074.8400000000001
76342664,31/01/2023,,371.62
76342664,03/02/2023,42.34,413.96000000000004
76342664,04/02/2023,124.23,538.19
76342664,05/02/2023,-44.51,493.68
76342664,12/02/2023,100.06,593.74
76343783,31/01/2023,,42.36
76343783,02/02/2023,133.38,175.74
76343783,08/02/2023,1253.6,1429.34
76343783,10/02/2023,113.56,1542.8999999999999
76343783,13/02/2023,1505.7,3048.6
76355557,31/01/2023,,285.61
76355557,03/02/2023,110.56,396.17
76355557,10/02/2023,65.54,461.71000000000004
76355557,10/02/2023,-206.97,254.74
76355557,11/02/2023,184.5,439.24
76355557,13/02/2023,-73.19,366.05
76454427,31/01/2023,,267.03
76454427,09/02/2023,32.83,299.85999999999996
76454427,10/02/2023,64.12,363.97999999999996
76454427,12/02/2023,-170.4,193.57999999999998
76470405,31/01/2023,,606.3
76470405,01/02/2023,120.13,726.43
76470405,02/02/2023,62.52,788.9499999999999
76470405,02/02/2023,-65.2,723.75
76470405,05/02/2023,175.68,899.43
76470405,05/02/2023,104.2,1003.63
76470405,05/02/2023,-41.21,962.42
76470405,07/02/2023,56.28,1018.6999999999999
76470405,07/02/2023,-98.61,920.0899999999999
76470405,10/02/2023,-116.06,804.03
76474111,31/01/2023,,563.43
76474111,01/02/2023,88.99,652.42
76474111,05/02/2023,-69.19,583.2299999999999
76474111,07/02/2023,173.35,756.5799999999999
76474111,07/02/2023,-17.39,739.1899999999999
76474111,09/02/2023,-158.25,580.9399999999999
76474111,11/02/2023,-73.94,506.99999999999994
76474111,12/02/2023,109.6,616.5999999999999
76474111,12/02/2023,85.9,702.5
76474111,14/02/2023,626.8,1329.3
76482858,31/01/2023,,568.63
76482858,04/02/2023,-1084.8,-516.17
76482858,05/02/2023,124.61,-391.55999999999995
76482858,06/02/2023,202.83,-188.72999999999996
76482858,07/02/2023,1236.7,1047.97
76482858,08/02/2023,-782.7,265.27
76524911,31/01/2023,,190.9
76524911,01/02/2023,-41.55,149.35000000000002
76524911,05/02/2023,-65.57,83.78000000000002
76524911,07/02/2023,176.26,260.04
76524911,13/02/2023,69.71,329.75
76537084,31/01/2023,,884.7
76537084,03/02/2023,77.14,961.84
76537084,03/02/2023,-86.49,875.35
76537084,05/02/2023,-117.8,757.5500000000001
76537084,06/02/2023,83.76,841.3100000000001
76537084,11/02/2023,84.29,925.6
76537084,12/02/2023,-76.36,849.24
76537084,13/02/2023,76.58,925.82
76546657,31/01/2023,,434.77
76546657,03/02/2023,-99.85,334.91999999999996
76546657,05/02/2023,-122.25,212.67
76546657,06/02/2023,-88.52,124.14999999999999
76546657,07/02/2023,-14.81,109.33999999999999
76546657,07/02/2023,-85.6,23.739999999999995
76546657,08/02/2023,-1123.1,-1099.36
76546657,09/02/2023,1363.6,264.24
76546657,10/02/2023,209.84,474.08000000000004
76629706,31/01/2023,,962.66
76629706,04/02/2023,126.02,1088.68
76629706,04/02/2023,52.76,1141.44
76629706,07/02/2023,105.66,1247.1
76629706,09/02/2023,-158.66,1088.44
76629706,10/02/2023,74.41,1162.85
76662799,31/01/2023,,296.68
76662799,01/02/2023,-84.07,212.61
76662799,04/02/2023,-76.66,135.95000000000002
76662799,06/02/2023,-77.47,58.48000000000002
76662799,08/02/2023,60.7,119.18000000000002
76662799,08/02/2023,-67.17,52.01000000000002
76662799,09/02/2023,70.71,122.72000000000001
76662799,10/02/2023,-1394.1,-1271.3799999999999
76662799,14/02/2023,95.2,-1176.1799999999998
76698056,31/01/2023,,827.36
76698056,02/02/2023,206.91,1034.27
76698056,02/02/2023,111.34,1145.6100000000001
76698056,02/02/2023,98.37,1243.98
76698056,03/02/2023,9.03,1253.01
76698056,07/02/2023,84.97,1337.98
76698056,07/02/2023,-124.31,1213.67
76698056,08/02/2023,221.0,1434.67
76720959,31/01/2023,,436.06
76720959,04/02/2023,100.63,536.69
76720959,05/02/2023,93.03,629.72
76720959,07/02/2023,93.88,723.6
76720959,10/02/2023,-166.54,557.06
76720959,13/02/2023,133.35,690.41
76787359,31/01/2023,,386.73
76787359,03/02/2023,116.55,503.28000000000003
76787359,03/02/2023,-110.59,392.69
76787359,04/02/2023,1398.7,1791.39
76787359,06/02/2023,-61.92,1729.47
76787359,07/02/2023,-151.4,1578.0700000000002
76787359,07/02/2023,-808.1,769.97
76787359,08/02/2023,154.93,924.9000000000001
76799768,31/01/2023,,981.08
76799768,01/02/2023,-77.81,903.27
76799768,03/02/2023,50.4,953.6700000000001
76799768,03/02/2023,-100.81,852.86
76799768,03/02/2023,-644.3,208.56000000000006
76799768,04/02/2023,73.93,282.49000000000007
76799768,04/02/2023,53.8,336.2900000000001
76799768,04/02/2023,49.53,385.82000000000005
76799768,06/02/2023,-71.52,314.30000000000007
76799768,09/02/2023,81.65,395.95000000000005
76799768,14/02/2023,55.79,451.74000000000007
76847816,31/01/2023,,197.8
76847816,01/02/2023,-16.06,181.74
76847816,01/02/2023,-129.39,52.35000000000002
76847816,02/02/2023,-699.5,-647.15
76847816,03/02/2023,1259.6,612.4499999999999
76847816,07/02/2023,-1282.4,-669.9500000000002
76847816,09/02/2023,160.1,-509.85000000000014
76847816,10/02/2023,115.98,-393.8700000000002
76847816,12/02/2023,1268.1,874.2299999999998
76847816,12/02/2023,-92.93,781.2999999999997
76847816,13/02/2023,-67.88,713.4199999999998
76857747,31/01/2023,,952.88
76857747,04/02/2023,-63.46,889.42
76857747,04/02/2023,-122.06,767.36
76857747,05/02/2023,-70.81,696.55
76857747,06/02/2023,112.33,808.88
76857747,07/02/2023,97.82,906.6999999999999
76857747,08/02/2023,117.22,1023.92
76857747,09/02/2023,107.22,1131.1399999999999
76857747,10/02/2023,205.21,1336.35
76857747,11/02/2023,75.48,1411.83
76857747,12/02/2023,122.61,1534.44
76869201,31/01/2023,,515.62
76869201,01/02/2023,-98.26,417.36
76869201,04/02/2023,-149.33,268.03
76869201,05/02/2023,-84.35,183.67999999999998
76869201,09/02/2023,1485.0,1668.68
76869201,12/02/2023,-128.28,1540.4
76869201,14/02/2023,-20.41,1519.99
76869375,31/01/2023,,894.84
76869375,01/02/2023,92.35,987.19
76869375,01/02/2023,41.18,1028.3700000000001
76869375,02/02/2023,-103.03,925.34
76869375,03/02/2023,141.16,1066.5
76869375,04/02/2023,96.31,1162.81
76869375,05/02/2023,-54.79,1108.02
76869375,06/02/2023,-82.75,1025.27
76869375,13/02/2023,148.17,1173.44
76953050,31/01/2023,,453.1
76953050,04/02/2023,-89.97,363.13
76953050,05/02/2023,129.47,492.6
76953050,09/02/2023,39.39,531.99
76953050,10/02/2023,102.06,634.0500000000001
76953050,14/02/2023,120.54,754.59
77010964,31/01/2023,,899.11
77010964,05/02/2023,91.81,990.9200000000001
77010964,07/02/2023,57.25,1048.17
77010964,10/02/2023,-116.67,931.5
77010964,11/02/2023,85.0,1016.5
77010964,11/02/2023,-70.24,946.26
77017650,31/01/2023,,699.24
77017650,01/02/2023,-103.04,596.2
77017650,03/02/2023,121.15,717.35
77017650,04/02/2023,-92.05,625.3
77017650,07/02/2023,121.9,747.2
77017650,07/02/2023,38.41,785.61
77017650,08/02/2023,96.4,882.01
77017650,08/02/2023,-104.18,777.83
77017650,12/02/2023,-57.5,720.33
77017650,12/02/2023,-95.8,624.53
77017650,13/02/2023,98.44,722.97
77017650,13/02/2023,-56.42,666.55
77017650,14/02/2023,113.46,780.01
77017650,14/02/2023,-49.55,730.46
77017650,14/02/2023,-116.74,613.72
77026279,31/01/2023,,126.05
77026279,05/02/2023,-39.2,86.85
77026279,06/02/2023,101.4,188.25
77026279,08/02/2023,36.78,225.03
77026279,09/02/2023,-105.04,119.99
77026279,12/02/2023,1640.8,1760.79
77026279,13/02/2023,101.58,1862.37
77026279,13/02/2023,-136.98,1725.3899999999999
77207452,31/01/2023,,696.83
77207452,04/02/2023,104.45,801.2800000000001
77207452,04/02/2023,65.13,866.4100000000001
77207452,04/02/2023,35.68,902.09
77207452,09/02/2023,-77.75,824.34
77207452,10/02/2023,-104.39,719.95
77207452,10/02/2023,-1975.6,-1255.6499999999999
77207452,11/02/2023,150.26,-1105.3899999999999
77207452,11/02/2023,-482.1,-1587.4899999999998
77207452,11/02/2023,-531.4,-2118.89
77241606,31/01/2023,,761.38
77241606,02/02/2023,-106.05,655.33
77241606,07/02/2023,174.77,830.1
77241606,07/02/2023,-97.26,732.84
77241606,08/02/2023,-84.11,648.73
77241606,09/02/2023,-5.59,643.14
77241606,12/02/2023,141.01,784.15
77241606,12/02/2023,77.9,862.05
77243259,31/01/2023,,614.86
77243259,01/02/2023,86.97,701.83
77243259,01/02/2023,-106.89,594.94
77243259,02/02/2023,86.62,681.5600000000001
77243259,08/02/2023,97.07,778.63
77243259,08/02/2023,-164.7,613.9300000000001
77243259,10/02/2023,90.2,704.13
77243259,12/02/2023,123.95,828.08
77289104,31/01/2023,,737.08
77289104,03/02/2023,145.14,882.22
77289104,06/02/2023,134.08,1016.3000000000001
77289104,07/02/2023,67.04,1083.3400000000001
77289104,10/02/2023,-148.04,935.3000000000001
77289104,13/02/2023,93.21,1028.51
77342574,31/01/2023,,907.34
77342574,01/02/2023,-115.41,791.9300000000001
77342574,02/02/2023,24.05,815.98
77342574,02/02/2023,-132.64,683.34
77342574,02/02/2023,-1666.0,-982.66
77342574,02/02/2023,-1774.7,-2757.36
77342574,04/02/2023,-127.8,-2885.16
77342574,10/02/2023,-187.69,-3072.85
77342574,13/02/2023,211.13,-2861.72
77342574,14/02/2023,114.72,-2747.0
77342574,14/02/2023,-40.73,-2787.73
77342574,14/02/2023,-130.66,-2918.39
77377150,31/01/2023,,673.03
77377150,01/02/2023,-8.07,664.9599999999999
77377150,06/02/2023,-144.03,520.93
77377150,08/02/2023,-112.44,408.49
77377150,11/02/2023,-139.56,268.92999999999995
77377150,12/02/2023,-791.8,-522.87
77379844,31/01/2023,,32.65
77379844,02/02/2023,55.08,87.72999999999999
77379844,03/02/2023,-139.16,-51.43000000000001
77379844,04/02/2023,-137.7,-189.13
77379844,06/02/2023,136.6,-52.53
77379844,13/02/2023,-37.83,-90.36
77387016,31/01/2023,,894.34
77387016,05/02/2023,505.0,1399.3400000000001
77387016,14/02/2023,707.3,2106.64
77418940,31/01/2023,,263.71
77418940,03/02/2023,159.42,423.13
77418940,04/02/2023,127.76,550.89
77418940,05/02/2023,-37.76,513.13
77418940,05/02/2023,-83.83,429.29999999999995
77418940,10/02/2023,92.09,521.39
77418940,11/02/2023,1012.8,1534.19
77418940,11/02/2023,-80.51,1453.6799999999998
77418940,11/02/2023,-130.61,1323.07
77418940,11/02/2023,-187.53,1135.54
77447018,31/01/2023,,754.64
77447018,03/02/2023,-56.34,698.3
77447018,08/02/2023,-59.47,638.8299999999999
77447018,08/02/2023,-163.05,475.78
77447018,10/02/2023,159.2,634.98
77447018,10/02/2023,-123.76,511.21999999999997
77447018,11/02/2023,-50.07,461.15
77447018,11/02/2023,-147.81,313.3399999999999
77504884,31/01/2023,,221.03
77504884,01/02/2023,695.3,916.3299999999999
77504884,07/02/2023,122.99,1039.32
77504884,08/02/2023,108.51,1147.83
77504884,08/02/2023,92.11,1239.9399999999998
77504884,08/02/2023,-43.89,1196.05
77504884,12/02/2023,-51.05,1145.0
77504884,12/02/2023,-118.61,1026.3899999999999
77551209,31/01/2023,,7.33
77551209,04/02/2023,1795.8,1803.1299999999999
77551209,05/02/2023,-69.16,1733.9699999999998
77551209,09/02/2023,666.4,2400.37
77551209,09/02/2023,136.79,2537.16
77551209,11/02/2023,-573.2,1963.9599999999998
77551209,13/02/2023,-104.56,1859.3999999999999
77554032,31/01/2023,,646.5
77554032,02/02/2023,45.75,692.25
77554032,02/02/2023,-124.34,567.91
77554032,04/02/2023,58.86,626.77
77554032,07/02/2023,-198.21,428.56
77554032,07/02/2023,-1029.9,-601.3400000000001
77554032,10/02/2023,-23.96,-625.3000000000002
77554032,10/02/2023,-101.72,-727.0200000000002
77587664,31/01/2023,,769.43
77587664,04/02/2023,-72.49,696.9399999999999
77587664,05/02/2023,-90.66,606.28
77587664,06/02/2023,154.81,761.0899999999999
77587664,06/02/2023,51.05,812.14
77587664,07/02/2023,-33.35,778.79
77587664,09/02/2023,-89.39,689.4
77587664,12/02/2023,72.94,762.3399999999999
77646359,31/01/2023,,434.93
77646359,11/02/2023,43.47,478.4
77668890,31/01/2023,,804.88
77668890,02/02/2023,-103.44,701.44
77668890,03/02/2023,590.1,1291.54
77668890,03/02/2023,-101.3,1190.24
77668890,05/02/2023,-149.93,1040.31
77668890,10/02/2023,-120.91,919.4
77668890,11/02/2023,-174.4,745.0
77668890,13/02/2023,-98.34,646.66
77668890,14/02/2023,132.75,779.41
77668890,14/02/2023,18.83,798.2399999999999
77668890,14/02/2023,-18.83,779.41
77668890,14/02/2023,-33.09,746.3199999999999
77688406,31/01/2023,,224.2
77688406,05/02/2023,49.84,274.03999999999996
77688406,06/02/2023,-16.5,257.53999999999996
77688406,07/02/2023,1516.3,1773.84
77688406,08/02/2023,-140.07,1633.77
77688406,10/02/2023,95.08,1728.85
77688406,14/02/2023,-101.1,1627.75
77717508,31/01/2023,,493.27
77717508,01/02/2023,-173.96,319.30999999999995
77717508,03/02/2023,-73.31,245.99999999999997
77717508,04/02/2023,119.83,365.83
77717508,12/02/2023,125.62,491.45
77717508,12/02/2023,110.26,601.71
77717508,12/02/2023,99.41,701.12
77722115,31/01/2023,,735.94
77722115,01/02/2023,-160.76,575.1800000000001
77722115,02/02/2023,-130.9,444.2800000000001
77722115,03/02/2023,129.36,573.6400000000001
77722115,05/02/2023,92.6,666.24
77722115,05/02/2023,80.56,746.8000000000001
77722115,05/02/2023,-138.32,608.48
77722115,06/02/2023,134.96,743.44
77722115,07/02/2023,-204.81,538.6300000000001
77722115,09/02/2023,178.61,717.2400000000001
77722115,14/02/2023,-142.86,574.3800000000001
77737443,31/01/2023,,220.7
77737443,03/02/2023,-115.87,104.82999999999998
77737443,04/02/2023,-187.19,-82.36000000000001
77737443,06/02/2023,103.08,20.719999999999985
77737443,07/02/2023,44.02,64.73999999999998
77737443,11/02/2023,73.94,138.67999999999998
77737443,12/02/2023,93.78,232.45999999999998
77737443,12/02/2023,11.78,244.23999999999998
77792490,31/01/2023,,822.76
77792490,01/02/2023,-150.38,672.38
77792490,03/02/2023,122.22,794.6
77792490,04/02/2023,-123.43,671.17
77792490,04/02/2023,-133.46,537.71
77792490,06/02/2023,124.17,661.88
77792490,11/02/2023,-89.5,572.38
77792490,11/02/2023,-92.62,479.76
77792490,12/02/2023,132.28,612.04
77792490,13/02/2023,111.75,723.79
77797288,31/01/2023,,199.97
77797288,02/02/2023,-68.63,131.34
77797288,05/02/2023,1852.7,1984.04
77797288,12/02/2023,1808.9,3792.94
77797288,12/02/2023,-108.19,3684.75
77802960,31/01/2023,,157.47
77802960,06/02/2023,-156.97,0.5
77802960,07/02/2023,-106.8,-106.3
77802960,14/02/2023,140.97,34.67
77838890,31/01/2023,,951.16
77838890,01/02/2023,85.61,1036.77
77838890,10/02/2023,812.8,1849.57
77838890,11/02/2023,-11.3,1838.27
77838890,13/02/2023,101.4,1939.6699999999998
77838890,14/02/2023,56.24,1995.9099999999999
77841390,31/01/2023,,673.82
77841390,04/02/2023,-81.91,591.9100000000001
77841390,07/02/2023,-98.66,493.25000000000006
77841390,08/02/2023,1908.7,2401.9500000000003
77841390,12/02/2023,-151.37,2250.58
77841390,13/02/2023,-61.83,2188.75
77841390,14/02/2023,-44.44,2144.31
77847751,31/01/2023,,850.14
77847751,09/02/2023,-74.39,775.75
77847751,10/02/2023,-195.79,579.96
77847751,13/02/2023,26.0,605.96
77847751,14/02/2023,-302.7,303.26
77867306,31/01/2023,,907.96
77867306,06/02/2023,-168.93,739.03
77867306,09/02/2023,-190.68,548.35
77867306,09/02/2023,-787.2,-238.85000000000002
77867306,11/02/2023,-851.2,-1090.0500000000002
77867306,12/02/2023,76.15,-1013.9000000000001
77867306,14/02/2023,-69.99,-1083.89
77880852,31/01/2023,,550.69
77880852,02/02/2023,179.67,730.36
77880852,03/02/2023,-113.03,617.33
77880852,04/02/2023,1649.2,2266.53
77880852,04/02/2023,55.7,2322.23
77880852,06/02/2023,-140.03,2182.2
77880852,07/02/2023,81.45,2263.65
77880852,10/02/2023,47.22,2310.87
77880852,10/02/2023,-103.62,2207.25
77880852,12/02/2023,68.38,2275.63
77911836,31/01/2023,,87.75
77911836,02/02/2023,-51.61,36.14
77911836,03/02/2023,46.29,82.43
77911836,03/02/2023,-622.9,-540.47
77911836,06/02/2023,-114.33,-654.8
77911836,08/02/2023,99.5,-555.3
77913078,31/01/2023,,885.96
77913078,01/02/2023,14.22,900.1800000000001
77913078,02/02/2023,93.5,993.6800000000001
77913078,03/02/2023,-193.29,800.3900000000001
77913078,10/02/2023,43.52,843.9100000000001
77913078,12/02/2023,154.82,998.73
77917083,31/01/2023,,929.41
77917083,04/02/2023,135.89,1065.3
77917083,05/02/2023,-78.8,986.5
77917083,08/02/2023,1119.6,2106.1
77931114,31/01/2023,,480.52
77931114,01/02/2023,57.95,538.47
77931114,05/02/2023,64.41,602.88
77931114,06/02/2023,-67.96,534.92
77931114,07/02/2023,-99.87,435.04999999999995
77931114,09/02/2023,-82.99,352.06
77931114,11/02/2023,-181.51,170.55
77931114,12/02/2023,-1041.9,-871.3500000000001
77966293,31/01/2023,,904.28
77966293,03/02/2023,-77.0,827.28
77966293,04/02/2023,44.5,871.78
77966293,05/02/2023,81.21,952.99
77966293,06/02/2023,22.54,975.53
77966293,08/02/2023,132.99,1108.52
77966293,08/02/2023,96.66,1205.18
77966293,12/02/2023,-134.41,1070.77
77966293,13/02/2023,-81.41,989.36
77966293,14/02/2023,100.41,1089.77
77980498,31/01/2023,,893.87
77980498,01/02/2023,-50.55,843.32
77980498,01/02/2023,-81.36,761.96
77980498,01/02/2023,-102.31,659.65
77980498,04/02/2023,-46.96,612.69
77980498,10/02/2023,819.0,1431.69
77980498,11/02/2023,36.07,1467.76
78004131,31/01/2023,,723.24
78004131,01/02/2023,-34.17,689.07
78004131,04/02/2023,-37.75,651.32
78004131,07/02/2023,-12.69,638.63
78004131,08/02/2023,-1245.5,-606.87
78004131,10/02/2023,156.94,-449.93
78047487,31/01/2023,,417.33
78047487,13/02/2023,-61.15,356.18
78065026,31/01/2023,,356.26
78065026,02/02/2023,-80.01,276.25
78065026,05/02/2023,-41.55,234.7
78065026,07/02/2023,-75.46,159.24
78065026,09/02/2023,38.34,197.57999999999998
78065026,13/02/2023,-194.21,3.3700000000000045
78072161,31/01/2023,,914.19
78072161,01/02/2023,-76.69,837.5
78072161,03/02/2023,70.99,908.49
78072161,05/02/2023,-175.05,733.44
78072161,06/02/2023,-118.48,614.96
78072161,07/02/2023,111.08,726.0400000000001
78072161,11/02/2023,-102.26,623.7800000000001
78076137,31/01/2023,,290.47
78076137,01/02/2023,128.93,419.40000000000003
78076137,02/02/2023,-45.75,373.65000000000003
78076137,04/02/2023,1231.2,1604.8500000000001
78076137,04/02/2023,-130.12,1474.73
78076137,05/02/2023,-357.9,1116.8300000000002
78076137,10/02/2023,-171.22,945.6100000000001
78076137,12/02/2023,78.91,1024.5200000000002
78076137,13/02/2023,115.5,1140.0200000000002
78076137,13/02/2023,-734.3,405.72000000000025
78129803,31/01/2023,,233.76
78129803,03/02/2023,38.61,272.37
78129803,03/02/2023,-168.33,104.03999999999996
78129803,05/02/2023,540.8,644.8399999999999
78129803,08/02/2023,-154.46,490.3799999999999
78129803,11/02/2023,35.03,525.4099999999999
78129803,12/02/2023,146.81,672.2199999999999
78129803,12/02/2023,-122.36,549.8599999999999
78129803,13/02/2023,-41.75,508.1099999999999
78129803,13/02/2023,-79.84,428.2699999999999
78133064,31/01/2023,,103.96
78133064,02/02/2023,103.44,207.39999999999998
78133064,02/02/2023,-156.52,50.879999999999995
78133064,03/02/2023,1935.5,1986.38
78133064,10/02/2023,129.69,2116.07
78133064,12/02/2023,177.52,2293.59
78133064,12/02/2023,149.27,2442.86
78133064,12/02/2023,-100.06,2342.8
78167719,31/01/2023,,969.06
78167719,03/02/2023,53.43,1022.4899999999999
78167719,03/02/2023,-130.91,891.5799999999999
78167719,04/02/2023,944.5,1836.08
78167719,04/02/2023,71.57,1907.6499999999999
78167719,07/02/2023,142.95,2050.6
78167719,07/02/2023,-84.81,1965.79
78167719,09/02/2023,-63.95,1901.84
78167719,14/02/2023,-97.06,1804.78
78167719,14/02/2023,-110.42,1694.36
78167719,14/02/2023,-147.72,1546.6399999999999
78175956,31/01/2023,,124.55
78175956,02/02/2023,114.44,238.99
78175956,04/02/2023,-74.84,164.14999999999998
78175956,06/02/2023,106.31,270.46
78175956,09/02/2023,-10.05,260.40999999999997
78175956,14/02/2023,-61.34,199.07
78184766,31/01/2023,,98.1
78184766,05/02/2023,-109.41,-11.310000000000002
78184766,08/02/2023,43.9,32.589999999999996
78184766,08/02/2023,-68.63,-36.04
78184766,10/02/2023,-75.51,-111.55000000000001
78184766,12/02/2023,-76.71,-188.26
78234498,31/01/2023,,697.88
78234498,01/02/2023,69.18,767.06
78234498,04/02/2023,1369.6,2136.66
78234498,13/02/2023,112.88,2249.54
78257880,31/01/2023,,933.22
78257880,03/02/2023,753.5,1686.72
78257880,03/02/2023,180.52,1867.24
78257880,03/02/2023,97.96,1965.2
78257880,08/02/2023,151.47,2116.67
78257880,09/02/2023,548.3,2664.9700000000003
78257880,09/02/2023,-587.9,2077.07
78257880,10/02/2023,-31.28,2045.79
78268704,31/01/2023,,888.99
78268704,05/02/2023,997.4,1886.3899999999999
78268704,05/02/2023,141.36,2027.75
78268704,06/02/2023,431.9,2459.65
78268704,07/02/2023,-26.33,2433.32
78268704,07/02/2023,-86.16,2347.16
78268704,13/02/2023,-24.32,2322.84
78296743,31/01/2023,,406.97
78296743,01/02/2023,-1888.2,-1481.23
78296743,02/02/2023,-108.67,-1589.9
78296743,07/02/2023,-94.27,-1684.17
78296743,08/02/2023,96.34,-1587.83
78296743,08/02/2023,-36.72,-1624.55
78296743,08/02/2023,-154.6,-1779.15
78296743,09/02/2023,-103.44,-1882.59
78296743,10/02/2023,-66.19,-1948.78
78296743,10/02/2023,-143.84,-2092.62
78296743,13/02/2023,62.36,-2030.26
78296743,13/02/2023,-334.9,-2365.16
78303304,31/01/2023,,921.4
78303304,03/02/2023,-108.32,813.0799999999999
78303304,06/02/2023,-91.58,721.5
78303304,08/02/2023,130.43,851.9300000000001
78343618,31/01/2023,,30.43
78343618,01/02/2023,80.43,110.86000000000001
78343618,01/02/2023,9.32,120.18
78343618,02/02/2023,72.9,193.08
78343618,02/02/2023,-1193.3,-1000.2199999999999
78343618,03/02/2023,-1632.0,-2632.22
78343618,08/02/2023,107.47,-2524.75
78343618,13/02/2023,164.76,-2359.99
78362587,31/01/2023,,390.79
78362587,01/02/2023,-1292.5,-901.71
78362587,02/02/2023,142.45,-759.26
78362587,02/02/2023,-1499.9,-2259.16
78362587,04/02/2023,1266.4,-992.76
78362587,04/02/2023,-66.32,-1059.08
78362587,04/02/2023,-1510.5,-2569.58
78362587,07/02/2023,-136.3,-2705.88
78362587,10/02/2023,35.64,-2670.24
78362587,10/02/2023,-25.41,-2695.65
78362587,12/02/2023,-118.77,-2814.42
78392456,31/01/2023,,592.04
78392456,02/02/2023,123.8,715.8399999999999
78392456,04/02/2023,-41.13,674.7099999999999
78392456,05/02/2023,65.73,740.4399999999999
78392456,07/02/2023,-71.99,668.4499999999999
78392456,09/02/2023,158.77,827.22
78392456,10/02/2023,-222.4,604.8199999999999
78392456,11/02/2023,205.44,810.26
78392456,11/02/2023,94.31,904.5699999999999
78392456,12/02/2023,108.51,1013.0799999999999
78392456,13/02/2023,-42.54,970.54
78395863,31/01/2023,,458.24
78395863,01/02/2023,168.34,626.58
78395863,02/02/2023,379.5,1006.08
78395863,02/02/2023,-101.46,904.62
78395863,03/02/2023,-153.58,751.04
78395863,09/02/2023,-49.68,701.36
78395863,10/02/2023,85.31,786.6700000000001
78395863,11/02/2023,-126.78,659.89
78395863,12/02/2023,-1619.3,-959.41
78395863,13/02/2023,177.52,-781.89
78493642,31/01/2023,,748.98
78493642,02/02/2023,53.59,802.57
78493642,02/02/2023,-54.11,748.46
78493642,02/02/2023,-103.47,644.99
78493642,07/02/2023,185.02,830.01
78493642,07/02/2023,113.23,943.24
78493642,07/02/2023,65.6,1008.84
78493642,09/02/2023,134.78,1143.6200000000001
78493642,10/02/2023,167.69,1311.31
78493642,13/02/2023,161.8,1473.1100000000001
78501355,31/01/2023,,910.42
78501355,04/02/2023,1610.8,2521.22
78501355,07/02/2023,210.28,2731.5
78501355,10/02/2023,1038.8,3770.3
78541427,31/01/2023,,366.51
78541427,03/02/2023,718.2,1084.71
78541427,06/02/2023,-981.9,102.81000000000006
78541427,06/02/2023,-1751.6,-1648.79
78541427,07/02/2023,76.58,-1572.21
78541427,09/02/2023,-32.87,-1605.08
78541427,13/02/2023,116.3,-1488.78
78541427,14/02/2023,-95.3,-1584.08
78580221,31/01/2023,,271.94
78580221,01/02/2023,105.16,377.1
78580221,06/02/2023,-121.13,255.97
78580221,12/02/2023,-96.6,159.37
78580221,12/02/2023,-197.29,-37.91999999999999
78580221,14/02/2023,119.48,81.56000000000002
78584818,31/01/2023,,723.21
78584818,02/02/2023,122.42,845.63
78584818,03/02/2023,119.02,964.6500000000001
78584818,07/02/2023,124.55,1089.2
78584818,09/02/2023,-56.03,1033.17
78667134,31/01/2023,,672.23
78667134,02/02/2023,-93.09,579.14
78667134,03/02/2023,-135.44,443.70000000000005
78667134,04/02/2023,153.31,597.01
78667134,04/02/2023,39.71,636.72
78667134,08/02/2023,-97.07,539.6500000000001
78667134,13/02/2023,77.77,617.4200000000001
78667134,13/02/2023,-55.07,562.35
78667134,14/02/2023,-68.56,493.79
78673350,31/01/2023,,307.25
78673350,03/02/2023,74.72,381.97
78673350,08/02/2023,112.44,494.40999999999997
78673350,09/02/2023,-137.17,357.24
78673350,14/02/2023,18.62,375.86
78716149,31/01/2023,,658.83
78716149,01/02/2023,-49.84,608.99
78716149,02/02/2023,-184.29,424.70000000000005
78716149,06/02/2023,38.7,463.40000000000003
78716149,08/02/2023,40.13,503.53000000000003
78716149,10/02/2023,-106.03,397.50000000000006
78716149,14/02/2023,85.81,483.31000000000006
78767161,31/01/2023,,248.42
78767161,01/02/2023,-115.41,133.01
78767161,02/02/2023,22.54,155.54999999999998
78767161,02/02/2023,-133.59,21.95999999999998
78767161,05/02/2023,-185.3,-163.34000000000003
78767161,06/02/2023,8.04,-155.30000000000004
78767161,06/02/2023,-69.84,-225.14000000000004
78767161,08/02/2023,110.07,-115.07000000000005
78767161,11/02/2023,75.14,-39.93000000000005
78767161,14/02/2023,-103.18,-143.11000000000007
78773905,31/01/2023,,511.78
78773905,10/02/2023,-189.51,322.27
78773905,11/02/2023,-1104.5,-782.23
78773905,12/02/2023,116.83,-665.4
78773905,12/02/2023,-51.02,-716.4200000000001
78773905,13/02/2023,-38.13,-754.5500000000001
78807944,31/01/2023,,442.48
78807944,01/02/2023,-90.9,351.58000000000004
78807944,04/02/2023,-134.34,217.24
78807944,06/02/2023,141.23,358.47
78807944,07/02/2023,226.83,585.3
78807944,08/02/2023,-9.19,576.11
78807944,10/02/2023,152.17,728.28
78807944,12/02/2023,-75.44,652.84
78807944,12/02/2023,-169.34,483.5
78807944,13/02/2023,92.53,576.03
78807944,13/02/2023,-161.8,414.23
78844183,31/01/2023,,194.7
78844183,02/02/2023,-12.35,182.35
78844183,05/02/2023,-181.42,0.9300000000000068
78844183,06/02/2023,-132.29,-131.35999999999999
78844183,12/02/2023,-50.34,-181.7
78844183,13/02/2023,-101.09,-282.78999999999996
78905675,31/01/2023,,11.18
78905675,01/02/2023,-84.08,-72.9
78905675,04/02/2023,-138.04,-210.93999999999997
78905675,05/02/2023,-101.84,-312.78
78905675,08/02/2023,129.7,-183.07999999999998
78905675,08/02/2023,100.85,-82.22999999999999
78905675,08/02/2023,53.66,-28.569999999999993
78905675,09/02/2023,35.18,6.6100000000000065
78905675,10/02/2023,11.07,17.680000000000007
78905675,13/02/2023,-48.01,-30.32999999999999
78905675,13/02/2023,-79.92,-110.25
78913378,31/01/2023,,378.08
78913378,01/02/2023,-84.25,293.83
78913378,03/02/2023,-127.62,166.20999999999998
78913378,04/02/2023,68.87,235.07999999999998
78913378,04/02/2023,-143.88,91.19999999999999
78913378,05/02/2023,-58.45,32.749999999999986
78913378,06/02/2023,-711.2,-678.45
78913378,08/02/2023,146.5,-531.95
78913378,12/02/2023,-72.09,-604.0400000000001
78913378,12/02/2023,-85.39,-689.4300000000001
78927989,31/01/2023,,825.23
78927989,02/02/2023,22.64,847.87
78927989,05/02/2023,-60.35,787.52
78927989,05/02/2023,-1174.8,-387.28
78927989,07/02/2023,-105.18,-492.46
78927989,09/02/2023,217.27,-275.18999999999994
78927989,09/02/2023,153.45,-121.73999999999998
78927989,11/02/2023,-148.81,-270.54999999999995
78927989,12/02/2023,66.32,-204.23
78927989,13/02/2023,66.55,-137.68
78927989,13/02/2023,52.26,-85.41999999999999
78927989,14/02/2023,-31.7,-117.11999999999999
78927989,14/02/2023,-34.84,-151.95999999999998
78945298,31/01/2023,,609.68
78945298,03/02/2023,100.81,710.49
78945298,04/02/2023,1320.2,2030.69
78945298,05/02/2023,119.75,2150.44
78945298,05/02/2023,115.53,2265.9700000000003
78945298,07/02/2023,883.6,3149.57
78945298,07/02/2023,-194.01,2955.56
78945298,08/02/2023,58.82,3014.38
78945298,09/02/2023,-115.06,2899.32
78953379,31/01/2023,,45.3
78953379,02/02/2023,-181.56,-136.26
78953379,05/02/2023,53.54,-82.72
78953379,05/02/2023,-325.0,-407.72
78953379,10/02/2023,80.36,-327.36
78953379,12/02/2023,85.93,-241.43
78953379,12/02/2023,53.57,-187.86
78953379,14/02/2023,-63.74,-251.60000000000002
79015773,31/01/2023,,706.11
79015773,03/02/2023,-74.72,631.39
79015773,10/02/2023,111.05,742.44
79015773,11/02/2023,74.36,816.8
79015773,12/02/2023,-91.81,724.99
79015773,12/02/2023,-95.84,629.15
79015773,13/02/2023,39.15,668.3
79015773,14/02/2023,118.75,787.05
79033058,31/01/2023,,97.12
79033058,01/02/2023,-167.53,-70.41
79033058,02/02/2023,-117.49,-187.89999999999998
79033058,04/02/2023,1454.9,1267.0
79033058,09/02/2023,-1504.7,-237.70000000000005
79033058,12/02/2023,68.89,-168.81000000000006
79033058,13/02/2023,-47.82,-216.63000000000005
79036903,31/01/2023,,491.23
79036903,01/02/2023,16.06,507.29
79036903,03/02/2023,-45.41,461.88
79036903,09/02/2023,181.31,643.19
79036903,09/02/2023,-119.51,523.6800000000001
79036903,10/02/2023,-179.1,344.58000000000004
79036903,11/02/2023,-64.21,280.37000000000006
79036903,11/02/2023,-72.7,207.67000000000004
79036903,11/02/2023,-137.26,70.41000000000005
79036903,13/02/2023,-161.44,-91.02999999999994
79036903,14/02/2023,-141.13,-232.15999999999994
79069274,31/01/2023,,685.1
79069274,03/02/2023,-104.0,581.1
79069274,09/02/2023,-97.15,483.95000000000005
79069274,12/02/2023,-103.74,380.21000000000004
79069274,13/02/2023,-86.79,293.42
79090076,31/01/2023,,119.25
79090076,01/02/2023,130.83,250.08
79090076,02/02/2023,1520.8,1770.8799999999999
79090076,02/02/2023,-551.2,1219.6799999999998
79090076,03/02/2023,187.7,1407.3799999999999
79090076,07/02/2023,-54.35,1353.0299999999997
79090076,07/02/2023,-126.32,1226.7099999999998
79090076,09/02/2023,210.8,1437.5099999999998
79090076,09/02/2023,-101.12,1336.3899999999999
79090076,13/02/2023,-144.82,1191.57
79090076,14/02/2023,174.26,1365.83
79091642,31/01/2023,,961.45
79091642,02/02/2023,663.6,1625.0500000000002
79091642,05/02/2023,110.12,1735.17
79091642,07/02/2023,133.96,1869.13
79091642,10/02/2023,64.46,1933.5900000000001
79091642,10/02/2023,-125.47,1808.1200000000001
79118116,31/01/2023,,463.1
79118116,01/02/2023,55.58,518.6800000000001
79118116,01/02/2023,-105.55,413.13
79118116,02/02/2023,-136.38,276.75
79118116,04/02/2023,122.06,398.81000000000006
79118116,06/02/2023,141.06,539.87
79118116,07/02/2023,-101.44,438.43000000000006
79118116,10/02/2023,97.03,535.46
79147964,31/01/2023,,753.1
79147964,01/02/2023,169.68,922.78
79147964,01/02/2023,102.61,1025.39
79147964,01/02/2023,-52.32,973.07
79147964,02/02/2023,130.9,1103.97
79147964,02/02/2023,-183.83,920.14
79147964,04/02/2023,210.25,1130.39
79147964,05/02/2023,-63.7,1066.69
79163824,31/01/2023,,938.15
79163824,01/02/2023,-899.8,38.35000000000002
79163824,04/02/2023,-63.81,-25.45999999999998
79163824,06/02/2023,125.82,100.36000000000001
79163824,06/02/2023,81.68,182.04000000000002
79163824,12/02/2023,111.68,293.72
79163824,14/02/2023,147.24,440.96000000000004
79169988,31/01/2023,,354.01
79169988,02/02/2023,136.38,490.39
79169988,06/02/2023,51.53,541.92
79169988,08/02/2023,-31.3,510.62
79169988,08/02/2023,-102.11,408.51
79169988,09/02/2023,827.3,1235.81
79169988,10/02/2023,212.1,1447.9099999999999
79169988,13/02/2023,58.3,1506.21
79169988,13/02/2023,-93.56,1412.6499999999999
79181666,31/01/2023,,600.88
79181666,04/02/2023,103.33,704.21
79181666,08/02/2023,-138.31,565.9
79181666,09/02/2023,123.84,689.74
79181666,10/02/2023,66.98,756.72
79181666,11/02/2023,77.77,834.49
79181666,12/02/2023,108.96,943.4499999999999
79181666,14/02/2023,129.59,1073.04
79181666,14/02/2023,-129.29,943.75
79213491,31/01/2023,,308.65
79213491,03/02/2023,-49.16,259.49
79213491,05/02/2023,-51.72,207.76999999999998
79213491,05/02/2023,-216.4,-8.630000000000024
79213491,07/02/2023,-11.99,-20.620000000000026
79213491,09/02/2023,-37.9,-58.520000000000024
79307217,31/01/2023,,307.87
79307217,02/02/2023,93.31,401.18
79307217,08/02/2023,26.82,428.0
79307217,09/02/2023,101.37,529.37
79307217,10/02/2023,79.08,608.45
79307217,13/02/2023,60.19,668.64
79309039,31/01/2023,,642.08
79309039,01/02/2023,-96.14,545.94
79309039,03/02/2023,164.94,710.8800000000001
79309039,04/02/2023,124.74,835.62
79309039,06/02/2023,78.77,914.3900000000001
79309039,06/02/2023,-977.0,-62.6099999999999
79309039,11/02/2023,-90.71,-153.31999999999988
79309039,11/02/2023,-94.31,-247.62999999999988
79325967,31/01/2023,,647.65
79325967,04/02/2023,157.32,804.97
79329254,31/01/2023,,984.43
79329254,08/02/2023,-83.02,901.41
79329254,10/02/2023,90.32,991.7299999999999
79329254,12/02/2023,1143.7,2135.43
79329254,12/02/2023,164.03,2299.46
79329254,12/02/2023,-95.14,2204.32
79355498,31/01/2023,,132.74
79355498,01/02/2023,812.6,945.34
79355498,03/02/2023,-119.56,825.78
79355498,05/02/2023,-74.28,751.5
79355498,06/02/2023,162.2,913.7
79380893,31/01/2023,,163.15
79380893,01/02/2023,-63.11,100.04
79380893,02/02/2023,174.74,274.78000000000003
79380893,03/02/2023,119.68,394.46000000000004
79380893,03/02/2023,-146.88,247.58000000000004
79380893,09/02/2023,196.47,444.05000000000007
79380893,12/02/2023,28.61,472.66
79380893,12/02/2023,-122.48,350.18000000000006
79380893,12/02/2023,-160.14,190.04000000000005
79415620,31/01/2023,,729.51
79415620,07/02/2023,104.64,834.15
79415620,08/02/2023,-113.38,720.77
79415620,10/02/2023,-117.79,602.98
79415620,11/02/2023,6.42,609.4
79415620,14/02/2023,95.3,704.7
79415620,14/02/2023,-64.1,640.6
79435523,31/01/2023,,920.0
79435523,03/02/2023,-17.57,902.43
79435523,04/02/2023,100.66,1003.09
79435523,08/02/2023,-140.73,862.36
79435523,12/02/2023,91.9,954.26
79435523,13/02/2023,-1397.6,-443.3399999999999
79499412,31/01/2023,,159.51
79499412,01/02/2023,960.8,1120.31
79499412,01/02/2023,527.1,1647.4099999999999
79499412,14/02/2023,43.42,1690.83
79566165,31/01/2023,,64.47
79566165,01/02/2023,-86.03,-21.560000000000002
79566165,04/02/2023,-98.42,-119.98
79566165,05/02/2023,94.95,-25.03
79566165,05/02/2023,94.45,69.42
79566165,08/02/2023,132.45,201.87
79566165,09/02/2023,18.36,220.23000000000002
79566165,11/02/2023,70.24,290.47
79566165,12/02/2023,-140.52,149.95
79566165,14/02/2023,-86.86,63.08999999999999
79566627,31/01/2023,,377.62
79566627,02/02/2023,-876.4,-498.78
79566627,03/02/2023,-108.13,-606.91
79566627,04/02/2023,122.23,-484.67999999999995
79566627,04/02/2023,-105.93,-590.61
79566627,05/02/2023,-17.69,-608.3
79566627,07/02/2023,167.72,-440.58
79566627,08/02/2023,-170.5,-611.0799999999999
79566627,09/02/2023,-109.28,-720.36
79566627,12/02/2023,-115.11,-835.47
79566627,13/02/2023,-81.86,-917.3299999999999
79566627,14/02/2023,72.35,-844.98
79570236,31/01/2023,,91.66
79570236,05/02/2023,-158.27,-66.61000000000001
79570236,07/02/2023,-101.36,-167.97000000000003
79570236,08/02/2023,1168.1,1000.1299999999999
79570236,11/02/2023,-1000.2,-0.07000000000016371
79599747,31/01/2023,,393.28
79599747,02/02/2023,-57.66,335.62
79599747,03/02/2023,92.94,428.55999999999995
79599747,04/02/2023,109.45,538.01
79599747,06/02/2023,125.59,663.6
79632523,31/01/2023,,867.95
79632523,04/02/2023,149.33,1017.2800000000001
79632523,04/02/2023,146.68,1163.96
79632523,04/02/2023,95.05,1259.01
79632523,05/02/2023,-129.27,1129.74
79632523,08/02/2023,93.73,1223.47
79632523,12/02/2023,-910.1,313.37
79656112,31/01/2023,,848.18
79656112,04/02/2023,-157.32,690.8599999999999
79656112,04/02/2023,-199.41,491.44999999999993
79656355,31/01/2023,,766.41
79656355,01/02/2023,1820.3,2586.71
79656355,02/02/2023,186.07,2772.7799999999997
79656355,05/02/2023,-85.62,2687.16
79656355,07/02/2023,68.86,2756.02
79656355,08/02/2023,-115.99,2640.0299999999997
79656355,09/02/2023,-49.28,2590.75
79656355,10/02/2023,-165.02,2425.7299999999996
79656355,11/02/2023,-57.3,2368.43
79656355,13/02/2023,94.19,2462.62
79656355,14/02/2023,666.1,3128.72
79656355,14/02/2023,-150.19,2978.5299999999997
79757019,31/01/2023,,369.26
79757019,01/02/2023,-116.57,252.69
79757019,04/02/2023,-116.65,136.04
79757019,05/02/2023,51.76,187.79999999999998
79757019,07/02/2023,74.11,261.90999999999997
79757019,13/02/2023,-93.14,168.76999999999998
79771974,31/01/2023,,350.67
79771974,03/02/2023,613.0,963.6700000000001
79771974,04/02/2023,159.42,1123.0900000000001
79771974,04/02/2023,-104.45,1018.6400000000001
79771974,07/02/2023,-98.57,920.07
79771974,09/02/2023,67.76,987.83
79771974,14/02/2023,-43.95,943.8800000000001
79792810,31/01/2023,,505.57
79792810,02/02/2023,-308.77,196.8
79792810,11/02/2023,-75.1,121.70000000000002
79792810,12/02/2023,98.23,219.93
79792810,12/02/2023,-142.78,77.15000000000003
79933337,31/01/2023,,508.79
79933337,01/02/2023,84.25,593.04
79933337,02/02/2023,-78.21,514.83
79933337,03/02/2023,1253.8,1768.63
79933337,04/02/2023,113.62,1882.25
79933337,09/02/2023,-125.98,1756.27
79933337,12/02/2023,-123.95,1632.32
80001684,31/01/2023,,572.24
80001684,05/02/2023,41.33,613.57
80001684,05/02/2023,-539.8,73.7700000000001
80005822,31/01/2023,,930.08
80005822,05/02/2023,160.23,1090.31
80005822,10/02/2023,90.04,1180.3500000000001
80005822,10/02/2023,-119.92,1060.43
80005822,12/02/2023,61.43,1121.8600000000001
80005822,14/02/2023,756.9,1878.76
80015485,31/01/2023,,310.56
80015485,05/02/2023,-56.51,254.05
80015485,10/02/2023,-92.86,161.19
80015485,14/02/2023,153.23,314.41999999999996
80040176,31/01/2023,,533.74
80040176,03/02/2023,137.98,671.72
80040176,03/02/2023,-94.07,577.65
80040176,07/02/2023,-21.02,556.63
80040176,07/02/2023,-156.4,400.23
80040176,08/02/2023,110.48,510.71
80040176,11/02/2023,-245.04,265.67
80040176,13/02/2023,-60.19,205.48000000000002
80046304,31/01/2023,,951.74
80046304,03/02/2023,99.68,1051.42
80046304,03/02/2023,-70.99,980.4300000000001
80046304,04/02/2023,53.03,1033.46
80046304,04/02/2023,-167.73,865.73
80046304,05/02/2023,190.01,1055.74
80046304,06/02/2023,-109.48,946.26
80046304,13/02/2023,120.16,1066.42
80046304,14/02/2023,36.6,1103.02
80135904,31/01/2023,,120.34
80135904,03/02/2023,993.7,1114.04
80135904,05/02/2023,-92.28,1021.7600000000001
80135904,07/02/2023,-86.83,934.9300000000001
80135904,08/02/2023,119.48,1054.41
80135904,13/02/2023,375.1,1429.5100000000002
80168427,31/01/2023,,19.01
80168427,01/02/2023,-81.22,-62.209999999999994
80168427,01/02/2023,-181.06,-243.26999999999998
80168427,03/02/2023,75.28,-167.98999999999998
80168427,04/02/2023,-138.34,-306.33
80168427,06/02/2023,102.2,-204.13
80184223,31/01/2023,,52.59
80184223,07/02/2023,-153.24,-100.65
80184223,10/02/2023,195.79,95.13999999999999
80184223,12/02/2023,95.71,190.84999999999997
80184223,12/02/2023,-13.57,177.27999999999997
80244844,31/01/2023,,774.54
80244844,01/02/2023,-90.07,684.47
80244844,04/02/2023,128.19,812.66
80244844,04/02/2023,-115.56,697.0999999999999
80244844,04/02/2023,-199.36,497.73999999999995
80244844,08/02/2023,140.07,637.81
80244844,08/02/2023,-149.73,488.0799999999999
80244844,09/02/2023,136.3,624.38
80244844,11/02/2023,139.56,763.9399999999999
80244844,11/02/2023,40.81,804.75
80244844,14/02/2023,51.9,856.65
80283776,31/01/2023,,334.03
80283776,02/02/2023,83.88,417.90999999999997
80283776,02/02/2023,-148.09,269.81999999999994
80283776,06/02/2023,-22.17,247.64999999999998
80283776,07/02/2023,-121.67,125.97999999999996
80283776,08/02/2023,92.84,218.81999999999996
80283776,08/02/2023,-123.29,95.52999999999996
80283776,13/02/2023,-40.02,55.509999999999955
80291188,31/01/2023,,338.65
80291188,01/02/2023,70.27,408.91999999999996
80291188,05/02/2023,-124.52,284.4
80291188,07/02/2023,38.29,322.69
80291188,08/02/2023,23.79,346.47999999999996
80291188,11/02/2023,-71.24,275.24
80291188,11/02/2023,-75.48,199.76
80291188,12/02/2023,-75.56,124.19999999999997
80291188,13/02/2023,111.96,236.15999999999997
80304720,31/01/2023,,614.87
80304720,01/02/2023,170.25,785.12
80304720,05/02/2023,-68.75,716.37
80325529,31/01/2023,,996.6
80325529,03/02/2023,44.0,1040.6
80325529,03/02/2023,-125.34,915.26
80325529,05/02/2023,145.13,1060.39
80325529,05/02/2023,-196.0,864.39
80325529,11/02/2023,590.6,1454.99
80325529,13/02/2023,71.7,1526.69
80355773,31/01/2023,,906.28
80355773,01/02/2023,-37.94,868.3399999999999
80355773,03/02/2023,122.53,990.87
80355773,03/02/2023,-5.38,985.49
80355773,05/02/2023,-122.18,863.31
80355773,09/02/2023,-82.14,781.17
80355773,13/02/2023,56.91,838.0799999999999
80355773,14/02/2023,-553.6,284.4799999999999
80360244,31/01/2023,,658.35
80360244,03/02/2023,-134.13,524.22
80360244,05/02/2023,-83.59,440.63
80360244,06/02/2023,-81.68,358.95000000000005
80360244,06/02/2023,-1947.3,-1588.35
80360244,07/02/2023,14.81,-1573.54
80360244,09/02/2023,76.61,-1496.9299999999998
80360244,10/02/2023,-11.31,-1508.24
80379245,31/01/2023,,793.17
80379245,01/02/2023,-56.06,737.1099999999999
80379245,03/02/2023,146.59,883.6999999999999
80379245,06/02/2023,61.92,945.62
80379245,06/02/2023,-1.58,944.04
80379245,07/02/2023,106.24,1050.28
80379245,08/02/2023,-85.29,964.99
80379245,09/02/2023,-40.77,924.2199999999999
80379245,13/02/2023,107.98,1032.2
80391084,31/01/2023,,466.35
80391084,03/02/2023,-584.3,-117.94999999999993
80391084,06/02/2023,28.34,-89.60999999999993
80391084,07/02/2023,-122.13,-211.73999999999992
80391084,14/02/2023,-116.9,-328.63999999999993
80428983,31/01/2023,,323.32
80428983,02/02/2023,-53.59,269.73
80428983,04/02/2023,158.41,428.14
80428983,09/02/2023,87.99,516.13
80428983,11/02/2023,-58.01,458.12
80428983,12/02/2023,-564.4,-106.27999999999997
80428983,13/02/2023,-68.69,-174.96999999999997
80428983,13/02/2023,-177.52,-352.49
80428983,14/02/2023,-60.97,-413.46
80439799,31/01/2023,,968.23
80439799,05/02/2023,49.95,1018.1800000000001
80439799,11/02/2023,62.33,1080.51
80439799,11/02/2023,-156.49,924.02
80439799,14/02/2023,-90.74,833.28
80464084,31/01/2023,,12.73
80464084,02/02/2023,145.27,158.0
80464084,03/02/2023,-32.08,125.92
80464084,04/02/2023,-189.06,-63.14
80464084,05/02/2023,80.67,17.53
80464084,06/02/2023,-70.94,-53.41
80464084,06/02/2023,-213.44,-266.85
80504934,31/01/2023,,759.22
80504934,04/02/2023,-74.95,684.27
80504934,06/02/2023,165.65,849.9200000000001
80504934,11/02/2023,-160.29,689.63
80504934,14/02/2023,114.98,804.61
80596699,31/01/2023,,47.06
80596699,01/02/2023,130.93,177.99
80596699,01/02/2023,123.08,301.07
80596699,03/02/2023,168.33,469.40000000000003
80596699,03/02/2023,91.37,560.77
80596699,04/02/2023,58.03,618.8000000000001
80596699,06/02/2023,85.9,704.7
80596699,06/02/2023,-35.38,669.32
80596699,07/02/2023,48.65,717.97
80596699,13/02/2023,-26.24,691.73
80610910,31/01/2023,,139.54
80610910,02/02/2023,-143.95,-4.409999999999997
80610910,05/02/2023,164.35,159.94
80610910,06/02/2023,-1032.3,-872.3599999999999
80610910,07/02/2023,214.17,-658.1899999999999
80678427,31/01/2023,,97.72
80678427,01/02/2023,102.9,200.62
80678427,01/02/2023,53.43,254.05
80678427,04/02/2023,-87.1,166.95000000000002
80678427,05/02/2023,142.28,309.23
80678427,08/02/2023,-136.73,172.50000000000003
80678427,08/02/2023,-144.26,28.240000000000038
80678427,08/02/2023,-1051.4,-1023.1600000000001
80678427,12/02/2023,106.86,-916.3000000000001
80678427,12/02/2023,-140.79,-1057.0900000000001
80678427,13/02/2023,136.9,-920.19
80678577,31/01/2023,,288.61
80678577,04/02/2023,94.62,383.23
80678577,11/02/2023,163.65,546.88
80678577,13/02/2023,75.02,621.9
80709302,31/01/2023,,280.92
80709302,05/02/2023,144.79,425.71000000000004
80709302,11/02/2023,2044.6,2470.31
80747298,31/01/2023,,768.33
80747298,09/02/2023,119.77,888.1
80747298,13/02/2023,138.24,1026.3400000000001
80758476,31/01/2023,,977.44
80758476,06/02/2023,91.53,1068.97
80758476,07/02/2023,-5.07,1063.9
80758476,11/02/2023,171.55,1235.45
80761210,31/01/2023,,545.59
80761210,01/02/2023,-143.85,401.74
80761210,04/02/2023,173.75,575.49
80761210,04/02/2023,-160.27,415.22
80761210,07/02/2023,-105.09,310.13
80761210,08/02/2023,73.68,383.81000000000006
80761210,10/02/2023,113.99,497.8
80778066,31/01/2023,,217.49
80778066,01/02/2023,-55.58,161.91000000000003
80778066,03/02/2023,149.87,311.78000000000003
80778066,03/02/2023,36.57,348.35
80778066,07/02/2023,56.13,404.48
80778066,08/02/2023,-2.72,401.76000000000005
80787776,31/01/2023,,460.46
80787776,01/02/2023,142.26,602.72
80787776,03/02/2023,72.41,675.13
80787776,03/02/2023,-22.26,652.87
80787776,05/02/2023,-102.9,549.9699999999999
80787776,05/02/2023,-1295.5,-745.5300000000001
80787776,10/02/2023,-112.36,-857.8900000000001
80787776,11/02/2023,-172.5,-1030.39
80787776,14/02/2023,150.42,-879.9700000000001
80808205,31/01/2023,,280.92
80808205,01/02/2023,-88.1,192.82000000000002
80808205,02/02/2023,-1082.7,-889.88
80808205,02/02/2023,-1698.0,-2587.88
80808205,03/02/2023,133.1,-2454.78
80808205,05/02/2023,73.78,-2381.0
80808205,06/02/2023,-59.6,-2440.6
80808205,11/02/2023,-193.89,-2634.4900000000002
80808205,13/02/2023,214.61,-2419.88
80808205,13/02/2023,-1017.6,-3437.48
80811957,31/01/2023,,139.95
80811957,05/02/2023,85.92,225.87
80811957,07/02/2023,-112.22,113.64999999999999
80811957,13/02/2023,40.65,154.29999999999998
80812213,31/01/2023,,277.14
80812213,07/02/2023,-81.75,195.39
80812213,07/02/2023,-103.35,92.03999999999999
80812213,08/02/2023,-67.93,24.109999999999985
80818151,31/01/2023,,320.64
80818151,01/02/2023,75.36,396.0
80818151,02/02/2023,-10.1,385.9
80818151,06/02/2023,436.1,822.0
80877479,31/01/2023,,210.98
80877479,03/02/2023,101.25,312.23
80877479,05/02/2023,-112.01,200.21999999999997
80877479,06/02/2023,-84.1,116.11999999999999
80877479,06/02/2023,-1457.8,-1341.68
80877479,07/02/2023,66.67,-1275.01
80877479,09/02/2023,203.24,-1071.77
80884901,31/01/2023,,453.71
80884901,05/02/2023,-179.02,274.68999999999994
80884901,06/02/2023,-59.73,214.95999999999998
80884901,07/02/2023,-85.23,129.72999999999996
80884901,09/02/2023,-128.31,1.419999999999959
80884901,11/02/2023,34.89,36.30999999999996
80884901,14/02/2023,61.16,97.46999999999996
80889919,31/01/2023,,298.45
80889919,06/02/2023,-20.39,278.06
80889919,08/02/2023,130.71,408.77
80938878,31/01/2023,,29.73
80938878,02/02/2023,24.23,53.96
80938878,08/02/2023,-70.5,-16.54
80938878,12/02/2023,151.29,134.75
80939694,31/01/2023,,923.76
80939694,04/02/2023,861.1,1784.8600000000001
80939694,05/02/2023,102.47,1887.33
80939694,08/02/2023,66.57,1953.9
80939694,08/02/2023,-79.57,1874.33
80939694,13/02/2023,-64.31,1810.02
80940019,31/01/2023,,957.41
80940019,02/02/2023,308.77,1266.1799999999998
80940019,03/02/2023,-612.6,653.5799999999999
80940019,07/02/2023,-301.0,352.5799999999999
80940019,11/02/2023,152.11,504.68999999999994
81049128,31/01/2023,,694.91
81049128,06/02/2023,113.47,808.38
81049128,09/02/2023,-1727.8,-919.42
81049128,10/02/2023,-191.56,-1110.98
81049128,11/02/2023,74.61,-1036.37
81075588,31/01/2023,,297.73
81075588,01/02/2023,99.3,397.03000000000003
81075588,01/02/2023,93.43,490.46000000000004
81075588,06/02/2023,100.09,590.5500000000001
81075588,08/02/2023,143.85,734.4000000000001
81075588,08/02/2023,117.07,851.47
81075588,09/02/2023,128.74,980.21
81075588,09/02/2023,-123.35,856.86
81075588,10/02/2023,-167.51,689.35
81075588,10/02/2023,-169.0,520.35
81075588,11/02/2023,-96.34,424.01000000000005
81075588,11/02/2023,-152.76,271.25000000000006
81087182,31/01/2023,,861.31
81087182,04/02/2023,-107.78,753.53
81087182,05/02/2023,-142.19,611.3399999999999
81087182,06/02/2023,-136.6,474.73999999999995
81087182,09/02/2023,-165.96,308.78
81087182,14/02/2023,153.66,462.43999999999994
81099534,31/01/2023,,216.8
81099534,01/02/2023,-99.68,117.12
81099534,04/02/2023,138.04,255.16
81099534,11/02/2023,68.14,323.3
81099534,14/02/2023,-117.23,206.07
81145048,31/01/2023,,290.02
81145048,02/02/2023,-115.05,174.96999999999997
81145048,03/02/2023,-131.54,43.43000000000001
81145048,05/02/2023,859.9,903.3299999999999
81145048,06/02/2023,51.78,955.11
81145048,09/02/2023,-898.2,56.90999999999997
81145048,12/02/2023,-99.41,-42.50000000000003
81145048,12/02/2023,-170.71,-213.21000000000004
81159651,31/01/2023,,466.71
81159651,02/02/2023,-44.56,422.15
81159651,05/02/2023,126.51,548.66
81159651,07/02/2023,55.28,603.9399999999999
81159651,08/02/2023,-132.1,471.84
81159651,09/02/2023,-67.99,403.84999999999997
81159651,12/02/2023,-109.6,294.25
81159651,13/02/2023,437.5,731.75
81159651,14/02/2023,-42.19,689.56
81181209,31/01/2023,,828.91
81181209,02/02/2023,-58.23,770.68
81181209,09/02/2023,181.77,952.45
81181209,09/02/2023,118.7,1071.15
81181209,09/02/2023,7.44,1078.59
81181209,10/02/2023,1210.3,2288.89
81181209,11/02/2023,-104.35,2184.54
81191580,31/01/2023,,584.56
81191580,06/02/2023,-14.55,570.01
81191580,10/02/2023,-145.53,424.4799999999999
81191580,12/02/2023,143.1,567.5799999999999
81191580,12/02/2023,76.93,644.51
81191580,14/02/2023,-135.36,509.1499999999999
81200849,31/01/2023,,479.29
81200849,03/02/2023,132.53,611.82
81200849,06/02/2023,63.33,675.15
81200849,06/02/2023,-99.31,575.84
81200849,07/02/2023,-76.35,499.49
81200849,08/02/2023,9.98,509.47
81200849,11/02/2023,18.39,527.86
81200849,12/02/2023,-165.42,362.44000000000005
81206535,31/01/2023,,452.69
81206535,05/02/2023,117.78,570.47
81206535,05/02/2023,84.4,654.87
81206535,05/02/2023,29.75,684.62
81206535,08/02/2023,42.59,727.21
81206535,09/02/2023,-22.93,704.28
81206535,10/02/2023,190.89,895.17
81206535,13/02/2023,47.54,942.71
81206535,14/02/2023,-836.0,106.71000000000004
81227009,31/01/2023,,475.45
81227009,01/02/2023,95.83,571.28
81227009,01/02/2023,-33.49,537.79
81227009,03/02/2023,90.64,628.43
81227009,03/02/2023,-59.28,569.15
81227009,07/02/2023,91.92,661.0699999999999
81227009,10/02/2023,144.33,805.4
81227009,11/02/2023,75.12,880.52
81227009,11/02/2023,-39.39,841.13
81227009,12/02/2023,541.9,1383.03
81227009,12/02/2023,144.19,1527.22
81227009,13/02/2023,-136.4,1390.82
81227009,14/02/2023,50.66,1441.48
81227009,14/02/2023,-111.15,1330.33
81245588,31/01/2023,,775.87
81245588,05/02/2023,-85.92,689.95
81245588,10/02/2023,83.51,773.46
81245588,10/02/2023,-120.39,653.07
81245588,13/02/2023,69.73,722.8
81245588,14/02/2023,136.73,859.53
81267006,31/01/2023,,425.16
81267006,02/02/2023,168.67,593.83
81267006,03/02/2023,-69.26,524.57
81267006,05/02/2023,107.8,632.37
81267006,10/02/2023,1430.6,2062.97
81267006,10/02/2023,-135.89,1927.08
81336389,31/01/2023,,210.06
81336389,01/02/2023,119.5,329.56
81336389,03/02/2023,77.36,406.92
81336389,03/02/2023,-188.47,218.45
81336389,05/02/2023,-106.54,111.90999999999998
81336389,06/02/2023,-109.52,2.3899999999999864
81336389,09/02/2023,83.99,86.37999999999998
81336389,10/02/2023,-216.08,-129.70000000000005
81336389,13/02/2023,99.54,-30.16000000000001
81336389,13/02/2023,-149.91,-180.07
81336468,31/01/2023,,935.41
81336468,02/02/2023,807.9,1743.31
81336468,02/02/2023,779.9,2523.21
81336468,02/02/2023,-663.6,1859.61
81336468,02/02/2023,-1327.5,532.1099999999999
81336468,05/02/2023,37.98,570.0899999999999
81336468,06/02/2023,75.77,645.8599999999999
81336468,07/02/2023,127.56,773.4199999999998
81336468,09/02/2023,154.98,928.3999999999999
81336468,09/02/2023,146.02,1074.4199999999998
81337623,31/01/2023,,815.36
81337623,04/02/2023,-185.63,629.73
81337623,07/02/2023,183.44,813.1700000000001
81337623,10/02/2023,167.13,980.3
81337623,10/02/2023,101.56,1081.8600000000001
81337623,12/02/2023,-26.35,1055.51
81337623,14/02/2023,69.51,1125.02
81340143,31/01/2023,,647.34
81340143,05/02/2023,103.36,750.7
81340143,09/02/2023,-682.6,68.10000000000002
81340143,11/02/2023,-47.38,20.72000000000002
81384411,31/01/2023,,175.86
81384411,03/02/2023,174.31,350.17
81384411,04/02/2023,-1361.0,-1010.8299999999999
81384411,10/02/2023,-63.87,-1074.6999999999998
81384411,11/02/2023,67.21,-1007.4899999999999
81384411,11/02/2023,-205.44,-1212.9299999999998
81384411,12/02/2023,-114.27,-1327.1999999999998
81398388,31/01/2023,,979.87
81398388,02/02/2023,120.93,1100.8
81398388,02/02/2023,15.93,1116.73
81398388,09/02/2023,-115.5,1001.23
81398388,10/02/2023,-97.88,903.35
81398388,13/02/2023,-43.87,859.48
81445756,31/01/2023,,267.66
81445756,03/02/2023,-1253.8,-986.1399999999999
81445756,04/02/2023,-110.0,-1096.1399999999999
81475774,31/01/2023,,568.11
81475774,03/02/2023,-156.2,411.91
81475774,04/02/2023,1059.1,1471.01
81475774,04/02/2023,89.97,1560.98
81475774,07/02/2023,118.92,1679.9
81475774,10/02/2023,-58.79,1621.11
81475774,12/02/2023,-196.98,1424.13
81475774,13/02/2023,-66.54,1357.59
81527490,31/01/2023,,234.05
81527490,01/02/2023,-102.61,131.44
81527490,02/02/2023,108.67,240.11
81527490,05/02/2023,135.59,375.70000000000005
81527490,06/02/2023,1.14,376.84000000000003
81527490,07/02/2023,69.94,446.78000000000003
81527490,07/02/2023,-17.58,429.20000000000005
81527490,09/02/2023,-181.77,247.43
81527490,09/02/2023,-254.92,-7.489999999999981
81527490,12/02/2023,174.92,167.43
81527490,13/02/2023,100.05,267.48
81527490,13/02/2023,-115.44,152.04000000000002
81561788,31/01/2023,,454.89
81561788,02/02/2023,-1106.9,-652.0100000000001
81561788,05/02/2023,821.8,169.78999999999985
81561788,05/02/2023,-94.45,75.33999999999985
81561788,06/02/2023,48.45,123.78999999999985
81561788,07/02/2023,96.93,220.71999999999986
81561788,08/02/2023,85.01,305.72999999999985
81561788,09/02/2023,-109.32,196.40999999999985
81561788,11/02/2023,1777.8,1974.2099999999998
81561788,11/02/2023,121.33,2095.54
81590655,31/01/2023,,742.17
81590655,04/02/2023,54.34,796.51
81590655,05/02/2023,103.0,899.51
81590655,09/02/2023,-54.35,845.16
81590655,10/02/2023,712.2,1557.3600000000001
81646873,31/01/2023,,188.36
81646873,02/02/2023,-95.2,93.16000000000001
81646873,03/02/2023,-62.59,30.570000000000007
81646873,04/02/2023,78.93,109.50000000000001
81646873,06/02/2023,89.63,199.13
81646873,07/02/2023,81.96,281.09000000000003
81646873,09/02/2023,10.45,291.54
81646873,09/02/2023,-161.02,130.51999999999998
81646873,10/02/2023,679.8,810.3199999999999
81646873,13/02/2023,-100.5,709.8199999999999
81651344,31/01/2023,,219.55
81651344,06/02/2023,155.37,374.92
81651344,08/02/2023,-92.38,282.54
81651344,09/02/2023,-78.16,204.38000000000002
81655495,31/01/2023,,315.33
81655495,01/02/2023,-1139.7,-824.3700000000001
81655495,02/02/2023,-1091.2,-1915.5700000000002
81655495,03/02/2023,89.14,-1826.43
81655495,06/02/2023,191.25,-1635.1800000000003
81655495,14/02/2023,-81.21,-1716.39
81662619,31/01/2023,,712.33
81662619,01/02/2023,-137.9,574.4300000000001
81662619,06/02/2023,82.51,656.94
81662619,07/02/2023,152.96,809.9000000000001
81662619,10/02/2023,-34.99,774.9100000000001
81662619,12/02/2023,-109.89,665.02
81662619,14/02/2023,141.21,806.23
81727860,31/01/2023,,192.44
81727860,05/02/2023,-99.25,93.19
81727860,08/02/2023,76.65,169.84
81727860,09/02/2023,-193.78,-23.939999999999998
81740267,31/01/2023,,67.86
81740267,02/02/2023,110.38,178.24
81740267,06/02/2023,81.53,259.77
81740267,06/02/2023,-110.09,149.68
81823420,31/01/2023,,259.73
81823420,01/02/2023,102.1,361.83000000000004
81823420,04/02/2023,201.15,562.98
81823420,06/02/2023,-49.47,513.51
81823420,10/02/2023,8.29,521.8000000000001
81823420,11/02/2023,38.25,560.0500000000001
81855175,31/01/2023,,907.59
81855175,01/02/2023,-42.34,865.25
81855175,01/02/2023,-49.37,815.88
81855175,02/02/2023,75.11,890.99
81855175,03/02/2023,102.49,993.48
81855175,09/02/2023,-892.4,101.08000000000004
81855175,10/02/2023,-90.2,10.880000000000038
81855175,12/02/2023,-1801.4,-1790.52
81855175,14/02/2023,-32.96,-1823.48
81923993,31/01/2023,,686.37
81923993,05/02/2023,-637.3,49.07000000000005
81923993,10/02/2023,27.72,76.79000000000005
81923993,11/02/2023,142.72,219.51000000000005
81923993,11/02/2023,130.08,349.59000000000003
81923993,12/02/2023,-181.41,168.18000000000006
81923993,14/02/2023,541.0,709.1800000000001
81932657,31/01/2023,,146.81
81932657,01/02/2023,80.7,227.51
81932657,01/02/2023,58.0,285.51
81932657,08/02/2023,1044.7,1330.21
81932657,09/02/2023,-4.61,1325.6000000000001
81932657,12/02/2023,-79.12,1246.48
81994568,31/01/2023,,578.86
81994568,03/02/2023,47.78,626.64
81994568,03/02/2023,-20.43,606.21
81994568,04/02/2023,1510.5,2116.71
81994568,06/02/2023,58.84,2175.55
81994568,10/02/2023,1463.6,3639.1499999999996
81994568,10/02/2023,30.61,3669.7599999999998
81994568,10/02/2023,-75.99,3593.77
82002852,31/01/2023,,816.53
82002852,04/02/2023,148.35,964.88
82002852,06/02/2023,-49.21,915.67
82002852,09/02/2023,-61.13,854.54
82002852,12/02/2023,-119.03,735.51
82023979,31/01/2023,,744.37
82023979,02/02/2023,-1019.5,-275.13
82023979,03/02/2023,104.62,-170.51
82023979,10/02/2023,-107.4,-277.90999999999997
82027257,31/01/2023,,681.1
82027257,02/02/2023,129.77,810.87
82027257,07/02/2023,-118.19,692.6800000000001
82027257,11/02/2023,147.54,840.22
82027257,11/02/2023,122.19,962.4100000000001
82027257,11/02/2023,-184.66,777.75
82027257,12/02/2023,-154.82,622.9300000000001
82027257,13/02/2023,88.79,711.72
82027257,13/02/2023,-74.3,637.4200000000001
82043720,31/01/2023,,803.68
82043720,01/02/2023,52.9,856.5799999999999
82043720,04/02/2023,-118.34,738.24
82043720,08/02/2023,119.51,857.75
82043720,10/02/2023,-62.15,795.5999999999999
82043720,12/02/2023,96.27,891.8699999999999
82101740,31/01/2023,,469.34
82101740,01/02/2023,-72.19,397.15
82101740,02/02/2023,68.21,465.35999999999996
82101740,11/02/2023,30.14,495.5
82101740,12/02/2023,-153.41,342.09
82101740,13/02/2023,-43.53,298.55999999999995
82115900,31/01/2023,,446.89
82115900,14/02/2023,1308.6,1755.4899999999998
82177278,31/01/2023,,236.32
82177278,02/02/2023,924.0,1160.32
82177278,02/02/2023,-123.02,1037.3
82177278,08/02/2023,-105.67,931.6299999999999
82177278,09/02/2023,95.76,1027.3899999999999
82177278,10/02/2023,75.98,1103.37
82177278,11/02/2023,-64.7,1038.6699999999998
82177278,12/02/2023,-130.79,907.8799999999999
82177278,13/02/2023,-123.69,784.1899999999999
82177278,14/02/2023,191.52,975.7099999999999
82188502,31/01/2023,,788.02
82188502,01/02/2023,66.19,854.21
82188502,01/02/2023,-96.2,758.01
82188502,02/02/2023,109.3,867.31
82188502,03/02/2023,45.41,912.72
82188502,09/02/2023,-109.88,802.8399999999999
82188502,09/02/2023,-127.38,675.46
82188502,10/02/2023,110.41,785.87
82188502,10/02/2023,-73.39,712.48
82233451,31/01/2023,,795.71
82233451,01/02/2023,97.37,893.08
82233451,05/02/2023,-167.85,725.23
82233451,13/02/2023,155.44,880.6700000000001
82259327,31/01/2023,,982.72
82259327,03/02/2023,-134.35,848.37
82259327,04/02/2023,-944.5,-96.13
82259327,05/02/2023,1463.6,1367.4699999999998
82259327,07/02/2023,112.11,1479.5799999999997
82259327,07/02/2023,46.81,1526.3899999999999
82259327,09/02/2023,107.63,1634.0199999999998
82259327,10/02/2023,-94.84,1539.1799999999998
82263080,31/01/2023,,928.54
82263080,03/02/2023,-180.52,748.02
82263080,04/02/2023,98.52,846.54
82263080,11/02/2023,782.2,1628.74
82263080,12/02/2023,133.67,1762.41
82263080,13/02/2023,-59.69,1702.72
82283956,31/01/2023,,745.72
82283956,01/02/2023,-158.92,586.8000000000001
82283956,02/02/2023,58.23,645.0300000000001
82283956,03/02/2023,-349.6,295.43
82303710,31/01/2023,,619.98
82303710,03/02/2023,102.85,722.83
82303710,10/02/2023,112.61,835.44
82303710,14/02/2023,208.0,1043.44
82303710,14/02/2023,-91.7,951.74
82303710,14/02/2023,-1674.0,-722.26
82314789,31/01/2023,,735.77
82314789,01/02/2023,53.09,788.86
82314789,04/02/2023,-87.35,701.51
82314789,06/02/2023,155.01,856.52
82314789,09/02/2023,-1340.1,-483.5799999999999
82314789,13/02/2023,-75.81,-559.3899999999999
82424659,31/01/2023,,568.77
82424659,02/02/2023,56.94,625.71
82424659,05/02/2023,-186.17,439.53999999999996
82424659,09/02/2023,140.61,580.15
82424659,09/02/2023,-87.15,493.0
82424659,12/02/2023,151.48,644.48
82424659,13/02/2023,21.73,666.21
82461559,31/01/2023,,652.26
82461559,03/02/2023,-98.38,553.88
82461559,07/02/2023,117.08,670.96
82461559,07/02/2023,-117.08,553.88
82461559,08/02/2023,85.07,638.95
82461559,09/02/2023,-6.95,632.0
82461559,12/02/2023,37.14,669.14
82461559,13/02/2023,-167.76,501.38
82461559,14/02/2023,-118.75,382.63
82543932,31/01/2023,,279.1
82543932,03/02/2023,-104.78,174.32000000000002
82543932,05/02/2023,170.9,345.22
82543932,05/02/2023,-167.18,178.04000000000002
82543932,10/02/2023,-98.45,79.59000000000002
82543932,12/02/2023,-187.21,-107.61999999999999
82558079,31/01/2023,,381.22
82558079,02/02/2023,106.05,487.27000000000004
82558079,07/02/2023,-65.45,421.82000000000005
82558079,12/02/2023,26.9,448.72
82558079,13/02/2023,-54.59,394.13
82558079,13/02/2023,-77.1,317.03000000000003
82568859,31/01/2023,,32.21
82568859,03/02/2023,432.2,464.40999999999997
82568859,03/02/2023,37.0,501.40999999999997
82568859,05/02/2023,87.66,589.0699999999999
82568859,06/02/2023,-102.1,486.96999999999997
82568859,10/02/2023,110.62,597.5899999999999
82589836,31/01/2023,,648.06
82589836,02/02/2023,-39.13,608.93
82589836,03/02/2023,207.91,816.8399999999999
82589836,08/02/2023,77.26,894.0999999999999
82589836,09/02/2023,-146.02,748.0799999999999
82589836,13/02/2023,-113.04,635.04
82589836,13/02/2023,-137.63,497.4099999999999
82696309,31/01/2023,,352.08
82696309,01/02/2023,90.9,442.98
82696309,11/02/2023,-114.97,328.01
82696309,13/02/2023,-63.14,264.87
82734145,31/01/2023,,278.57
82734145,02/02/2023,185.74,464.31
82734145,07/02/2023,124.86,589.17
82734145,09/02/2023,-94.06,495.11
82734145,12/02/2023,-85.04,410.07
82734145,13/02/2023,650.5,1060.57
82734145,13/02/2023,116.52,1177.09
82734145,13/02/2023,85.84,1262.9299999999998
82764940,31/01/2023,,876.37
82764940,01/02/2023,42.34,918.71
82764940,02/02/2023,1117.0,2035.71
82764940,02/02/2023,-100.46,1935.25
82764940,10/02/2023,-1580.9,354.3499999999999
82764940,12/02/2023,153.05,507.3999999999999
82764940,12/02/2023,127.13,634.53
82764940,14/02/2023,182.1,816.6299999999999
82776251,31/01/2023,,747.11
82776251,01/02/2023,91.77,838.88
82776251,03/02/2023,123.38,962.26
82776251,04/02/2023,-1315.2,-352.94000000000005
82776251,11/02/2023,202.15,-150.79000000000005
82807528,31/01/2023,,117.15
82807528,02/02/2023,128.03,245.18
82807528,02/02/2023,-109.57,135.61
82807528,03/02/2023,79.68,215.29000000000002
82807528,09/02/2023,-18.91,196.38000000000002
82807528,13/02/2023,-45.1,151.28000000000003
82807528,14/02/2023,-71.88,79.40000000000002
82807528,14/02/2023,-113.52,-34.119999999999976
82879607,31/01/2023,,72.18
82879607,06/02/2023,-171.29,-99.10999999999999
82879607,08/02/2023,102.11,3.000000000000014
82879607,11/02/2023,164.37,167.37
82879607,12/02/2023,-109.8,57.57000000000001
82879607,13/02/2023,75.81,133.38
82879607,14/02/2023,-117.24,16.140000000000015
82911152,31/01/2023,,564.11
82911152,02/02/2023,109.06,673.1700000000001
82911152,02/02/2023,-68.58,604.59
82911152,11/02/2023,118.19,722.78
82911152,11/02/2023,42.9,765.6800000000001
82911152,11/02/2023,-1104.0,-338.31999999999994
82911152,13/02/2023,-169.23,-507.54999999999995
82911152,14/02/2023,-156.79,-664.3399999999999
82920281,31/01/2023,,41.13
82920281,02/02/2023,94.2,135.33
82920281,03/02/2023,-1791.6,-1656.27
82920281,06/02/2023,-543.9,-2200.17
82920281,10/02/2023,114.72,-2085.45
82927034,31/01/2023,,435.71
82927034,03/02/2023,-131.87,303.84
82927034,04/02/2023,63.83,367.66999999999996
82927034,08/02/2023,-66.93,300.73999999999995
82927034,09/02/2023,86.0,386.73999999999995
82927034,11/02/2023,-116.46,270.28
82927034,14/02/2023,99.21,369.48999999999995
82930132,31/01/2023,,131.87
82930132,03/02/2023,192.08,323.95000000000005
82930132,03/02/2023,175.68,499.63
82930132,04/02/2023,69.05,568.6800000000001
82930132,05/02/2023,119.88,688.5600000000001
82930132,06/02/2023,-105.81,582.75
82930132,11/02/2023,-137.86,444.89
82930132,12/02/2023,0.94,445.83
83003822,31/01/2023,,286.54
83003822,03/02/2023,-143.42,143.12000000000003
83003822,10/02/2023,-1430.6,-1287.4799999999998
83003822,11/02/2023,-99.93,-1387.4099999999999
83056011,31/01/2023,,968.4
83056011,03/02/2023,129.38,1097.78
83056011,08/02/2023,168.14,1265.92
83056011,11/02/2023,-66.39,1199.53
83067540,31/01/2023,,258.33
83067540,03/02/2023,-37.0,221.32999999999998
83067540,03/02/2023,-111.0,110.32999999999998
83067540,06/02/2023,944.2,1054.53
83067540,11/02/2023,133.67,1188.2
83081615,31/01/2023,,301.32
83081615,02/02/2023,141.97,443.28999999999996
83081615,04/02/2023,41.77,485.06
83081615,05/02/2023,113.82,598.88
83081615,07/02/2023,139.96,738.84
83081615,11/02/2023,67.03,805.87
83124388,31/01/2023,,504.59
83124388,02/02/2023,101.47,606.06
83124388,03/02/2023,94.07,700.13
83124388,04/02/2023,97.81,797.9399999999999
83124388,09/02/2023,-46.08,751.86
83124388,09/02/2023,-64.47,687.39
83124388,14/02/2023,-71.41,615.98
83128181,31/01/2023,,816.12
83128181,01/02/2023,-97.36,718.76
83128181,03/02/2023,82.71,801.47
83128181,07/02/2023,132.91,934.38
83128181,09/02/2023,-1325.7,-391.32000000000005
83128181,12/02/2023,-1681.9,-2073.2200000000003
83128544,31/01/2023,,25.71
83128544,05/02/2023,21.67,47.38
83128544,07/02/2023,181.11,228.49
83128544,07/02/2023,1.03,229.52
83128544,07/02/2023,-153.16,76.36000000000001
83128544,08/02/2023,-128.53,-52.16999999999999
83128544,13/02/2023,-132.3,-184.47
83128544,14/02/2023,85.67,-98.8
83166098,31/01/2023,,827.81
83166098,01/02/2023,-116.71,711.0999999999999
83166098,06/02/2023,-135.81,575.29
83166098,07/02/2023,99.87,675.16
83166098,07/02/2023,-46.92,628.24
83166098,08/02/2023,-170.98,457.26
83166098,10/02/2023,989.8,1447.06
83166098,11/02/2023,-110.56,1336.5
83166098,13/02/2023,37.83,1374.33
83166098,13/02/2023,-165.82,1208.51
83187508,31/01/2023,,714.42
83187508,01/02/2023,130.8,845.22
83187508,05/02/2023,35.44,880.66
83187508,05/02/2023,-85.78,794.88
83187508,06/02/2023,106.03,900.91
83187508,06/02/2023,90.78,991.6899999999999
83187508,08/02/2023,-126.03,865.66
83187508,09/02/2023,65.38,931.04
83187508,09/02/2023,-122.79,808.25
83187508,10/02/2023,1048.2,1856.45
83187508,11/02/2023,-158.35,1698.1000000000001
83187508,13/02/2023,1207.6,2905.7
83187508,14/02/2023,-140.97,2764.73
83191889,31/01/2023,,344.33
83191889,02/02/2023,-91.54,252.78999999999996
83191889,02/02/2023,-101.15,151.64
83191889,02/02/2023,-115.12,36.51999999999997
83191889,04/02/2023,398.1,434.62
83191889,10/02/2023,90.73,525.35
83191889,10/02/2023,-88.72,436.63
83191889,12/02/2023,170.43,607.06
83191889,13/02/2023,128.78,735.84
83202693,31/01/2023,,165.41
83202693,02/02/2023,85.17,250.57999999999998
83202693,03/02/2023,-195.91,54.670000000000016
83202693,07/02/2023,-336.2,-281.53
83202693,09/02/2023,129.57,-151.95999999999998
83202693,11/02/2023,93.53,-58.42999999999998
83202693,13/02/2023,-33.04,-91.46999999999997
83281565,31/01/2023,,968.83
83281565,06/02/2023,68.88,1037.71
83281565,08/02/2023,-23.79,1013.9200000000001
83281565,08/02/2023,-126.11,887.8100000000001
83281565,08/02/2023,-146.5,741.3100000000001
83281565,09/02/2023,150.23,891.54
83281565,12/02/2023,-174.92,716.62
83281565,13/02/2023,106.97,823.59
83281565,14/02/2023,124.76,948.35
83302154,31/01/2023,,465.25
83302154,02/02/2023,-110.35,354.9
83302154,03/02/2023,-936.3,-581.4
83302154,04/02/2023,598.4,17.0
83302154,04/02/2023,72.97,89.97
83302154,06/02/2023,-141.54,-51.56999999999999
83302154,10/02/2023,206.87,155.3
83302154,13/02/2023,-166.98,-11.679999999999978
83443439,31/01/2023,,97.61
83443439,03/02/2023,1218.0,1315.61
83443439,03/02/2023,-4.02,1311.59
83443439,04/02/2023,-95.13,1216.4599999999998
83443439,05/02/2023,-103.0,1113.4599999999998
83443439,06/02/2023,-55.3,1058.1599999999999
83443439,10/02/2023,216.08,1274.24
83443439,10/02/2023,117.1,1391.34
83443439,13/02/2023,114.78,1506.12
83475318,31/01/2023,,228.96
83475318,01/02/2023,-95.83,133.13
83475318,12/02/2023,79.07,212.2
83475318,14/02/2023,-107.71,104.49000000000001
83530155,31/01/2023,,638.57
83530155,02/02/2023,-58.65,579.9200000000001
83530155,10/02/2023,-136.31,443.61
83530155,12/02/2023,-11.78,431.83000000000004
83530155,12/02/2023,-1006.5,-574.67
83530155,13/02/2023,80.6,-494.06999999999994
83530541,31/01/2023,,630.6
83530541,07/02/2023,33.35,663.95
83530541,08/02/2023,-1316.4,-652.45
83530541,13/02/2023,-97.98,-750.4300000000001
83531401,31/01/2023,,445.24
83531401,09/02/2023,-11.67,433.57
83531401,10/02/2023,123.19,556.76
83531401,12/02/2023,67.65,624.41
83539050,31/01/2023,,172.33
83539050,09/02/2023,64.03,236.36
83539050,09/02/2023,-138.19,98.17000000000002
83539050,14/02/2023,114.54,212.71000000000004
83557419,31/01/2023,,374.69
83557419,03/02/2023,-115.71,258.98
83557419,05/02/2023,-98.9,160.07999999999998
83557419,13/02/2023,194.21,354.29
83565726,31/01/2023,,910.38
83565726,02/02/2023,-90.49,819.89
83565726,02/02/2023,-792.0,27.889999999999986
83565726,03/02/2023,-68.43,-40.54000000000002
83565726,07/02/2023,162.23,121.68999999999997
83565726,07/02/2023,-87.52,34.16999999999997
83565726,11/02/2023,954.4,988.5699999999999
83565726,12/02/2023,119.09,1107.6599999999999
83565726,12/02/2023,100.74,1208.3999999999999
83565726,13/02/2023,-959.6,248.79999999999995
83573848,31/01/2023,,818.5
83573848,01/02/2023,-94.56,723.94
83573848,02/02/2023,133.09,857.03
83573848,02/02/2023,123.95,980.98
83573848,05/02/2023,-170.9,810.0799999999999
83573848,09/02/2023,193.78,1003.86
83573848,09/02/2023,-125.67,878.1899999999999
83573848,10/02/2023,83.89,962.0799999999999
83639740,31/01/2023,,266.62
83639740,02/02/2023,128.3,394.92
83639740,02/02/2023,105.52,500.44
83639740,03/02/2023,38.14,538.58
83639740,09/02/2023,587.9,1126.48
83639740,11/02/2023,200.58,1327.06
83659554,31/01/2023,,548.94
83659554,08/02/2023,1537.1,2086.04
83659554,12/02/2023,60.3,2146.34
83659554,12/02/2023,-144.19,2002.15
83668302,31/01/2023,,686.96
83668302,03/02/2023,-46.29,640.6700000000001
83668302,07/02/2023,-11.37,629.3000000000001
83668302,12/02/2023,36.33,665.63
83668302,12/02/2023,-28.61,637.02
83668302,12/02/2023,-209.98,427.0400000000001
83672404,31/01/2023,,269.57
83672404,01/02/2023,164.06,433.63
83672404,02/02/2023,-131.02,302.61
83672404,04/02/2023,-150.01,152.6
83672404,04/02/2023,-614.0,-461.4
83672404,07/02/2023,-111.08,-572.48
83672404,09/02/2023,75.46,-497.02
83672404,09/02/2023,55.42,-441.59999999999997
83693383,31/01/2023,,138.05
83693383,02/02/2023,-57.51,80.54000000000002
83693383,07/02/2023,-38.04,42.500000000000014
83693383,07/02/2023,-166.87,-124.36999999999999
83693383,07/02/2023,-905.3,-1029.6699999999998
83693383,08/02/2023,189.71,-839.9599999999999
83693383,10/02/2023,67.01,-772.9499999999999
83693383,14/02/2023,136.49,-636.4599999999999
83693383,14/02/2023,64.89,-571.5699999999999
83698413,31/01/2023,,223.67
83698413,07/02/2023,113.6,337.27
83698413,09/02/2023,-44.19,293.08
83698413,12/02/2023,-100.01,193.07
83698413,13/02/2023,141.46,334.53
83698413,13/02/2023,-90.0,244.52999999999997
83788130,31/01/2023,,833.68
83788130,01/02/2023,-132.46,701.2199999999999
83788130,02/02/2023,-76.14,625.0799999999999
83788130,03/02/2023,-136.61,488.4699999999999
83788130,03/02/2023,-196.73,291.7399999999999
83788130,06/02/2023,-161.03,130.70999999999992
83788130,08/02/2023,134.23,264.93999999999994
83788130,11/02/2023,69.84,334.7799999999999
83796561,31/01/2023,,410.08
83796561,01/02/2023,-2239.3,-1829.2200000000003
83796561,03/02/2023,-115.16,-1944.3800000000003
83796561,04/02/2023,69.83,-1874.5500000000002
83796561,13/02/2023,124.65,-1749.9000000000003
83796561,14/02/2023,187.3,-1562.6000000000004
83828891,31/01/2023,,780.59
83828891,05/02/2023,40.41,821.0
83828891,05/02/2023,-136.6,684.4000000000001
83828891,08/02/2023,120.57,804.97
83828891,09/02/2023,-51.97,753.0
83828891,12/02/2023,84.03,837.03
83828891,13/02/2023,116.37,953.4000000000001
83828891,14/02/2023,68.67,1022.07
83852014,31/01/2023,,830.02
83852014,01/02/2023,103.4,933.42
83852014,04/02/2023,57.49,990.91
83852014,04/02/2023,-61.88,929.03
83852014,05/02/2023,-82.33,846.7
83852014,06/02/2023,154.07,1000.77
83852014,12/02/2023,-84.13,916.64
83852014,14/02/2023,37.22,953.86
83854141,31/01/2023,,280.06
83854141,02/02/2023,-126.94,153.12
83854141,04/02/2023,-71.57,81.55000000000001
83854141,05/02/2023,26.38,107.93
83854141,13/02/2023,109.04,216.97000000000003
83854141,14/02/2023,59.91,276.88
83891783,31/01/2023,,158.08
83891783,01/02/2023,-144.25,13.830000000000013
83891783,02/02/2023,15.77,29.600000000000012
83891783,02/02/2023,-128.31,-98.71
83891783,08/02/2023,118.11,19.400000000000006
83891783,09/02/2023,-123.62,-104.22
83891783,13/02/2023,-760.4,-864.62
83891783,14/02/2023,32.8,-831.82
83975923,31/01/2023,,837.45
83975923,01/02/2023,-156.79,680.6600000000001
83975923,06/02/2023,-68.31,612.35
83975923,07/02/2023,-12.66,599.69
83975923,12/02/2023,-131.34,468.35
83981442,31/01/2023,,89.35
83981442,02/02/2023,133.34,222.69
83981442,02/02/2023,93.56,316.25
83981442,06/02/2023,-1138.4,-822.1500000000001
83981442,07/02/2023,85.6,-736.5500000000001
84070285,31/01/2023,,796.6
84070285,02/02/2023,-936.1,-139.5
84070285,04/02/2023,-32.62,-172.12
84070285,06/02/2023,160.17,-11.950000000000017
84070285,08/02/2023,117.53,105.57999999999998
84070285,12/02/2023,1128.7,1234.28
84070285,12/02/2023,-128.19,1106.09
84070285,13/02/2023,82.37,1188.46
84070285,13/02/2023,75.77,1264.23
84070285,13/02/2023,-69.55,1194.68
84107088,31/01/2023,,2.2
84107088,04/02/2023,116.65,118.85000000000001
84107088,05/02/2023,105.33,224.18
84107088,05/02/2023,-65.92,158.26
84107088,07/02/2023,-591.2,-432.94000000000005
84107088,09/02/2023,-35.02,-467.96000000000004
84107088,09/02/2023,-78.03,-545.99
84187157,31/01/2023,,252.9
84187157,04/02/2023,-125.07,127.83000000000001
84187157,05/02/2023,184.86,312.69000000000005
84187157,07/02/2023,106.8,419.49
84187157,09/02/2023,-96.36,323.13
84187157,14/02/2023,1485.7,1808.83
84187157,14/02/2023,-178.46,1630.3700000000001
84188877,31/01/2023,,624.29
84188877,03/02/2023,104.82,729.1099999999999
84188877,04/02/2023,-58.55,670.56
84188877,05/02/2023,-183.91,486.65
84188877,06/02/2023,92.7,579.35
84188877,06/02/2023,-110.83,468.52
84188877,09/02/2023,-56.12,412.4
84188877,09/02/2023,-67.84,344.55999999999995
84188877,10/02/2023,-1800.7,-1456.14
84188877,11/02/2023,102.13,-1354.0100000000002
84188877,11/02/2023,-1273.1,-2627.11
84188877,12/02/2023,183.73,-2443.38
84275961,31/01/2023,,625.24
84275961,01/02/2023,138.19,763.4300000000001
84275961,03/02/2023,110.96,874.39
84275961,03/02/2023,98.41,972.8
84275961,07/02/2023,-79.84,892.96
84275961,09/02/2023,7.96,900.92
84275961,10/02/2023,-182.75,718.17
84280969,31/01/2023,,161.7
84280969,02/02/2023,92.47,254.17
84280969,09/02/2023,103.44,357.61
84280969,10/02/2023,-75.83,281.78
84280969,12/02/2023,-92.56,189.21999999999997
84280969,12/02/2023,-119.08,70.13999999999999
84290934,31/01/2023,,914.5
84290934,05/02/2023,-81.8,832.7
84290934,06/02/2023,-67.41,765.29
84290934,06/02/2023,-107.8,657.49
84290934,07/02/2023,-71.52,585.97
84290934,09/02/2023,185.1,771.0699999999999
84295462,31/01/2023,,154.03
84295462,01/02/2023,913.5,1067.53
84295462,10/02/2023,136.73,1204.26
84295462,10/02/2023,89.47,1293.73
84295462,11/02/2023,128.07,1421.8
84295462,12/02/2023,-49.41,1372.3899999999999
84310867,31/01/2023,,258.66
84310867,01/02/2023,65.12,323.78000000000003
84310867,10/02/2023,-144.29,179.49000000000004
84310867,11/02/2023,104.35,283.84000000000003
84310867,12/02/2023,893.8,1177.6399999999999
84310867,12/02/2023,70.46,1248.1
84310867,14/02/2023,-1295.6,-47.5
84333228,31/01/2023,,330.99
84333228,02/02/2023,190.92,521.91
84333228,02/02/2023,-75.84,446.07
84333228,03/02/2023,114.6,560.67
84333228,05/02/2023,-96.05,464.62
84333228,05/02/2023,-118.78,345.84
84333228,11/02/2023,84.08,429.91999999999996
84334262,31/01/2023,,525.57
84334262,02/02/2023,93.94,619.51
84334262,04/02/2023,-110.05,509.46000000000004
84334262,06/02/2023,133.3,642.76
84334262,11/02/2023,409.8,1052.56
84334262,11/02/2023,105.66,1158.22
84334262,12/02/2023,-207.6,950.6200000000001
84334262,13/02/2023,104.24,1054.8600000000001
84334262,14/02/2023,-201.83,853.03
84366763,31/01/2023,,734.48
84366763,02/02/2023,-110.43,624.05
84366763,05/02/2023,76.24,700.29
84366763,06/02/2023,-470.6,229.69
84366763,11/02/2023,107.54,337.23
84366763,11/02/2023,74.51,411.74
84366763,11/02/2023,-1012.8,-601.06
84375036,31/01/2023,,356.1
84375036,01/02/2023,114.22,470.32000000000005
84375036,07/02/2023,115.15,585.47
84375036,07/02/2023,-313.5,271.97
84375036,08/02/2023,155.15,427.12
84375036,11/02/2023,69.64,496.76000000000005
84375036,11/02/2023,-130.89,365.87000000000006
84375036,13/02/2023,510.4,876.27
84396180,31/01/2023,,103.83
84396180,04/02/2023,54.15,157.98
84396180,08/02/2023,-130.54,27.439999999999998
84396180,10/02/2023,100.43,127.87
84396180,10/02/2023,-964.8,-836.93
84396180,11/02/2023,31.4,-805.53
84396180,13/02/2023,156.37,-649.16
84406205,31/01/2023,,818.63
84406205,05/02/2023,46.34,864.97
84406205,08/02/2023,94.34,959.31
84406205,13/02/2023,-1827.6,-868.29
84406205,14/02/2023,-72.94,-941.23
84411377,31/01/2023,,870.25
84411377,07/02/2023,112.51,982.76
84411377,12/02/2023,-351.6,631.16
84411377,13/02/2023,139.83,770.99
84411930,31/01/2023,,916.61
84411930,04/02/2023,-58.05,858.5600000000001
84411930,05/02/2023,-36.77,821.79
84411930,05/02/2023,-95.84,725.95
84411930,06/02/2023,-52.31,673.64
84411930,07/02/2023,-56.32,617.32
84411930,12/02/2023,163.83,781.1500000000001
84416510,31/01/2023,,793.45
84416510,02/02/2023,-31.64,761.8100000000001
84416510,02/02/2023,-88.86,672.95
84416510,09/02/2023,84.55,757.5
84416510,11/02/2023,954.4,1711.9
84416510,12/02/2023,124.59,1836.49
84416510,13/02/2023,72.94,1909.43
84416510,14/02/2023,-404.9,1504.53
84418749,31/01/2023,,457.27
84418749,01/02/2023,200.4,657.67
84418749,01/02/2023,-78.47,579.2
84418749,02/02/2023,46.77,625.97
84418749,08/02/2023,-109.06,516.91
84418749,09/02/2023,116.81,633.72
84418749,12/02/2023,21.61,655.33
84418749,13/02/2023,93.39,748.72
84448752,31/01/2023,,412.15
84448752,06/02/2023,1409.6,1821.75
84448752,06/02/2023,88.91,1910.66
84448752,08/02/2023,1368.6,3279.26
84448752,08/02/2023,-1253.6,2025.66
84471701,31/01/2023,,89.27
84471701,01/02/2023,62.0,151.26999999999998
84471701,02/02/2023,97.37,248.64
84471701,05/02/2023,-55.81,192.82999999999998
84471701,08/02/2023,77.23,270.06
84656105,31/01/2023,,547.59
84656105,03/02/2023,-56.77,490.82000000000005
84656105,06/02/2023,1457.8,1948.62
84656105,06/02/2023,109.51,2058.13
84656105,07/02/2023,100.78,2158.9100000000003
84656105,08/02/2023,189.28,2348.19
84656105,13/02/2023,-105.18,2243.01
84682032,31/01/2023,,612.1
84682032,03/02/2023,-3.5,608.6
84682032,09/02/2023,-149.44,459.16
84682032,14/02/2023,-79.89,379.27000000000004
84682032,14/02/2023,-123.85,255.42000000000002
84695068,31/01/2023,,693.94
84695068,09/02/2023,-74.41,619.5300000000001
84695068,10/02/2023,34.71,654.24
84695068,12/02/2023,1764.4,2418.6400000000003
84695068,13/02/2023,-9.8,2408.84
84714323,31/01/2023,,667.61
84714323,03/02/2023,-43.31,624.3
84714323,04/02/2023,1268.7,1893.0
84746166,31/01/2023,,806.73
84746166,03/02/2023,20.43,827.16
84746166,04/02/2023,24.15,851.3100000000001
84746166,05/02/2023,-59.8,791.51
84746166,08/02/2023,-157.06,634.45
84746166,09/02/2023,-1202.9,-568.45
84746166,11/02/2023,-32.0,-600.45
84746166,13/02/2023,-124.65,-725.1
84746166,14/02/2023,-98.03,-823.1300000000001
84778718,31/01/2023,,521.14
84778718,03/02/2023,37.49,558.63
84778718,05/02/2023,101.46,660.0899999999999
84778718,09/02/2023,133.43,793.52
84778718,11/02/2023,-78.25,715.27
84778718,12/02/2023,1183.8,1899.07
84778718,13/02/2023,70.58,1969.6499999999999
84822607,31/01/2023,,425.79
84822607,02/02/2023,-93.16,332.63
84822607,03/02/2023,65.15,397.78000000000003
84822607,07/02/2023,77.96,475.74
84822607,07/02/2023,-209.73,266.01000000000005
84822607,08/02/2023,134.18,400.19000000000005
84822607,10/02/2023,90.33,490.52000000000004
84853260,31/01/2023,,925.31
84853260,07/02/2023,-74.75,850.56
84853260,09/02/2023,-72.3,778.26
84853260,13/02/2023,128.84,907.0999999999999
84853260,14/02/2023,142.57,1049.67
84928531,31/01/2023,,236.36
84928531,01/02/2023,-75.09,161.27
84928531,04/02/2023,186.01,347.28
84928531,06/02/2023,138.32,485.6
84928531,06/02/2023,-87.2,398.4
84928531,09/02/2023,-69.41,328.99
84951477,31/01/2023,,316.2
84951477,02/02/2023,-68.17,248.02999999999997
84951477,03/02/2023,39.9,287.93
84951477,06/02/2023,144.68,432.61
84951477,10/02/2023,174.71,607.3199999999999
84951477,10/02/2023,141.06,748.38
84951477,10/02/2023,-551.6,196.77999999999997
84951477,13/02/2023,-61.34,135.43999999999997
84964879,31/01/2023,,629.81
84964879,01/02/2023,106.68,736.49
84964879,03/02/2023,15.12,751.6099999999999
84964879,05/02/2023,45.42,797.03
84964879,07/02/2023,1653.3,2450.33
84964879,08/02/2023,-113.98,2336.35
84964879,11/02/2023,-59.1,2277.25
84969883,31/01/2023,,672.74
84969883,02/02/2023,-128.13,544.61
84969883,03/02/2023,-1179.0,-634.39
84969883,05/02/2023,139.34,-495.04999999999995
84969883,12/02/2023,845.0,349.95000000000005
84969883,13/02/2023,57.17,407.12000000000006
84969883,14/02/2023,-117.34,289.78000000000003
84969883,14/02/2023,-707.3,-417.5199999999999
84995019,31/01/2023,,731.41
84995019,01/02/2023,-89.01,642.4
84995019,01/02/2023,-126.06,516.3399999999999
84995019,02/02/2023,-118.32,398.02
84995019,03/02/2023,195.63,593.65
84995019,03/02/2023,64.43,658.0799999999999
84995019,04/02/2023,482.7,1140.78
84995019,04/02/2023,133.46,1274.24
84995019,04/02/2023,85.5,1359.74
84995019,04/02/2023,-64.93,1294.81
84995019,05/02/2023,146.21,1441.02
84995019,10/02/2023,148.09,1589.11
84995019,11/02/2023,-69.11,1520.0
84995019,14/02/2023,58.59,1578.59
85001424,31/01/2023,,653.31
85001424,01/02/2023,-103.68,549.6299999999999
85001424,06/02/2023,-82.51,467.11999999999995
85001424,09/02/2023,-126.2,340.91999999999996
85001424,11/02/2023,149.84,490.75999999999993
85001424,11/02/2023,-107.51,383.24999999999994
85001424,14/02/2023,94.55,477.79999999999995
85001424,14/02/2023,44.4,522.1999999999999
85057916,31/01/2023,,656.89
85057916,03/02/2023,18.28,675.17
85057916,05/02/2023,74.52,749.6899999999999
85057916,09/02/2023,26.26,775.9499999999999
85057916,10/02/2023,150.39,926.3399999999999
85057916,10/02/2023,76.06,1002.4
85057916,10/02/2023,-167.69,834.71
85128569,31/01/2023,,340.68
85128569,03/02/2023,114.58,455.26
85128569,07/02/2023,-65.37,389.89
85128569,11/02/2023,-105.27,284.62
85128569,14/02/2023,-122.97,161.65
85140734,31/01/2023,,699.57
85140734,01/02/2023,205.89,905.46
85140734,01/02/2023,131.36,1036.8200000000002
85140734,02/02/2023,70.63,1107.45
85140734,03/02/2023,-79.37,1028.08
85140734,04/02/2023,77.13,1105.21
85140734,08/02/2023,-2113.3,-1008.0900000000001
85140734,12/02/2023,71.65,-936.4400000000002
85140734,12/02/2023,-143.0,-1079.44
85156953,31/01/2023,,900.09
85156953,02/02/2023,-16.74,883.35
85156953,03/02/2023,81.73,965.08
85156953,05/02/2023,103.29,1068.3700000000001
85156953,10/02/2023,168.19,1236.56
85156953,12/02/2023,-93.42,1143.14
85156953,13/02/2023,68.93,1212.0700000000002
85156953,14/02/2023,2134.6,3346.67
85177718,31/01/2023,,478.18
85177718,03/02/2023,513.3,991.48
85177718,05/02/2023,-131.36,860.12
85177718,14/02/2023,125.03,985.15
85182642,31/01/2023,,451.38
85182642,07/02/2023,-108.09,343.28999999999996
85182642,08/02/2023,-96.42,246.87
85182642,11/02/2023,99.35,346.21999999999997
85192761,31/01/2023,,982.48
85192761,04/02/2023,95.76,1078.24
85192761,05/02/2023,-1922.5,-844.26
85192761,08/02/2023,52.45,-791.81
85192761,12/02/2023,151.09,-640.72
85238291,31/01/2023,,665.68
85238291,01/02/2023,-142.98,522.6999999999999
85238291,02/02/2023,-28.99,493.71
85238291,02/02/2023,-645.8,-152.08999999999997
85238291,05/02/2023,-94.84,-246.92999999999998
85238291,07/02/2023,163.8,-83.12999999999997
85238291,08/02/2023,197.96,114.83000000000004
85238291,13/02/2023,115.9,230.73000000000005
85250129,31/01/2023,,400.91
85250129,01/02/2023,-119.21,281.70000000000005
85250129,02/02/2023,77.14,358.84000000000003
85250129,06/02/2023,-87.33,271.51000000000005
85250129,08/02/2023,952.0,1223.51
85250129,08/02/2023,-118.76,1104.75
85250129,10/02/2023,-135.21,969.54
85250129,12/02/2023,-56.37,913.17
85265080,31/01/2023,,992.6
85265080,01/02/2023,-78.22,914.38
85265080,01/02/2023,-126.36,788.02
85265080,12/02/2023,-1111.4,-323.3800000000001
85310930,31/01/2023,,688.91
85310930,07/02/2023,108.09,797.0
85310930,09/02/2023,121.5,918.5
85310930,11/02/2023,-81.42,837.0799999999999
85336547,31/01/2023,,785.57
85336547,03/02/2023,120.76,906.33
85336547,08/02/2023,-83.2,823.1300000000001
85336547,10/02/2023,222.4,1045.53
85341369,31/01/2023,,932.11
85341369,01/02/2023,146.39,1078.5
85341369,02/02/2023,-149.36,929.14
85341369,02/02/2023,-187.4,741.74
85341369,05/02/2023,36.56,778.3
85341369,06/02/2023,178.4,956.7
85341369,06/02/2023,-34.38,922.3199999999999
85341369,09/02/2023,67.84,990.16
85341369,11/02/2023,28.34,1018.5
85341369,13/02/2023,137.63,1156.13
85344981,31/01/2023,,874.46
85344981,05/02/2023,-85.08,789.38
85344981,06/02/2023,1024.2,1813.58
85344981,08/02/2023,203.1,2016.68
85344981,09/02/2023,121.16,2137.84
85344981,11/02/2023,120.98,2258.82
85344981,12/02/2023,-1128.7,1130.1200000000001
85344981,13/02/2023,105.71,1235.8300000000002
85344981,14/02/2023,64.22,1300.0500000000002
85362253,31/01/2023,,790.41
85362253,01/02/2023,-63.28,727.13
85362253,03/02/2023,-178.54,548.5899999999999
85362253,04/02/2023,-61.06,487.53
85362253,07/02/2023,78.85,566.38
85362253,08/02/2023,92.43,658.81
85362253,12/02/2023,-76.86,581.9499999999999
85362253,14/02/2023,544.0,1125.9499999999998
85399459,31/01/2023,,705.94
85399459,02/02/2023,-89.7,616.24
85399459,07/02/2023,-169.12,447.12000000000006
85399459,10/02/2023,37.83,484.95000000000005
85399459,11/02/2023,-1037.0,-552.05
85399459,13/02/2023,-89.1,-641.15
85420056,31/01/2023,,107.03
85420056,04/02/2023,26.76,133.79
85420056,08/02/2023,-120.11,13.680000000000007
85420056,09/02/2023,94.81,108.49000000000001
85420056,11/02/2023,177.1,285.59000000000003
85420056,13/02/2023,48.77,334.36
85423742,31/01/2023,,131.14
85423742,02/02/2023,84.91,216.04999999999998
85423742,09/02/2023,106.29,322.34
85423742,11/02/2023,858.7,1181.04
85423742,11/02/2023,11.69,1192.73
85423742,12/02/2023,122.62,1315.35
85423742,12/02/2023,-79.07,1236.28
85423742,14/02/2023,-87.55,1148.73
85435135,31/01/2023,,106.63
85435135,02/02/2023,-72.58,34.05
85435135,03/02/2023,127.62,161.67000000000002
85435135,03/02/2023,56.77,218.44
85435135,03/02/2023,-90.48,127.96000000000001
85435135,07/02/2023,127.93,255.89000000000001
85435135,11/02/2023,141.75,397.64
85435135,11/02/2023,110.28,507.92
85435135,12/02/2023,-178.37,329.55
85435135,13/02/2023,126.46,456.01
85482194,31/01/2023,,997.62
85482194,03/02/2023,160.1,1157.72
85482194,05/02/2023,114.53,1272.25
85482194,07/02/2023,145.86,1418.1100000000001
85482194,08/02/2023,141.86,1559.97
85482194,08/02/2023,45.23,1605.2
85482194,09/02/2023,-1216.6,388.60000000000014
85482194,11/02/2023,33.64,422.2400000000001
85482194,11/02/2023,-137.43,284.8100000000001
85490561,31/01/2023,,512.78
85490561,03/02/2023,119.2,631.98
85490561,03/02/2023,-140.5,491.47999999999996
85490561,07/02/2023,75.08,566.56
85490561,08/02/2023,190.37,756.93
85490561,09/02/2023,-97.54,659.39
85490561,09/02/2023,-205.74,453.6499999999999
85490561,13/02/2023,-86.25,367.3999999999999
85493851,31/01/2023,,796.35
85493851,05/02/2023,-121.03,675.32
85493851,06/02/2023,1.46,676.78
85493851,08/02/2023,96.95,773.73
85493851,09/02/2023,-134.75,638.98
85493851,09/02/2023,-142.59,496.39
85493851,14/02/2023,93.61,590.0
85496714,31/01/2023,,353.13
85496714,03/02/2023,-129.19,223.94
85496714,04/02/2023,-91.41,132.53
85496714,04/02/2023,-117.79,14.739999999999995
85496714,06/02/2023,60.39,75.13
85496714,08/02/2023,-153.79,-78.66
85496714,09/02/2023,63.04,-15.619999999999997
85496714,10/02/2023,-116.54,-132.16
85496714,11/02/2023,110.56,-21.60000000000001
85496714,12/02/2023,1314.3,1292.7
85496714,12/02/2023,69.85,1362.55
85496714,13/02/2023,99.37,1461.92
85496714,13/02/2023,32.94,1494.8600000000001
85498335,31/01/2023,,745.08
85498335,04/02/2023,-80.51,664.57
85498335,07/02/2023,84.97,749.5400000000001
85498335,09/02/2023,149.64,899.1800000000001
85498335,09/02/2023,122.79,1021.97
85498936,31/01/2023,,47.77
85498936,03/02/2023,-1935.5,-1887.73
85498936,09/02/2023,158.52,-1729.21
85498936,10/02/2023,39.45,-1689.76
85498936,13/02/2023,0.58,-1689.18
85501046,31/01/2023,,354.76
85501046,01/02/2023,-152.04,202.72
85501046,05/02/2023,158.24,360.96000000000004
85501046,08/02/2023,-57.32,303.64
85503501,31/01/2023,,13.66
85503501,01/02/2023,53.46,67.12
85503501,04/02/2023,-148.08,-80.96000000000001
85503501,05/02/2023,186.17,105.20999999999998
85503501,05/02/2023,-55.52,49.689999999999976
85503501,06/02/2023,394.5,444.19
85503501,08/02/2023,178.49,622.6800000000001
85503501,09/02/2023,190.68,813.36
85503501,13/02/2023,59.04,872.4
85551186,31/01/2023,,909.25
85551186,07/02/2023,102.52,1011.77
85551186,07/02/2023,-1198.9,-187.1300000000001
85551186,09/02/2023,99.59,-87.5400000000001
85559926,31/01/2023,,423.28
85559926,01/02/2023,-125.68,297.59999999999997
85559926,06/02/2023,16.67,314.27
85559926,07/02/2023,-56.13,258.14
85559926,09/02/2023,1727.8,1985.94
85559926,10/02/2023,89.09,2075.0299999999997
85559926,10/02/2023,71.14,2146.1699999999996
85559926,11/02/2023,50.07,2196.24
85559926,12/02/2023,1071.4,3267.64
85559926,12/02/2023,-177.52,3090.12
85562851,31/01/2023,,499.37
85562851,02/02/2023,-144.51,354.86
85562851,03/02/2023,-141.05,213.81
85562851,07/02/2023,119.25,333.06
85562851,07/02/2023,-226.83,106.22999999999999
85562851,08/02/2023,-19.11,87.11999999999999
85562851,08/02/2023,-186.34,-99.22000000000001
85562851,09/02/2023,158.25,59.02999999999999
85562851,12/02/2023,-66.67,-7.640000000000015
85609963,31/01/2023,,424.83
85609963,04/02/2023,189.72,614.55
85609963,05/02/2023,142.79,757.3399999999999
85609963,10/02/2023,156.22,913.56
85652943,31/01/2023,,424.5
85652943,02/02/2023,-95.52,328.98
85652943,03/02/2023,110.59,439.57
85652943,03/02/2023,-854.4,-414.83
85652943,09/02/2023,121.95,-292.88
85679194,31/01/2023,,891.99
85679194,06/02/2023,104.32,996.31
85679194,07/02/2023,-185.02,811.29
85679194,09/02/2023,79.45,890.74
85679194,10/02/2023,31.28,922.02
85679194,13/02/2023,38.26,960.28
85709972,31/01/2023,,936.57
85709972,05/02/2023,45.1,981.6700000000001
85709972,11/02/2023,173.7,1155.3700000000001
85723355,31/01/2023,,745.34
85723355,05/02/2023,-6.72,738.62
85723355,08/02/2023,-187.24,551.38
85723355,12/02/2023,112.23,663.61
85723355,13/02/2023,-30.37,633.24
85723355,14/02/2023,-1773.6,-1140.36
85724829,31/01/2023,,189.94
85724829,02/02/2023,49.63,239.57
85724829,02/02/2023,-2.63,236.94
85724829,03/02/2023,-23.5,213.44
85724829,08/02/2023,108.96,322.4
85724829,08/02/2023,-122.81,199.58999999999997
85724829,10/02/2023,148.63,348.21999999999997
85724829,10/02/2023,141.46,489.67999999999995
85724829,10/02/2023,-74.15,415.53
85724829,11/02/2023,185.47,601.0
85724829,13/02/2023,39.15,640.15
85771346,31/01/2023,,458.88
85771346,07/02/2023,-201.7,257.18
85771346,08/02/2023,-570.9,-313.71999999999997
85826354,31/01/2023,,611.74
85826354,02/02/2023,-80.3,531.44
85826354,03/02/2023,52.49,583.9300000000001
85826354,05/02/2023,100.81,684.74
85826354,13/02/2023,64.85,749.59
85826354,13/02/2023,-44.38,705.21
85839285,31/01/2023,,728.06
85839285,01/02/2023,637.1,1365.1599999999999
85839285,03/02/2023,-136.43,1228.73
85839285,06/02/2023,104.85,1333.58
85839285,07/02/2023,124.7,1458.28
85839285,09/02/2023,-65.77,1392.51
85839285,10/02/2023,-193.12,1199.3899999999999
85839285,13/02/2023,-68.86,1130.53
85841767,31/01/2023,,458.43
85841767,01/02/2023,-111.89,346.54
85841767,03/02/2023,90.58,437.12
85841767,04/02/2023,14.63,451.75
85841767,04/02/2023,-90.44,361.31
85841767,06/02/2023,-110.66,250.65
85841767,08/02/2023,-70.92,179.73000000000002
85841767,08/02/2023,-134.88,44.85000000000002
85841767,10/02/2023,-168.64,-123.78999999999996
85841767,13/02/2023,-216.37,-340.15999999999997
85841767,14/02/2023,-37.74,-377.9
85846175,31/01/2023,,22.88
85846175,03/02/2023,56.99,79.87
85846175,04/02/2023,112.13,192.0
85846175,04/02/2023,-117.97,74.03
85846175,07/02/2023,15.66,89.69
85846175,08/02/2023,-113.65,-23.960000000000008
85846175,09/02/2023,-101.26,-125.22000000000001
85846175,11/02/2023,197.9,72.67999999999999
85846175,11/02/2023,114.34,187.01999999999998
85846175,12/02/2023,115.87,302.89
85846175,14/02/2023,164.38,467.27
85848442,31/01/2023,,118.46
85848442,02/02/2023,-141.97,-23.510000000000005
85848442,07/02/2023,301.0,277.49
85848442,07/02/2023,-118.92,158.57
85848442,08/02/2023,-103.57,55.000000000000014
85848442,08/02/2023,-1537.1,-1482.1
85848442,10/02/2023,87.35,-1394.75
85848442,10/02/2023,74.72,-1320.03
85848442,10/02/2023,-168.35,-1488.3799999999999
85848442,11/02/2023,-45.67,-1534.05
85848442,11/02/2023,-77.54,-1611.59
85874418,31/01/2023,,151.83
85874418,01/02/2023,-151.41,0.4200000000000159
85874418,02/02/2023,110.52,110.94000000000001
85874418,02/02/2023,-33.06,77.88000000000001
85874418,03/02/2023,113.54,191.42000000000002
85874418,03/02/2023,-247.64,-56.21999999999997
85874418,06/02/2023,111.97,55.75000000000003
85874418,08/02/2023,-1805.6,-1749.85
85874418,12/02/2023,-61.36,-1811.2099999999998
85902834,31/01/2023,,357.94
85902834,02/02/2023,88.86,446.8
85902834,03/02/2023,23.24,470.04
85902834,06/02/2023,178.37,648.41
85902834,06/02/2023,-107.61,540.8
85902834,07/02/2023,-127.93,412.87
85902834,08/02/2023,-120.35,292.52
85902834,10/02/2023,-160.72,131.8
85902834,11/02/2023,138.48,270.28
85902834,13/02/2023,731.4,1001.68
85902834,13/02/2023,-83.84,917.8399999999999
85919813,31/01/2023,,647.36
85919813,01/02/2023,106.8,754.16
85919813,07/02/2023,-171.45,582.71
85919813,09/02/2023,-77.66,505.05000000000007
85919813,12/02/2023,-81.83,423.22
85924719,31/01/2023,,472.05
85924719,08/02/2023,1872.8,2344.85
85924719,09/02/2023,-77.33,2267.52
85924719,11/02/2023,1010.6,3278.12
85939269,31/01/2023,,223.1
85939269,01/02/2023,-121.91,101.19
85939269,02/02/2023,534.5,635.69
85939269,05/02/2023,-181.23,454.46000000000004
85939269,06/02/2023,-151.33,303.13000000000005
85939269,10/02/2023,-174.71,128.42000000000004
85939269,13/02/2023,154.15,282.57000000000005
85939269,13/02/2023,-121.3,161.27000000000004
85940057,31/01/2023,,521.37
85940057,01/02/2023,1069.7,1591.0700000000002
85940057,04/02/2023,-100.53,1490.54
85940057,05/02/2023,49.85,1540.3899999999999
85940057,05/02/2023,-1136.4,403.9899999999998
85940057,12/02/2023,-110.14,293.8499999999998
85940057,12/02/2023,-989.2,-695.3500000000003
85951663,31/01/2023,,385.0
85951663,01/02/2023,99.45,484.45
85951663,02/02/2023,233.36,717.81
85951663,02/02/2023,184.29,902.1
85951663,02/02/2023,-133.67,768.4300000000001
85951663,03/02/2023,-122.22,646.21
85951663,04/02/2023,255.0,901.21
85951663,08/02/2023,-105.97,795.24
85951663,08/02/2023,-215.14,580.1
85951663,14/02/2023,-125.03,455.07000000000005
85994636,31/01/2023,,819.24
85994636,01/02/2023,-114.04,705.2
85994636,02/02/2023,-104.79,600.41
85994636,04/02/2023,1361.0,1961.4099999999999
85994636,04/02/2023,-1410.9,550.5099999999998
85994636,08/02/2023,65.85,616.3599999999998
85994636,09/02/2023,-96.08,520.2799999999997
85994636,12/02/2023,123.24,643.5199999999998
85994636,12/02/2023,63.33,706.8499999999998
85994636,13/02/2023,104.7,811.5499999999997
86007729,31/01/2023,,320.78
86007729,05/02/2023,97.55,418.33
86007729,10/02/2023,-29.52,388.80999999999995
86007729,12/02/2023,111.6,500.40999999999997
86007729,13/02/2023,72.81,573.22
86020532,31/01/2023,,972.95
86020532,05/02/2023,-95.98,876.97
86020532,11/02/2023,120.19,997.1600000000001
86020532,12/02/2023,44.97,1042.13
86020532,13/02/2023,-56.91,985.22
86031592,31/01/2023,,637.42
86031592,01/02/2023,124.24,761.66
86031592,01/02/2023,-135.0,626.66
86031592,02/02/2023,180.16,806.8199999999999
86031592,02/02/2023,51.28,858.0999999999999
86031592,03/02/2023,70.8,928.9
86031592,03/02/2023,-56.89,872.01
86031592,04/02/2023,-398.1,473.90999999999997
86031592,05/02/2023,78.96,552.87
86031592,10/02/2023,144.29,697.16
86031592,11/02/2023,-331.8,365.35999999999996
86031592,13/02/2023,86.51,451.86999999999995
86053438,31/01/2023,,303.06
86053438,01/02/2023,1152.9,1455.96
86053438,02/02/2023,116.0,1571.96
86053438,04/02/2023,-150.45,1421.51
86053438,10/02/2023,-42.14,1379.3700000000001
86053438,13/02/2023,147.5,1526.8700000000001
86053438,13/02/2023,77.52,1604.39
86068003,31/01/2023,,567.14
86068003,03/02/2023,3.24,570.38
86068003,03/02/2023,-129.77,440.61
86068003,06/02/2023,63.7,504.31
86068003,07/02/2023,79.99,584.3
86068003,08/02/2023,-693.4,-109.10000000000002
86068003,11/02/2023,-42.95,-152.05
86068003,11/02/2023,-56.7,-208.75000000000003
86068003,12/02/2023,84.03,-124.72000000000003
86068003,14/02/2023,2620.1,2495.38
86086812,31/01/2023,,832.82
86086812,02/02/2023,-106.61,726.21
86086812,13/02/2023,-105.74,620.47
86092750,31/01/2023,,261.57
86092750,03/02/2023,952.0,1213.57
86092750,08/02/2023,-91.53,1122.04
86092750,09/02/2023,155.22,1277.26
86092750,10/02/2023,-80.91,1196.35
86106528,31/01/2023,,238.55
86106528,02/02/2023,120.72,359.27
86106528,06/02/2023,11.94,371.21000000000004
86108287,31/01/2023,,523.61
86108287,05/02/2023,61.25,584.86
86108287,08/02/2023,167.35,752.21
86108287,10/02/2023,-86.14,666.07
86108287,10/02/2023,-1210.3,-544.2299999999999
86108287,11/02/2023,40.3,-503.9299999999999
86131065,31/01/2023,,920.08
86131065,05/02/2023,-114.02,806.0600000000001
86131065,07/02/2023,26.33,832.3900000000001
86131065,08/02/2023,154.2,986.59
86131065,09/02/2023,-73.98,912.61
86155528,31/01/2023,,772.38
86155528,01/02/2023,81.56,853.94
86155528,06/02/2023,161.12,1015.06
86155528,08/02/2023,-63.8,951.26
86155528,09/02/2023,-107.63,843.63
86155528,13/02/2023,33.04,876.67
86169883,31/01/2023,,452.25
86169883,06/02/2023,-52.84,399.40999999999997
86169883,07/02/2023,98.66,498.07
86169883,08/02/2023,-165.79,332.28
86169883,12/02/2023,-151.06,181.22
86169883,12/02/2023,-164.03,17.189999999999998
86169883,12/02/2023,-191.61,-174.42000000000002
86169883,13/02/2023,-57.17,-231.59000000000003
86169883,14/02/2023,69.79,-161.8
86169883,14/02/2023,-143.83,-305.63
86190489,31/01/2023,,237.72
86190489,03/02/2023,-108.09,129.63
86190489,05/02/2023,860.7,990.33
86190489,07/02/2023,-182.27,808.0600000000001
86190489,07/02/2023,-184.29,623.77
86190489,13/02/2023,-89.42,534.35
86190489,13/02/2023,-136.67,397.68000000000006
86190489,14/02/2023,191.09,588.7700000000001
86207903,31/01/2023,,911.44
86207903,01/02/2023,-41.18,870.2600000000001
86207903,01/02/2023,-131.27,738.99
86207903,05/02/2023,-97.55,641.44
86207903,06/02/2023,1085.4,1726.8400000000001
86207903,06/02/2023,-54.71,1672.13
86207903,07/02/2023,-189.62,1482.5100000000002
86207903,10/02/2023,-108.81,1373.7
86207903,11/02/2023,-1035.1,338.60000000000014
86207903,12/02/2023,-92.53,246.07000000000014
86218347,31/01/2023,,481.16
86218347,01/02/2023,165.66,646.82
86218347,07/02/2023,1581.8,2228.62
86218347,07/02/2023,-80.47,2148.15
86218347,09/02/2023,-52.73,2095.42
86218347,10/02/2023,146.12,2241.54
86218347,10/02/2023,-1463.6,777.9400000000003
86218347,11/02/2023,100.23,878.1700000000003
86218347,14/02/2023,156.02,1034.1900000000003
86228741,31/01/2023,,562.04
86228741,06/02/2023,-114.11,447.92999999999995
86228741,10/02/2023,-139.65,308.28
86228741,13/02/2023,156.49,464.77
86263956,31/01/2023,,852.67
86263956,10/02/2023,-80.77,771.9
86263956,12/02/2023,-111.68,660.2199999999999
86266595,31/01/2023,,539.96
86266595,01/02/2023,-156.73,383.23
86266595,02/02/2023,115.05,498.28000000000003
86266595,05/02/2023,357.9,856.1800000000001
86266595,05/02/2023,-159.3,696.88
86266595,09/02/2023,-8.38,688.5
86266595,09/02/2023,-47.07,641.43
86266595,10/02/2023,122.66,764.09
86266595,11/02/2023,-60.37,703.72
86266595,13/02/2023,-100.05,603.67
86266595,14/02/2023,-36.2,567.47
86268635,31/01/2023,,679.32
86268635,02/02/2023,77.54,756.86
86268635,03/02/2023,84.12,840.98
86268635,04/02/2023,152.48,993.46
86272488,31/01/2023,,11.73
86272488,01/02/2023,-90.79,-79.06
86272488,03/02/2023,13.61,-65.45
86272488,03/02/2023,-156.35,-221.8
86272488,05/02/2023,144.1,-77.69999999999999
86272488,14/02/2023,88.35,10.650000000000006
86297017,31/01/2023,,803.81
86297017,01/02/2023,103.04,906.8499999999999
86297017,03/02/2023,-80.26,826.5899999999999
86297017,04/02/2023,-67.91,758.68
86297017,10/02/2023,715.5,1474.1799999999998
86297017,11/02/2023,531.4,2005.58
86297017,13/02/2023,-89.3,1916.28
86339581,31/01/2023,,91.76
86339581,02/02/2023,126.16,217.92000000000002
86339581,03/02/2023,48.23,266.15
86339581,04/02/2023,-47.33,218.82
86339581,06/02/2023,-246.82,-28.0
86339581,07/02/2023,-108.09,-136.09
86339581,08/02/2023,166.36,30.27000000000001
86339581,10/02/2023,-74.6,-44.329999999999984
86339581,11/02/2023,133.59,89.26000000000002
86339581,11/02/2023,-1107.1,-1017.8399999999999
86339899,31/01/2023,,460.69
86339899,01/02/2023,615.8,1076.49
86339899,01/02/2023,-601.7,474.78999999999996
86339899,03/02/2023,171.99,646.78
86339899,04/02/2023,-127.8,518.98
86339899,06/02/2023,1792.7,2311.6800000000003
86339899,06/02/2023,-138.32,2173.36
86339899,07/02/2023,71.01,2244.37
86339899,10/02/2023,80.58,2324.9500000000003
86339899,10/02/2023,-64.28,2260.67
86339899,11/02/2023,-114.84,2145.83
86406958,31/01/2023,,842.43
86406958,02/02/2023,-27.69,814.7399999999999
86406958,06/02/2023,-687.1,127.63999999999987
86406958,10/02/2023,34.99,162.62999999999988
86406958,13/02/2023,93.14,255.76999999999987
86406958,14/02/2023,68.7,324.46999999999986
86406958,14/02/2023,66.88,391.34999999999985
86439949,31/01/2023,,782.42
86439949,02/02/2023,66.42,848.8399999999999
86439949,02/02/2023,12.87,861.7099999999999
86439949,03/02/2023,-27.88,833.8299999999999
86439949,03/02/2023,-56.99,776.8399999999999
86439949,05/02/2023,-109.7,667.14
86439949,09/02/2023,-735.1,-67.96000000000004
86489618,31/01/2023,,488.7
86489618,03/02/2023,-5.31,483.39
86489618,06/02/2023,37.9,521.29
86489618,09/02/2023,166.16,687.45
86489618,13/02/2023,2.0,689.45
86496446,31/01/2023,,124.84
86496446,01/02/2023,-85.61,39.230000000000004
86496446,07/02/2023,137.51,176.74
86496446,08/02/2023,138.31,315.05
86496446,11/02/2023,151.17,466.22
86496446,14/02/2023,95.87,562.09
86530050,31/01/2023,,447.17
86530050,01/02/2023,103.16,550.33
86530050,03/02/2023,-90.66,459.67
86530050,04/02/2023,-128.26,331.41
86530050,07/02/2023,-169.25,162.16000000000003
86530050,09/02/2023,138.85,301.01
86530050,09/02/2023,31.87,332.88
86530050,09/02/2023,-57.36,275.52000000000004
86530050,09/02/2023,-102.35,173.17000000000002
86530050,14/02/2023,158.33,331.50000000000006
86530050,14/02/2023,30.74,362.24000000000007
86530050,14/02/2023,-119.1,243.14000000000004
86596620,31/01/2023,,512.69
86596620,04/02/2023,42.74,555.4300000000001
86596620,07/02/2023,-24.34,531.09
86596620,10/02/2023,-70.43,460.6600000000001
86596620,11/02/2023,84.35,545.01
86596620,12/02/2023,-142.86,402.15000000000003
86624158,31/01/2023,,818.29
86624158,04/02/2023,-124.23,694.06
86624158,05/02/2023,97.55,791.6099999999999
86624158,07/02/2023,169.03,960.64
86624158,08/02/2023,-101.89,858.75
86624158,09/02/2023,56.03,914.78
86624158,10/02/2023,-94.45,820.3299999999999
86624158,11/02/2023,179.27,999.5999999999999
86624158,11/02/2023,126.42,1126.02
86637863,31/01/2023,,672.86
86637863,03/02/2023,105.11,777.97
86637863,04/02/2023,155.63,933.6
86637863,05/02/2023,-78.36,855.24
86637863,06/02/2023,-27.56,827.6800000000001
86637863,08/02/2023,87.73,915.4100000000001
86637863,12/02/2023,-91.23,824.1800000000001
86655008,31/01/2023,,671.72
86655008,01/02/2023,84.07,755.79
86655008,01/02/2023,-52.9,702.89
86655008,03/02/2023,-198.29,504.6
86655008,04/02/2023,-900.7,-396.1
86655008,09/02/2023,98.31,-297.79
86655008,09/02/2023,-66.83,-364.62
86655008,13/02/2023,-142.99,-507.61
86655008,14/02/2023,115.38,-392.23
86698396,31/01/2023,,314.21
86698396,03/02/2023,113.68,427.89
86728138,31/01/2023,,175.36
86728138,04/02/2023,-214.78,-39.41999999999999
86728138,07/02/2023,162.23,122.81
86728138,07/02/2023,-113.6,9.210000000000008
86728138,08/02/2023,-157.76,-148.54999999999998
86737119,31/01/2023,,432.69
86737119,04/02/2023,244.13,676.8199999999999
86737119,04/02/2023,-158.98,517.84
86737119,05/02/2023,-772.5,-254.65999999999997
86737119,06/02/2023,-193.27,-447.92999999999995
86737119,07/02/2023,197.12,-250.80999999999997
86737119,07/02/2023,123.68,-127.12999999999997
86737119,07/02/2023,76.84,-50.289999999999964
86737119,07/02/2023,-152.63,-202.91999999999996
86737119,09/02/2023,176.56,-26.359999999999957
86737119,13/02/2023,148.57,122.21000000000004
86737119,14/02/2023,73.77,195.98000000000002
86765156,31/01/2023,,290.53
86765156,02/02/2023,118.87,409.4
86765156,05/02/2023,-65.68,343.71999999999997
86765156,09/02/2023,176.29,520.01
86765156,09/02/2023,97.79,617.8
86785126,31/01/2023,,148.21
86785126,02/02/2023,-225.34,-77.13
86785126,03/02/2023,104.95,27.820000000000007
86785126,04/02/2023,-103.81,-75.99
86785126,05/02/2023,-80.83,-156.82
86785126,07/02/2023,147.04,-9.780000000000001
86785126,11/02/2023,-47.98,-57.76
86785126,14/02/2023,643.9,586.14
86785126,14/02/2023,-412.8,173.33999999999997
86788651,31/01/2023,,593.38
86788651,01/02/2023,218.14,811.52
86788651,01/02/2023,152.04,963.56
86788651,04/02/2023,-85.5,878.06
86788651,07/02/2023,-101.07,776.99
86788651,07/02/2023,-283.4,493.59000000000003
86788651,13/02/2023,128.76,622.35
86788651,14/02/2023,-90.79,531.5600000000001
86788651,14/02/2023,-162.35,369.21000000000004
86795912,31/01/2023,,295.95
86795912,05/02/2023,-119.75,176.2
86795912,08/02/2023,-98.0,78.19999999999999
86795912,09/02/2023,132.48,210.67999999999998
86795912,12/02/2023,-877.5,-666.82
86795912,14/02/2023,170.78,-496.0400000000001
86816054,31/01/2023,,391.59
86816054,03/02/2023,109.86,501.45
86816054,06/02/2023,-83.26,418.18999999999994
86816054,07/02/2023,-1255.9,-837.7100000000002
86816054,09/02/2023,164.72,-672.9900000000001
86816054,09/02/2023,69.0,-603.9900000000001
86816054,12/02/2023,80.44,-523.5500000000002
86864320,31/01/2023,,611.14
86864320,01/02/2023,-103.58,507.56
86864320,05/02/2023,183.42,690.98
86864320,06/02/2023,138.14,829.1199999999999
86864320,06/02/2023,-63.43,765.6899999999999
86864320,13/02/2023,99.8,865.49
86864320,14/02/2023,126.71,992.1999999999999
86870860,31/01/2023,,987.14
86870860,02/02/2023,130.93,1118.07
86870860,02/02/2023,-1556.9,-438.83000000000015
86870860,05/02/2023,-146.29,-585.1200000000001
86870860,06/02/2023,-187.58,-772.7000000000002
86870860,07/02/2023,78.9,-693.8000000000002
86870860,10/02/2023,-98.63,-792.4300000000002
86870860,12/02/2023,228.38,-564.0500000000002
86870860,13/02/2023,-133.35,-697.4000000000001
86870860,14/02/2023,-131.53,-828.9300000000002
86893452,31/01/2023,,641.84
86893452,01/02/2023,108.17,750.01
86893452,01/02/2023,-1152.9,-402.8900000000001
86893452,04/02/2023,-46.13,-449.0200000000001
86893452,06/02/2023,119.58,-329.4400000000001
86893452,07/02/2023,152.63,-176.81000000000012
86893452,08/02/2023,92.25,-84.56000000000012
86893452,09/02/2023,-96.28,-180.84000000000012
86893452,10/02/2023,79.77,-101.07000000000012
86893452,10/02/2023,-46.29,-147.36000000000013
86893452,12/02/2023,-94.03,-241.39000000000013
86893452,14/02/2023,-124.48,-365.8700000000001
86941058,31/01/2023,,337.99
86941058,01/02/2023,466.7,804.69
86941058,01/02/2023,150.96,955.65
86941058,01/02/2023,148.96,1104.6100000000001
86941058,01/02/2023,-92.85,1011.76
86941058,03/02/2023,-21.03,990.73
86941058,05/02/2023,1233.7,2224.4300000000003
86941058,07/02/2023,110.05,2334.48
86941058,07/02/2023,-53.6,2280.88
86941058,07/02/2023,-64.02,2216.86
86941058,08/02/2023,-1800.8,416.0600000000002
86941058,09/02/2023,105.33,521.3900000000002
86941058,09/02/2023,-85.04,436.35000000000014
86941058,09/02/2023,-102.59,333.76000000000016
86941058,11/02/2023,173.15,506.9100000000002
86941058,13/02/2023,159.64,666.5500000000002
86941058,14/02/2023,505.6,1172.15
86941058,14/02/2023,-148.07,1024.0800000000002
86995846,31/01/2023,,956.26
86995846,04/02/2023,-50.69,905.5699999999999
86995846,06/02/2023,132.29,1037.86
86995846,07/02/2023,96.08,1133.94
86995846,09/02/2023,45.7,1179.6399999999999
86995846,09/02/2023,-88.73,1090.91
86995846,10/02/2023,-126.15,964.76
87010556,31/01/2023,,175.33
87010556,03/02/2023,41.04,216.37
87010556,07/02/2023,112.22,328.59000000000003
87010556,07/02/2023,105.53,434.12
87010556,11/02/2023,90.36,524.48
87010556,12/02/2023,99.56,624.04
87010556,13/02/2023,-0.58,623.46
87101816,31/01/2023,,862.87
87101816,01/02/2023,-150.96,711.91
87101816,04/02/2023,-567.7,144.20999999999992
87101816,07/02/2023,164.85,309.05999999999995
87101816,08/02/2023,7.94,316.99999999999994
87101816,10/02/2023,182.87,499.8699999999999
87101816,11/02/2023,77.75,577.6199999999999
87101816,14/02/2023,-81.74,495.87999999999994
87101816,14/02/2023,-99.95,395.92999999999995
87121270,31/01/2023,,122.09
87121270,04/02/2023,-86.9,35.19
87121270,04/02/2023,-94.72,-59.53
87121270,08/02/2023,-175.97,-235.5
87121270,12/02/2023,-109.65,-345.15
87133080,31/01/2023,,947.42
87133080,05/02/2023,-197.22,750.1999999999999
87133080,07/02/2023,-1151.1,-400.9
87133080,08/02/2023,-85.98,-486.88
87133080,10/02/2023,127.34,-359.53999999999996
87133080,14/02/2023,-67.47,-427.01
87171530,31/01/2023,,705.41
87171530,01/02/2023,-102.91,602.5
87171530,03/02/2023,107.8,710.3
87171530,05/02/2023,-55.38,654.92
87171530,06/02/2023,21.12,676.04
87171530,06/02/2023,-784.3,-108.25999999999999
87171530,10/02/2023,112.36,4.1000000000000085
87171530,10/02/2023,-39.48,-35.37999999999999
87171530,11/02/2023,182.68,147.3
87171530,13/02/2023,-36.43,110.87
87171530,14/02/2023,-113.78,-2.9099999999999966
87179572,31/01/2023,,527.23
87179572,01/02/2023,1292.5,1819.73
87179572,02/02/2023,-107.47,1712.26
87179572,03/02/2023,74.5,1786.76
87179572,04/02/2023,185.63,1972.39
87179572,05/02/2023,-69.93,1902.46
87179572,07/02/2023,-43.28,1859.18
87179572,07/02/2023,-109.43,1749.75
87179572,13/02/2023,223.88,1973.63
87179572,13/02/2023,91.43,2065.06
87195449,31/01/2023,,493.58
87195449,09/02/2023,126.81,620.39
87195449,10/02/2023,110.9,731.29
87195449,13/02/2023,-445.8,285.49
87231063,31/01/2023,,305.69
87231063,04/02/2023,83.95,389.64
87231063,07/02/2023,-96.86,292.78
87261089,31/01/2023,,613.62
87261089,13/02/2023,152.6,766.22
87261106,31/01/2023,,203.16
87261106,06/02/2023,-57.88,145.28
87261106,08/02/2023,-24.94,120.33999999999999
87261106,09/02/2023,187.78,308.12
87261106,09/02/2023,-55.42,252.7
87261106,09/02/2023,-126.81,125.88999999999997
87261106,11/02/2023,-149.28,-23.39000000000003
87261106,13/02/2023,-18.04,-41.43000000000003
87276000,31/01/2023,,826.21
87276000,01/02/2023,179.6,1005.8100000000001
87276000,01/02/2023,119.88,1125.69
87276000,05/02/2023,-74.37,1051.32
87276000,09/02/2023,46.3,1097.6200000000001
87276000,10/02/2023,-40.2,1057.42
87276000,13/02/2023,90.4,1147.82
87297577,31/01/2023,,351.06
87297577,03/02/2023,109.74,460.8
87297577,03/02/2023,-101.75,359.05
87297577,04/02/2023,-155.57,203.48000000000002
87297577,05/02/2023,117.54,321.02000000000004
87297577,14/02/2023,-49.4,271.62
87325576,31/01/2023,,354.27
87325576,01/02/2023,-185.45,168.82
87325576,03/02/2023,134.13,302.95
87325576,07/02/2023,-79.32,223.63
87325576,10/02/2023,-196.24,27.389999999999986
87325576,11/02/2023,116.37,143.76
87325576,13/02/2023,2.26,146.01999999999998
87356428,31/01/2023,,705.05
87356428,06/02/2023,42.19,747.24
87356428,08/02/2023,79.16,826.4
87356428,10/02/2023,213.8,1040.2
87356428,10/02/2023,101.74,1141.94
87373821,31/01/2023,,945.0
87373821,01/02/2023,-69.91,875.09
87373821,01/02/2023,-163.82,711.27
87373821,03/02/2023,27.88,739.15
87373821,06/02/2023,999.1,1738.25
87373821,07/02/2023,-54.28,1683.97
87373821,08/02/2023,133.65,1817.62
87373821,08/02/2023,-111.05,1706.57
87373821,14/02/2023,175.48,1882.05
87433733,31/01/2023,,34.77
87433733,02/02/2023,104.72,139.49
87433733,02/02/2023,-139.25,0.2400000000000091
87433733,05/02/2023,-71.17,-70.92999999999999
87433733,06/02/2023,-83.76,-154.69
87433733,08/02/2023,-158.67,-313.36
87433733,09/02/2023,239.1,-74.25999999999999
87433733,12/02/2023,-139.75,-214.01
87433733,13/02/2023,-159.64,-373.65
87456121,31/01/2023,,257.5
87456121,01/02/2023,76.69,334.19
87456121,06/02/2023,-29.95,304.24
87456121,09/02/2023,-58.71,245.53
87456121,09/02/2023,-82.14,163.39
87456121,10/02/2023,62.31,225.7
87456121,11/02/2023,51.18,276.88
87504607,31/01/2023,,605.63
87504607,01/02/2023,86.21,691.84
87504607,03/02/2023,91.97,783.81
87504607,11/02/2023,142.53,926.3399999999999
87504607,11/02/2023,-83.49,842.85
87504607,13/02/2023,162.05,1004.9
87533652,31/01/2023,,156.61
87533652,03/02/2023,22.57,179.18
87533652,06/02/2023,-176.4,2.780000000000001
87533652,07/02/2023,199.97,202.75
87533652,07/02/2023,-67.88,134.87
87533652,10/02/2023,153.19,288.06
87533652,14/02/2023,81.26,369.32
87543952,31/01/2023,,14.85
87543952,07/02/2023,-93.88,-79.03
87543952,08/02/2023,77.04,-1.9899999999999949
87543952,09/02/2023,125.94,123.95
87543952,11/02/2023,112.24,236.19
87556975,31/01/2023,,657.17
87556975,02/02/2023,-57.04,600.13
87556975,05/02/2023,-200.2,399.92999999999995
87556975,06/02/2023,-173.27,226.65999999999997
87556975,07/02/2023,1372.5,1599.1599999999999
87556975,13/02/2023,99.78,1698.9399999999998
87556975,14/02/2023,1469.3,3168.24
87726203,31/01/2023,,55.92
87726203,06/02/2023,152.16,208.07999999999998
87726203,07/02/2023,-21.61,186.47000000000003
87726203,09/02/2023,-124.33,62.140000000000015
87726203,10/02/2023,-57.63,4.510000000000012
87726203,12/02/2023,-28.57,-24.059999999999988
87735660,31/01/2023,,990.25
87735660,03/02/2023,28.0,1018.25
87735660,04/02/2023,-82.87,935.38
87735660,11/02/2023,-64.84,870.54
87735660,11/02/2023,-138.99,731.55
87735660,12/02/2023,101.83,833.38
87735660,13/02/2023,152.92,986.3
87735660,13/02/2023,79.81,1066.11
87746071,31/01/2023,,215.91
87746071,01/02/2023,-106.3,109.61
87746071,06/02/2023,135.04,244.64999999999998
87746071,14/02/2023,259.3,503.95000000000005
87801896,31/01/2023,,181.56
87801896,03/02/2023,1632.0,1813.56
87801896,05/02/2023,118.55,1932.11
87801896,06/02/2023,108.14,2040.25
87801896,12/02/2023,-171.12,1869.1299999999999
87807990,31/01/2023,,317.4
87807990,01/02/2023,72.79,390.19
87807990,02/02/2023,-97.47,292.71999999999997
87807990,04/02/2023,957.5,1250.22
87807990,06/02/2023,178.88,1429.1
87807990,08/02/2023,57.32,1486.42
87807990,10/02/2023,38.88,1525.3
87817645,31/01/2023,,983.36
87817645,01/02/2023,181.11,1164.47
87817645,03/02/2023,-17.26,1147.21
87817645,04/02/2023,64.93,1212.14
87817645,05/02/2023,-114.48,1097.66
87817645,05/02/2023,-141.51,956.1500000000001
87817645,06/02/2023,-660.3,295.85000000000014
87817645,08/02/2023,-103.89,191.96000000000015
87817645,09/02/2023,-155.76,36.20000000000016
87817645,10/02/2023,616.1,652.3000000000002
87817645,10/02/2023,80.91,733.2100000000002
87827496,31/01/2023,,935.66
87827496,02/02/2023,-103.39,832.27
87827496,05/02/2023,-107.8,724.47
87827496,13/02/2023,72.65,797.12
87836000,31/01/2023,,937.46
87836000,07/02/2023,-115.15,822.3100000000001
87836000,13/02/2023,-93.97,728.34
87876065,31/01/2023,,627.15
87876065,01/02/2023,1821.6,2448.75
87876065,01/02/2023,123.29,2572.04
87876065,11/02/2023,140.15,2712.19
87876065,11/02/2023,-75.65,2636.54
87876065,12/02/2023,-84.4,2552.14
87876065,14/02/2023,-64.45,2487.69
87906438,31/01/2023,,196.99
87906438,05/02/2023,-144.67,52.32000000000002
87906438,07/02/2023,0.83,53.15000000000002
87906438,09/02/2023,136.48,189.63
87906438,10/02/2023,174.95,364.58000000000004
87906438,10/02/2023,40.2,404.78000000000003
87906438,10/02/2023,-75.98,328.8
87906438,12/02/2023,159.82,488.62
87906438,12/02/2023,-99.99,388.63
87911550,31/01/2023,,149.29
87911550,02/02/2023,-91.54,57.749999999999986
87911550,04/02/2023,74.75,132.5
87911550,11/02/2023,-72.76,59.73999999999998
87911550,13/02/2023,24.32,84.05999999999997
87913244,31/01/2023,,730.48
87913244,01/02/2023,136.95,867.4300000000001
87913244,02/02/2023,-237.02,630.41
87913244,06/02/2023,-123.31,507.1
87913244,08/02/2023,104.55,611.65
87913244,08/02/2023,-54.56,557.09
87913244,10/02/2023,-210.07,347.02
87913244,11/02/2023,-139.07,207.95
87913244,12/02/2023,-131.58,76.36999999999998
87967388,31/01/2023,,682.7
87967388,03/02/2023,-114.6,568.1
87967388,05/02/2023,135.04,703.1400000000001
87967388,05/02/2023,77.0,780.1400000000001
87967388,10/02/2023,932.3,1712.44
87967388,12/02/2023,-882.7,829.74
87967388,13/02/2023,1393.1,2222.84
87967388,13/02/2023,89.23,2312.0699999999997
87967388,13/02/2023,-2359.1,-47.0300000000002
87967388,14/02/2023,-137.37,-184.4000000000002
88033693,31/01/2023,,917.7
88033693,06/02/2023,-114.15,803.5500000000001
88033693,07/02/2023,19.21,822.76
88033693,07/02/2023,-109.39,713.37
88033693,09/02/2023,81.22,794.59
88033693,12/02/2023,-19.56,775.0300000000001
88040274,31/01/2023,,550.79
88040274,03/02/2023,-89.14,461.65
88040274,05/02/2023,158.27,619.92
88040274,06/02/2023,1743.5,2363.42
88040274,14/02/2023,76.31,2439.73
88074391,31/01/2023,,851.54
88074391,02/02/2023,-111.21,740.3299999999999
88074391,05/02/2023,-127.52,612.81
88074391,06/02/2023,115.19,728.0
88074391,09/02/2023,-83.26,644.74
88074391,10/02/2023,-121.44,523.3
88106566,31/01/2023,,477.78
88106566,02/02/2023,211.27,689.05
88106566,02/02/2023,93.52,782.5699999999999
88106566,03/02/2023,-221.11,561.46
88106566,05/02/2023,12.23,573.6899999999999
88106566,09/02/2023,140.26,713.9499999999999
88106566,14/02/2023,-134.69,579.26
88160468,31/01/2023,,640.07
88160468,01/02/2023,-84.03,556.0400000000001
88160468,01/02/2023,-1041.9,-485.86
88160468,04/02/2023,127.8,-358.06
88160468,07/02/2023,46.31,-311.75
88160468,08/02/2023,-103.69,-415.44
88160468,09/02/2023,142.59,-272.85
88160468,12/02/2023,-143.47,-416.32000000000005
88160468,13/02/2023,44.17,-372.15000000000003
88160468,14/02/2023,-151.02,-523.1700000000001
88229109,31/01/2023,,730.76
88229109,05/02/2023,-65.1,665.66
88229109,10/02/2023,182.81,848.47
88229109,12/02/2023,140.82,989.29
88229109,12/02/2023,76.6,1065.8899999999999
88229109,12/02/2023,67.02,1132.91
88229109,14/02/2023,115.32,1248.23
88235115,31/01/2023,,150.58
88235115,02/02/2023,-51.28,99.30000000000001
88235115,02/02/2023,-137.17,-37.869999999999976
88235115,05/02/2023,167.85,129.98000000000002
88235115,07/02/2023,-74.11,55.87000000000002
88235115,08/02/2023,89.97,145.84000000000003
88235115,08/02/2023,-118.94,26.90000000000002
88235115,09/02/2023,98.98,125.88000000000002
88235115,12/02/2023,154.56,280.44000000000005
88235115,12/02/2023,-797.7,-517.26
88235115,14/02/2023,-643.9,-1161.1599999999999
88285378,31/01/2023,,473.79
88285378,03/02/2023,94.79,568.58
88285378,06/02/2023,887.9,1456.48
88285378,08/02/2023,180.39,1636.87
88285378,09/02/2023,-230.97,1405.9
88285378,14/02/2023,-104.53,1301.37
88293767,31/01/2023,,487.22
88293767,04/02/2023,-102.71,384.51000000000005
88293767,07/02/2023,-82.79,301.72
88293767,09/02/2023,-65.38,236.34000000000003
88306714,31/01/2023,,808.0
88306714,08/02/2023,36.71,844.71
88306714,13/02/2023,-114.54,730.17
88306714,14/02/2023,-112.72,617.45
88343796,31/01/2023,,338.0
88343796,02/02/2023,-224.12,113.88
88343796,08/02/2023,-30.57,83.31
88343796,11/02/2023,66.07,149.38
88381437,31/01/2023,,472.65
88381437,04/02/2023,-100.94,371.71
88381437,05/02/2023,-65.54,306.16999999999996
88381437,05/02/2023,-74.21,231.95999999999998
88399132,31/01/2023,,751.13
88399132,02/02/2023,56.02,807.15
88399132,03/02/2023,-83.69,723.46
88399132,08/02/2023,195.95,919.41
88399132,10/02/2023,151.6,1071.01
88399132,10/02/2023,69.69,1140.7
88399132,11/02/2023,32.0,1172.7
88399132,14/02/2023,-159.09,1013.61
88436283,31/01/2023,,689.71
88436283,09/02/2023,-233.91,455.80000000000007
88466448,31/01/2023,,920.61
88466448,03/02/2023,-640.4,280.21000000000004
88466448,03/02/2023,-1453.5,-1173.29
88466448,04/02/2023,131.11,-1042.1799999999998
88466448,04/02/2023,-79.47,-1121.6499999999999
88466448,05/02/2023,627.1,-494.54999999999995
88466448,05/02/2023,-51.26,-545.81
88466448,07/02/2023,-143.04,-688.8499999999999
88466448,08/02/2023,-58.82,-747.67
88466448,09/02/2023,11.47,-736.1999999999999
88466448,10/02/2023,-121.97,-858.17
88466448,12/02/2023,112.58,-745.5899999999999
88476961,31/01/2023,,524.76
88476961,01/02/2023,75.85,600.61
88476961,04/02/2023,86.15,686.76
88476961,05/02/2023,138.66,825.42
88476961,07/02/2023,75.95,901.37
88476961,10/02/2023,-55.13,846.24
88476961,11/02/2023,-133.78,712.46
88482062,31/01/2023,,149.31
88482062,01/02/2023,-321.2,-171.89
88482062,07/02/2023,130.23,-41.66
88482062,07/02/2023,85.25,43.59
88482062,08/02/2023,-1096.2,-1052.6100000000001
88482062,10/02/2023,-87.07,-1139.68
88489173,31/01/2023,,476.26
88489173,01/02/2023,169.18,645.44
88489173,02/02/2023,-115.09,530.35
88489173,08/02/2023,-0.47,529.88
88489173,09/02/2023,-145.71,384.16999999999996
88489173,13/02/2023,-133.97,250.2
88538200,31/01/2023,,518.77
88538200,02/02/2023,-83.89,434.88
88538200,06/02/2023,40.91,475.78999999999996
88538200,10/02/2023,1394.1,1869.8899999999999
88538200,12/02/2023,1077.3,2947.1899999999996
88538200,12/02/2023,127.83,3075.02
88538200,13/02/2023,76.09,3151.1099999999997
88551691,31/01/2023,,979.24
88551691,01/02/2023,89.41,1068.65
88551691,05/02/2023,1136.4,2205.05
88551691,07/02/2023,-75.03,2130.02
88551691,08/02/2023,-118.77,2011.2500000000002
88558016,31/01/2023,,156.64
88558016,04/02/2023,84.53,241.17
88558016,09/02/2023,-37.65,203.51999999999998
88558016,12/02/2023,84.83,288.35
88558016,12/02/2023,76.51,364.86
88558016,14/02/2023,76.93,441.79
88568543,31/01/2023,,472.83
88568543,01/02/2023,-168.34,304.49
88568543,02/02/2023,-86.62,217.86999999999998
88568543,02/02/2023,-723.0,-505.13
88568543,03/02/2023,-102.35,-607.48
88568543,07/02/2023,126.03,-481.45
88568543,10/02/2023,-65.54,-546.99
88568543,11/02/2023,1215.8,668.81
88568543,13/02/2023,26.24,695.05
88568543,14/02/2023,-17.11,677.9399999999999
88570753,31/01/2023,,62.48
88570753,07/02/2023,1440.9,1503.38
88570753,07/02/2023,-99.56,1403.8200000000002
88570753,09/02/2023,-127.53,1276.2900000000002
88570753,12/02/2023,-90.66,1185.63
88570753,14/02/2023,89.9,1275.5300000000002
88580402,31/01/2023,,118.18
88580402,01/02/2023,104.47,222.65
88580402,03/02/2023,59.01,281.66
88580402,06/02/2023,143.3,424.96000000000004
88580402,09/02/2023,-83.99,340.97
88580402,14/02/2023,-175.7,165.27000000000004
88646863,31/01/2023,,250.52
88646863,03/02/2023,35.32,285.84000000000003
88646863,08/02/2023,947.8,1233.6399999999999
88657589,31/01/2023,,712.85
88657589,03/02/2023,-97.96,614.89
88657589,04/02/2023,94.72,709.61
88657589,05/02/2023,98.03,807.64
88657589,07/02/2023,50.49,858.13
88657589,09/02/2023,163.99,1022.12
88657589,09/02/2023,11.2,1033.32
88657589,10/02/2023,-129.33,903.99
88657589,13/02/2023,26.71,930.7
88657589,14/02/2023,77.4,1008.1
88676459,31/01/2023,,285.95
88676459,01/02/2023,94.56,380.51
88676459,03/02/2023,-493.5,-112.99000000000001
88676459,09/02/2023,-113.5,-226.49
88676459,12/02/2023,-183.53,-410.02
88676459,14/02/2023,-42.94,-452.96000000000004
88681540,31/01/2023,,531.01
88681540,01/02/2023,122.46,653.47
88681540,01/02/2023,-158.59,494.88
88681540,03/02/2023,-11.36,483.52
88681540,08/02/2023,-96.66,386.86
88681540,13/02/2023,144.82,531.6800000000001
88710457,31/01/2023,,818.28
88710457,03/02/2023,-49.28,769.0
88710457,03/02/2023,-70.8,698.1999999999999
88710457,09/02/2023,156.03,854.23
88710457,11/02/2023,-128.07,726.16
88710457,14/02/2023,-137.37,588.79
88732093,31/01/2023,,57.56
88732093,01/02/2023,81.49,139.05
88732093,01/02/2023,-132.52,6.529999999999973
88732093,06/02/2023,1502.6,1509.1299999999999
88732093,06/02/2023,878.3,2387.43
88732093,08/02/2023,-88.5,2298.93
88732093,12/02/2023,-164.29,2134.64
88824263,31/01/2023,,295.9
88824263,01/02/2023,-28.95,266.95
88824263,02/02/2023,-38.78,228.16999999999996
88824263,09/02/2023,-132.11,96.05999999999995
88824263,12/02/2023,133.13,229.18999999999994
88824263,12/02/2023,31.2,260.38999999999993
88831746,31/01/2023,,565.27
88831746,03/02/2023,128.25,693.52
88831746,04/02/2023,-101.49,592.03
88831746,07/02/2023,64.68,656.71
88831746,08/02/2023,-179.3,477.40999999999997
88831746,10/02/2023,204.71,682.12
88834465,31/01/2023,,18.3
88834465,05/02/2023,-87.06,-68.76
88834465,06/02/2023,26.04,-42.720000000000006
88834465,10/02/2023,-400.1,-442.82000000000005
88837750,31/01/2023,,269.14
88837750,03/02/2023,116.84,385.98
88837750,04/02/2023,111.74,497.71999999999997
88837750,05/02/2023,-61.25,436.46999999999997
88837750,06/02/2023,-127.59,308.88
88837750,07/02/2023,-26.09,282.78999999999996
88837750,09/02/2023,-38.34,244.45
88837750,10/02/2023,187.69,432.14
88837750,10/02/2023,-149.53,282.61
88837750,12/02/2023,76.82,359.42999999999995
88857879,31/01/2023,,601.01
88857879,03/02/2023,-16.43,584.58
88857879,08/02/2023,86.36,670.94
88857879,11/02/2023,181.25,852.19
88857879,11/02/2023,-85.41,766.78
88926132,31/01/2023,,275.1
88926132,02/02/2023,12.65,287.75
88926132,04/02/2023,1618.2,1905.95
88926132,04/02/2023,1031.4,2937.3500000000004
88926132,04/02/2023,-381.6,2555.75
88926132,07/02/2023,-64.68,2491.07
88926132,08/02/2023,113.38,2604.4500000000003
88926132,10/02/2023,-75.67,2528.78
88926132,13/02/2023,152.58,2681.36
88926132,13/02/2023,-116.52,2564.84
88926132,13/02/2023,-2264.3,300.53999999999996
88926132,14/02/2023,175.7,476.23999999999995
88933315,31/01/2023,,289.79
88933315,01/02/2023,115.4,405.19000000000005
88933315,01/02/2023,101.08,506.27000000000004
88933315,06/02/2023,-114.74,391.53000000000003
88933315,09/02/2023,108.34,499.87
88933315,09/02/2023,-82.08,417.79
88933315,11/02/2023,-150.26,267.53000000000003
88933315,11/02/2023,-1828.9,-1561.3700000000001
88933315,13/02/2023,-61.19,-1622.5600000000002
88933315,14/02/2023,87.23,-1535.3300000000002
88933315,14/02/2023,-157.43,-1692.7600000000002
88968006,31/01/2023,,952.66
88968006,02/02/2023,57.04,1009.6999999999999
88968006,04/02/2023,-89.95,919.75
88968006,04/02/2023,-129.7,790.05
88968006,08/02/2023,176.94,966.99
88974311,31/01/2023,,501.47
88974311,01/02/2023,-152.59,348.88
88974311,02/02/2023,-153.2,195.68000000000004
89065134,31/01/2023,,447.32
89065134,02/02/2023,153.04,600.36
89065134,02/02/2023,-93.52,506.84
89065134,02/02/2023,-111.91,394.93
89065134,02/02/2023,-119.89,275.03999999999996
89065134,14/02/2023,-120.46,154.57999999999998
89088715,31/01/2023,,336.6
89088715,02/02/2023,1180.2,1516.8000000000002
89088715,03/02/2023,36.14,1552.94
89088715,04/02/2023,104.24,1657.1799999999998
89088715,07/02/2023,-65.96,1591.22
89088715,10/02/2023,-63.35,1527.87
89088715,11/02/2023,79.06,1606.9299999999998
89088715,12/02/2023,77.54,1684.47
89088715,14/02/2023,117.34,1801.81
89117536,31/01/2023,,123.22
89117536,02/02/2023,150.57,273.78999999999996
89117536,02/02/2023,74.5,348.28999999999996
89117536,06/02/2023,27.56,375.84999999999997
89194917,31/01/2023,,332.56
89194917,08/02/2023,61.4,393.96
89194917,10/02/2023,-99.66,294.3
89194917,12/02/2023,-122.32,171.98000000000002
89194917,13/02/2023,-75.77,96.21000000000002
89223056,31/01/2023,,139.98
89223056,08/02/2023,149.64,289.62
89223056,09/02/2023,-39.08,250.53999999999996
89223056,09/02/2023,-98.06,152.47999999999996
89223056,09/02/2023,-141.4,11.079999999999984
89223056,11/02/2023,48.78,59.859999999999985
89223056,14/02/2023,1660.2,1720.06
89225677,31/01/2023,,660.05
89225677,04/02/2023,-52.76,607.29
89225677,05/02/2023,-80.23,527.06
89225677,06/02/2023,24.38,551.4399999999999
89225677,06/02/2023,-141.06,410.37999999999994
89225677,07/02/2023,1107.6,1517.9799999999998
89225677,09/02/2023,-123.84,1394.1399999999999
89225677,11/02/2023,90.85,1484.9899999999998
89225677,12/02/2023,108.0,1592.9899999999998
89225677,12/02/2023,-104.9,1488.0899999999997
89244577,31/01/2023,,706.67
89244577,02/02/2023,555.5,1262.17
89244577,05/02/2023,134.55,1396.72
89244577,06/02/2023,-50.86,1345.86
89244577,06/02/2023,-117.46,1228.4
89244577,08/02/2023,-96.58,1131.82
89244577,09/02/2023,103.8,1235.62
89244577,11/02/2023,-122.21,1113.41
89244577,12/02/2023,55.85,1169.26
89309725,31/01/2023,,858.68
89309725,02/02/2023,-124.23,734.4499999999999
89309725,03/02/2023,1453.5,2187.95
89309725,04/02/2023,-135.89,2052.06
89309725,07/02/2023,121.91,2173.97
89309725,08/02/2023,63.8,2237.77
89309725,09/02/2023,45.07,2282.8399999999997
89309725,12/02/2023,146.24,2429.08
89318229,31/01/2023,,675.08
89318229,02/02/2023,-72.72,602.36
89318229,02/02/2023,-98.51,503.85
89318229,07/02/2023,209.73,713.58
89318229,08/02/2023,132.6,846.1800000000001
89318229,09/02/2023,46.37,892.5500000000001
89318229,14/02/2023,-85.66,806.8900000000001
89353946,31/01/2023,,809.48
89353946,05/02/2023,142.19,951.6700000000001
89353946,07/02/2023,117.45,1069.1200000000001
89353946,07/02/2023,-1.03,1068.09
89353946,08/02/2023,-94.96,973.13
89353946,11/02/2023,-161.25,811.88
89369216,31/01/2023,,404.56
89369216,01/02/2023,-99.09,305.47
89369216,02/02/2023,57.51,362.98
89369216,06/02/2023,-87.82,275.15999999999997
89369216,07/02/2023,93.19,368.35
89369216,07/02/2023,-141.99,226.35999999999999
89369216,08/02/2023,80.72,307.08
89369216,10/02/2023,100.23,407.31
89369216,10/02/2023,61.16,468.46999999999997
89369216,10/02/2023,-107.56,360.90999999999997
89369216,11/02/2023,1944.9,2305.81
89406032,31/01/2023,,453.31
89406032,05/02/2023,-123.79,329.52
89406032,05/02/2023,-176.37,153.14999999999998
89406032,11/02/2023,-141.71,11.43999999999997
89407337,31/01/2023,,211.2
89438779,31/01/2023,,347.92
89438779,01/02/2023,-104.57,243.35000000000002
89438779,02/02/2023,-21.71,221.64000000000001
89438779,02/02/2023,-205.22,16.420000000000016
89438779,07/02/2023,140.14,156.56
89438779,07/02/2023,125.71,282.27
89438779,07/02/2023,-113.6,168.67000000000002
89438779,12/02/2023,198.2,366.87
89438779,12/02/2023,-69.44,297.43
89438779,13/02/2023,1062.5,1359.93
89471153,31/01/2023,,52.29
89471153,12/02/2023,153.64,205.92999999999998
89471153,13/02/2023,81.41,287.34
89471153,13/02/2023,-114.78,172.55999999999997
89471153,14/02/2023,-68.12,104.43999999999997
89497773,31/01/2023,,637.02
89497773,02/02/2023,131.02,768.04
89497773,03/02/2023,-94.57,673.47
89497773,04/02/2023,-100.39,573.08
89497773,06/02/2023,-55.52,517.56
89497773,07/02/2023,141.01,658.5699999999999
89497773,07/02/2023,50.93,709.5
89497773,09/02/2023,123.35,832.85
89497773,12/02/2023,123.38,956.23
89497773,14/02/2023,-172.96,783.27
89503991,31/01/2023,,204.52
89503991,02/02/2023,95.08,299.6
89503991,09/02/2023,72.3,371.9
89503991,12/02/2023,1030.7,1402.6
89608054,31/01/2023,,495.15
89608054,04/02/2023,80.37,575.52
89608054,11/02/2023,92.62,668.14
89608054,12/02/2023,190.17,858.31
89608054,12/02/2023,-86.73,771.5799999999999
89608054,14/02/2023,-116.09,655.49
89629293,31/01/2023,,292.31
89629293,11/02/2023,-124.56,167.75
89629293,14/02/2023,-191.52,-23.77000000000001
89632856,31/01/2023,,557.83
89632856,02/02/2023,-126.16,431.6700000000001
89632856,03/02/2023,-119.95,311.72
89632856,06/02/2023,50.84,362.56000000000006
89632856,08/02/2023,-1908.7,-1546.1399999999999
89645445,31/01/2023,,287.29
89645445,03/02/2023,-112.15,175.14000000000001
89645445,09/02/2023,1726.4,1901.5400000000002
89650416,31/01/2023,,146.17
89650416,01/02/2023,-205.89,-59.72
89650416,04/02/2023,-127.68,-187.4
89650416,10/02/2023,71.44,-115.96000000000001
89650416,12/02/2023,55.39,-60.57000000000001
89650416,12/02/2023,-120.12,-180.69
89689059,31/01/2023,,906.88
89689059,02/02/2023,-173.89,732.99
89689059,03/02/2023,-99.14,633.85
89689059,04/02/2023,-76.44,557.41
89689059,06/02/2023,100.18,657.59
89689059,06/02/2023,-69.68,587.91
89689059,09/02/2023,-1576.6,-988.6899999999999
89689059,14/02/2023,103.89,-884.8
89697097,31/01/2023,,449.71
89697097,02/02/2023,128.36,578.0699999999999
89697097,08/02/2023,-1737.4,-1159.3300000000002
89697097,13/02/2023,44.38,-1114.95
89697097,14/02/2023,100.83,-1014.1200000000001
89720252,31/01/2023,,672.88
89720252,03/02/2023,101.53,774.41
89720252,03/02/2023,91.02,865.43
89720252,11/02/2023,-55.02,810.41
89720252,12/02/2023,192.75,1003.16
89720252,13/02/2023,182.14,1185.3
89720252,14/02/2023,40.13,1225.43
89761152,31/01/2023,,923.01
89761152,05/02/2023,-166.03,756.98
89761152,06/02/2023,-44.43,712.55
89761152,09/02/2023,-1365.7,-653.1500000000001
89761152,11/02/2023,-67.06,-720.21
89761152,11/02/2023,-144.17,-864.3800000000001
89761152,12/02/2023,89.43,-774.95
89761152,12/02/2023,85.04,-689.9100000000001
89761152,14/02/2023,-99.21,-789.1200000000001
89905732,31/01/2023,,883.38
89905732,02/02/2023,-1921.4,-1038.02
89905732,05/02/2023,-128.78,-1166.8
89905732,05/02/2023,-141.29,-1308.09
89905732,10/02/2023,1147.5,-160.58999999999992
89905732,14/02/2023,156.56,-4.029999999999916
89916489,31/01/2023,,726.43
89916489,01/02/2023,-174.0,552.43
89916489,03/02/2023,101.75,654.18
89916489,06/02/2023,-81.53,572.65
89972805,31/01/2023,,456.55
89972805,08/02/2023,35.2,491.75
89983842,31/01/2023,,880.93
89983842,03/02/2023,39.37,920.3
89983842,05/02/2023,-80.89,839.41
89983842,07/02/2023,60.4,899.81
89983842,11/02/2023,145.45,1045.26
89983842,11/02/2023,-129.67,915.5899999999999
90019913,31/01/2023,,430.21
90019913,02/02/2023,-69.49,360.71999999999997
90019913,08/02/2023,-1693.2,-1332.48
90019913,09/02/2023,156.34,-1176.14
90019913,10/02/2023,72.21,-1103.93
90019913,12/02/2023,-622.0,-1725.93
90019913,14/02/2023,66.36,-1659.5700000000002
90044139,31/01/2023,,568.28
90044139,04/02/2023,-72.06,496.21999999999997
90044139,05/02/2023,-94.48,401.73999999999995
90044139,13/02/2023,-138.94,262.79999999999995
90054505,31/01/2023,,586.12
90054505,01/02/2023,-129.54,456.58000000000004
90054505,08/02/2023,88.44,545.02
90054505,10/02/2023,108.6,653.62
90090889,31/01/2023,,836.85
90090889,04/02/2023,-105.37,731.48
90090889,05/02/2023,142.54,874.02
90090889,10/02/2023,-1499.1,-625.0799999999999
90090889,12/02/2023,-190.9,-815.9799999999999
90090889,14/02/2023,-136.43,-952.41
90118682,31/01/2023,,58.16
90118682,02/02/2023,-129.77,-71.61000000000001
90118682,03/02/2023,149.58,77.97
90118682,03/02/2023,69.26,147.23000000000002
90118682,05/02/2023,-62.8,84.43
90118682,07/02/2023,105.38,189.81
90118682,08/02/2023,143.57,333.38
90118682,09/02/2023,-203.24,130.14
90118682,10/02/2023,-123.94,6.199999999999989
90118682,13/02/2023,-4.66,1.5399999999999885
90168031,31/01/2023,,196.48
90168031,01/02/2023,-170.35,26.129999999999995
90168031,04/02/2023,157.26,183.39
90168031,09/02/2023,-74.6,108.78999999999999
90168031,09/02/2023,-156.34,-47.55000000000001
90203948,31/01/2023,,689.49
90203948,03/02/2023,133.06,822.55
90203948,03/02/2023,103.32,925.87
90203948,06/02/2023,110.71,1036.58
90203948,08/02/2023,1608.4,2644.98
90203948,11/02/2023,-116.37,2528.61
90203948,13/02/2023,63.14,2591.75
90233696,31/01/2023,,628.02
90233696,01/02/2023,73.14,701.16
90233696,02/02/2023,-197.62,503.53999999999996
90233696,05/02/2023,138.32,641.8599999999999
90233696,08/02/2023,62.15,704.01
90233696,11/02/2023,-40.3,663.7099999999999
90233696,13/02/2023,-38.7,625.01
90287712,31/01/2023,,316.17
90287712,01/02/2023,105.25,421.42
90287712,03/02/2023,-46.33,375.09000000000003
90287712,05/02/2023,-108.31,266.78000000000003
90287712,08/02/2023,115.99,382.77
90287712,10/02/2023,-65.52,317.25
90287712,14/02/2023,59.8,377.05
90313378,31/01/2023,,743.7
90313378,03/02/2023,622.9,1366.6
90313378,03/02/2023,-99.93,1266.67
90313378,06/02/2023,169.47,1436.14
90313378,07/02/2023,57.59,1493.73
90313378,08/02/2023,24.38,1518.1100000000001
90313378,11/02/2023,-27.58,1490.53
90313378,12/02/2023,-103.79,1386.74
90313378,13/02/2023,74.74,1461.48
90336689,31/01/2023,,847.88
90336689,02/02/2023,169.64,1017.52
90336689,03/02/2023,-120.88,896.64
90336689,04/02/2023,973.3,1869.94
90336689,07/02/2023,-48.04,1821.8999999999999
90336689,09/02/2023,-69.33,1752.57
90336689,11/02/2023,-954.4,798.17
90338454,31/01/2023,,748.63
90338454,01/02/2023,-162.02,586.61
90338454,06/02/2023,57.25,643.86
90338454,08/02/2023,72.15,716.01
90338454,10/02/2023,-105.08,610.93
90349791,31/01/2023,,568.63
90349791,06/02/2023,93.16,661.79
90446254,31/01/2023,,930.0
90446254,03/02/2023,-372.2,557.8
90446254,12/02/2023,-100.81,456.99
90446254,13/02/2023,-92.53,364.46000000000004
90446254,14/02/2023,-50.66,313.8
90480183,31/01/2023,,465.06
90480183,03/02/2023,72.03,537.09
90480183,03/02/2023,-34.72,502.37
90480183,05/02/2023,94.53,596.9
90480183,05/02/2023,-167.77,429.13
90480183,06/02/2023,-140.76,288.37
90480183,07/02/2023,74.75,363.12
90549616,31/01/2023,,37.69
90549616,01/02/2023,-169.68,-131.99
90549616,01/02/2023,-787.2,-919.19
90549616,04/02/2023,27.43,-891.7600000000001
90549616,04/02/2023,-99.93,-991.69
90549616,06/02/2023,-1338.0,-2329.69
90549616,07/02/2023,-165.34,-2495.03
90549616,08/02/2023,34.93,-2460.1
90549616,10/02/2023,69.64,-2390.46
90549616,12/02/2023,-133.13,-2523.59
90549616,14/02/2023,136.43,-2387.16
90589761,31/01/2023,,535.28
90589761,02/02/2023,82.9,618.18
90589761,05/02/2023,108.08,726.26
90589761,06/02/2023,118.48,844.74
90589761,11/02/2023,-166.8,677.9399999999999
90589761,12/02/2023,158.31,836.25
90625637,31/01/2023,,477.46
90625637,03/02/2023,-110.66,366.79999999999995
90625637,07/02/2023,39.59,406.39
90625637,10/02/2023,-90.09,316.29999999999995
90625637,11/02/2023,107.06,423.36
90625637,13/02/2023,60.63,483.99
90625637,13/02/2023,-186.35,297.64
90717656,31/01/2023,,409.99
90717656,02/02/2023,224.91,634.9
90717656,04/02/2023,668.8,1303.6999999999998
90717656,09/02/2023,-39.39,1264.31
90717656,12/02/2023,114.27,1378.58
90717656,12/02/2023,-98.81,1279.77
90745743,31/01/2023,,375.07
90745743,01/02/2023,-142.99,232.07999999999998
90745743,02/02/2023,111.9,343.98
90745743,03/02/2023,-113.54,230.44
90745743,06/02/2023,98.92,329.36
90745743,10/02/2023,104.75,434.11
90745743,11/02/2023,-9.21,424.9
90745743,13/02/2023,49.9,474.79999999999995
90824896,31/01/2023,,484.11
90824896,02/02/2023,92.36,576.47
90824896,04/02/2023,104.15,680.62
90824896,06/02/2023,-74.25,606.37
90824896,08/02/2023,-10.05,596.32
90851200,31/01/2023,,361.43
90851200,02/02/2023,-755.8,-394.36999999999995
90851200,06/02/2023,83.26,-311.10999999999996
90851200,07/02/2023,46.27,-264.8399999999999
90851200,10/02/2023,150.77,-114.06999999999994
90851200,10/02/2023,-81.71,-195.77999999999992
90851200,13/02/2023,98.19,-97.58999999999993
90851200,14/02/2023,-86.1,-183.68999999999994
90871147,31/01/2023,,362.86
90871147,08/02/2023,64.27,427.13
90871147,08/02/2023,-76.59,350.54
90871147,09/02/2023,-484.0,-133.45999999999998
90871147,10/02/2023,58.45,-75.00999999999998
90871147,10/02/2023,-59.42,-134.42999999999998
90894195,31/01/2023,,157.01
90894195,02/02/2023,90.49,247.5
90894195,03/02/2023,40.13,287.63
90894195,04/02/2023,-150.38,137.25
90894195,05/02/2023,-112.34,24.909999999999997
90894195,07/02/2023,45.83,70.74
90932350,31/01/2023,,480.51
90932350,02/02/2023,98.11,578.62
90932350,06/02/2023,189.84,768.46
90932350,07/02/2023,-65.9,702.56
90932350,08/02/2023,-24.76,677.8
90932350,08/02/2023,-837.3,-159.5
90932350,09/02/2023,126.46,-33.040000000000006
90932350,09/02/2023,67.99,34.94999999999999
90932350,10/02/2023,-121.71,-86.76
90951743,31/01/2023,,220.81
90951743,02/02/2023,1559.2,1780.01
90951743,02/02/2023,-64.9,1715.11
90951743,03/02/2023,-83.25,1631.86
90951743,04/02/2023,-1548.2,83.65999999999985
90951743,05/02/2023,74.55,158.20999999999987
90951743,08/02/2023,81.17,239.37999999999985
90951743,09/02/2023,112.31,351.6899999999998
90951743,11/02/2023,26.95,378.6399999999999
90951743,11/02/2023,-96.88,281.7599999999999
90982016,31/01/2023,,776.15
90982016,07/02/2023,-92.8,683.35
90982016,09/02/2023,142.5,825.8499999999999
90982016,13/02/2023,124.37,950.22
90982016,14/02/2023,-97.59,852.63
91020929,31/01/2023,,348.12
91020929,01/02/2023,-107.56,240.56
91020929,05/02/2023,99.91,340.47
91020929,05/02/2023,-111.54,228.93
91020929,08/02/2023,-40.13,188.79999999999998
91020929,10/02/2023,-165.41,23.389999999999986
91020929,11/02/2023,39.39,62.77999999999999
91020929,13/02/2023,102.35,165.13
91020929,14/02/2023,-115.38,49.749999999999986
91062192,31/01/2023,,211.52
91062192,02/02/2023,-170.79,40.73000000000002
91062192,03/02/2023,-130.7,-89.96999999999997
91062192,06/02/2023,981.9,891.9300000000001
91142310,31/01/2023,,363.08
91142310,06/02/2023,162.13,525.21
91142310,07/02/2023,-1225.0,-699.79
91142310,14/02/2023,-666.1,-1365.8899999999999
91184544,31/01/2023,,64.05
91184544,02/02/2023,12.35,76.39999999999999
91184544,07/02/2023,-91.56,-15.16000000000001
91184544,08/02/2023,159.35,144.19
91184544,09/02/2023,71.26,215.45
91184544,11/02/2023,1207.7,1423.15
91184544,13/02/2023,-105.4,1317.75
91246568,31/01/2023,,147.43
91246568,02/02/2023,88.8,236.23000000000002
91246568,02/02/2023,-111.58,124.65
91246568,02/02/2023,-189.79,-65.13999999999999
91246568,06/02/2023,86.91,21.77000000000001
91246568,06/02/2023,-88.91,-67.13999999999999
91246568,06/02/2023,-120.78,-187.92
91246568,09/02/2023,94.78,-93.13999999999999
91246568,13/02/2023,55.07,-38.069999999999986
91246568,14/02/2023,79.76,41.69000000000002
91251995,31/01/2023,,244.0
91251995,05/02/2023,-135.59,108.41
91251995,07/02/2023,-181.11,-72.70000000000002
91251995,12/02/2023,92.56,19.859999999999985
91259453,31/01/2023,,816.68
91259453,02/02/2023,224.1,1040.78
91259453,11/02/2023,6.19,1046.97
91259453,12/02/2023,1801.4,2848.37
91259453,13/02/2023,-52.26,2796.11
91305080,31/01/2023,,123.21
91305080,01/02/2023,105.63,228.83999999999997
91305080,07/02/2023,-66.78,162.06
91305080,11/02/2023,-29.76,132.29999999999998
91305080,11/02/2023,-125.91,6.389999999999986
91305080,14/02/2023,1288.0,1294.3899999999999
91305080,14/02/2023,111.08,1405.4699999999998
91349198,31/01/2023,,669.58
91349198,06/02/2023,-1.46,668.12
91349198,09/02/2023,-54.69,613.4300000000001
91349198,10/02/2023,123.66,737.09
91349198,11/02/2023,-101.75,635.34
91349198,12/02/2023,-1149.0,-513.66
91373446,31/01/2023,,561.42
91373446,01/02/2023,-87.59,473.8299999999999
91373446,03/02/2023,-126.64,347.18999999999994
91373446,05/02/2023,55.81,402.99999999999994
91373446,05/02/2023,-112.73,290.27
91373446,06/02/2023,-137.1,153.16999999999996
91373446,09/02/2023,165.46,318.63
91373446,09/02/2023,-64.96,253.66999999999996
91373446,11/02/2023,-510.2,-256.53000000000003
91373446,14/02/2023,64.61,-191.92000000000002
91382872,31/01/2023,,782.62
91382872,10/02/2023,96.17,878.79
91382872,12/02/2023,-96.6,782.19
91423814,31/01/2023,,957.99
91423814,06/02/2023,-59.52,898.47
91423814,06/02/2023,-113.54,784.9300000000001
91445572,31/01/2023,,405.88
91445572,02/02/2023,58.4,464.28
91445572,03/02/2023,156.41,620.69
91576212,31/01/2023,,824.71
91576212,02/02/2023,-120.45,704.26
91576212,03/02/2023,-117.46,586.8000000000001
91576212,05/02/2023,53.81,640.61
91576212,08/02/2023,1254.7,1895.31
91576212,08/02/2023,-85.9,1809.41
91576212,09/02/2023,-1301.5,507.9100000000001
91576212,12/02/2023,989.2,1497.1100000000001
91605034,31/01/2023,,560.96
91605034,02/02/2023,162.1,723.0600000000001
91605034,09/02/2023,91.82,814.88
91605034,12/02/2023,-1030.7,-215.82000000000005
91621026,31/01/2023,,834.74
91621026,06/02/2023,96.79,931.53
91621026,10/02/2023,-739.5,192.02999999999997
91621026,12/02/2023,145.55,337.58
91621026,12/02/2023,142.86,480.44
91621026,12/02/2023,129.73,610.17
91621026,12/02/2023,65.91,676.0799999999999
91658755,31/01/2023,,347.59
91658755,01/02/2023,126.06,473.65
91658755,03/02/2023,59.28,532.93
91658755,03/02/2023,-1016.9,-483.97
91658755,08/02/2023,-69.56,-553.53
91658755,08/02/2023,-189.28,-742.8100000000001
91658755,10/02/2023,882.0,139.18999999999994
91658755,11/02/2023,-112.56,26.62999999999994
91658755,14/02/2023,166.87,193.49999999999994
91703213,31/01/2023,,891.67
91703213,01/02/2023,54.25,945.92
91703213,06/02/2023,43.89,989.81
91703213,07/02/2023,104.21,1094.02
91703213,08/02/2023,-62.19,1031.83
91703213,09/02/2023,-201.62,830.2099999999999
91703213,09/02/2023,-780.7,49.50999999999988
91703213,10/02/2023,132.35,181.85999999999987
91747441,31/01/2023,,356.85
91747441,03/02/2023,87.05,443.90000000000003
91747441,05/02/2023,202.11,646.01
91747441,05/02/2023,-103.17,542.84
91747441,09/02/2023,76.74,619.58
91747441,11/02/2023,108.78,728.36
91747441,11/02/2023,-129.66,598.7
91747441,13/02/2023,-151.93,446.77000000000004
91819341,31/01/2023,,701.61
91819341,02/02/2023,-99.58,602.03
91819341,07/02/2023,-44.98,557.0500000000001
91819341,07/02/2023,-90.26,466.79
91819341,09/02/2023,115.89,582.6800000000001
91819341,09/02/2023,-103.88,478.8
91819341,10/02/2023,-170.55,308.25
91829198,31/01/2023,,103.19
91829198,09/02/2023,-1156.9,-1053.71
91829198,10/02/2023,1585.0,531.29
91829198,12/02/2023,90.34,621.63
91829198,13/02/2023,-138.85,482.78
91834926,31/01/2023,,793.19
91834926,03/02/2023,53.42,846.61
91834926,04/02/2023,-8.63,837.98
91834926,09/02/2023,-121.5,716.48
91834926,11/02/2023,-143.86,572.6200000000001
91834926,12/02/2023,75.44,648.0600000000001
91834926,14/02/2023,89.16,737.22
91859090,31/01/2023,,10.38
91859090,02/02/2023,231.9,242.28
91859090,04/02/2023,97.84,340.12
91859090,06/02/2023,114.75,454.87
91859090,08/02/2023,206.07,660.94
91859090,09/02/2023,160.06,821.0
91859090,14/02/2023,52.73,873.73
91885907,31/01/2023,,652.65
91885907,03/02/2023,610.8,1263.4499999999998
91885907,05/02/2023,107.87,1371.32
91885907,05/02/2023,-125.05,1246.27
91885907,06/02/2023,-70.1,1176.1699999999998
91885907,08/02/2023,-110.64,1065.53
91885907,13/02/2023,-114.36,951.17
91939298,31/01/2023,,61.59
91939298,01/02/2023,-121.69,-60.099999999999994
91939298,02/02/2023,-122.81,-182.91
91939298,04/02/2023,-110.99,-293.9
91939298,07/02/2023,86.83,-207.07
91939298,12/02/2023,-91.62,-298.69
91939298,14/02/2023,126.03,-172.66
91943555,31/01/2023,,438.21
91943555,04/02/2023,-119.74,318.46999999999997
91943555,07/02/2023,201.7,520.17
91943555,13/02/2023,-112.0,408.16999999999996
91944915,31/01/2023,,601.21
91944915,01/02/2023,100.12,701.33
91944915,10/02/2023,192.08,893.4100000000001
91944915,12/02/2023,-68.26,825.1500000000001
91957838,31/01/2023,,587.57
91957838,03/02/2023,80.26,667.83
91957838,05/02/2023,81.6,749.4300000000001
91957838,05/02/2023,-100.87,648.5600000000001
91957838,05/02/2023,-152.02,496.54
91957838,10/02/2023,-209.84,286.70000000000005
91957838,11/02/2023,169.33,456.03000000000003
91971494,31/01/2023,,74.37
91971494,02/02/2023,-787.6,-713.23
91971494,06/02/2023,1053.5,340.27
91971494,09/02/2023,-645.9,-305.63
91971494,10/02/2023,-168.19,-473.82
91972687,31/01/2023,,463.97
91972687,07/02/2023,93.03,557.0
91972687,10/02/2023,1128.4,1685.4
91972687,14/02/2023,-144.57,1540.8300000000002
92001688,31/01/2023,,339.08
92001688,05/02/2023,-100.23,238.84999999999997
92001688,07/02/2023,60.76,299.60999999999996
92001688,08/02/2023,203.33,502.94
92001688,08/02/2023,94.91,597.85
92001688,08/02/2023,-72.05,525.8
92001688,11/02/2023,62.36,588.16
92001688,14/02/2023,-207.36,380.79999999999995
92015508,31/01/2023,,457.52
92015508,04/02/2023,-76.06,381.46
92015508,05/02/2023,-52.36,329.09999999999997
92015508,06/02/2023,171.67,500.77
92015508,07/02/2023,-119.25,381.52
92015508,10/02/2023,-83.79,297.72999999999996
92015508,11/02/2023,-29.25,268.47999999999996
92015508,14/02/2023,-150.24,118.23999999999995
92037264,31/01/2023,,252.95
92037264,03/02/2023,1131.6,1384.55
92037264,05/02/2023,81.8,1466.35
92037264,05/02/2023,-109.6,1356.75
92037264,09/02/2023,7.4,1364.1499999999999
92037264,09/02/2023,-128.74,1235.4099999999999
92037264,10/02/2023,-56.59,1178.82
92037264,11/02/2023,126.5,1305.32
92037264,12/02/2023,-151.48,1153.84
92037264,14/02/2023,-73.4,1080.44
92037264,14/02/2023,-128.56,951.8799999999999
92052516,31/01/2023,,466.43
92052516,02/02/2023,1082.7,1549.13
92052516,06/02/2023,368.9,1918.0300000000002
92052516,07/02/2023,56.32,1974.3500000000001
92052516,12/02/2023,-27.9,1946.45
92052516,14/02/2023,-68.7,1877.75
92145159,31/01/2023,,61.65
92145159,01/02/2023,122.63,184.28
92145159,01/02/2023,105.61,289.89
92145159,01/02/2023,105.36,395.25
92145159,06/02/2023,-104.1,291.15
92145159,07/02/2023,-134.99,156.16
92145159,10/02/2023,136.31,292.47
92145159,12/02/2023,-2208.4,-1915.93
92145159,13/02/2023,1370.8,-545.1300000000001
92145159,14/02/2023,-615.6,-1160.73
92155262,31/01/2023,,501.67
92155262,03/02/2023,-95.71,405.96000000000004
92155262,08/02/2023,1051.3,1457.26
92155262,09/02/2023,1060.0,2517.26
92155262,10/02/2023,134.54,2651.8
92155262,11/02/2023,175.16,2826.96
92155262,12/02/2023,58.39,2885.35
92155262,12/02/2023,-39.42,2845.93
92195724,31/01/2023,,726.92
92195724,01/02/2023,98.75,825.67
92195724,01/02/2023,-124.27,701.4
92195724,04/02/2023,-1579.8,-878.4
92195724,07/02/2023,-78.1,-956.5
92195724,08/02/2023,-221.0,-1177.5
92212099,31/01/2023,,584.21
92212099,09/02/2023,-120.47,463.74
92212099,12/02/2023,68.21,531.95
92212099,12/02/2023,-7.59,524.36
92212099,13/02/2023,-59.45,464.91
92212099,14/02/2023,-122.94,341.97
92214557,31/01/2023,,258.42
92214557,01/02/2023,173.01,431.43
92214557,02/02/2023,-80.13,351.3
92214557,04/02/2023,158.56,509.86
92214557,05/02/2023,98.2,608.0600000000001
92214557,07/02/2023,1567.0,2175.06
92214557,07/02/2023,123.67,2298.73
92214557,12/02/2023,113.72,2412.45
92214557,13/02/2023,95.71,2508.16
92221411,31/01/2023,,849.46
92221411,01/02/2023,-122.46,727.0
92221411,02/02/2023,-23.22,703.7800000000001
92221411,04/02/2023,72.06,775.84
92221411,06/02/2023,96.4,872.24
92221411,08/02/2023,122.18,994.4200000000001
92221411,08/02/2023,-89.97,904.45
92221411,12/02/2023,-123.13,781.32
92221411,14/02/2023,-78.83,702.49
92232319,31/01/2023,,416.11
92232319,02/02/2023,165.3,581.4100000000001
92232319,04/02/2023,-126.98,454.43
92232319,05/02/2023,-212.21,242.22000000000003
92232319,08/02/2023,-114.69,127.53000000000003
92232319,10/02/2023,67.69,195.22000000000003
92232319,11/02/2023,96.88,292.1
92234913,31/01/2023,,613.18
92234913,07/02/2023,-142.6,470.5799999999999
92234913,12/02/2023,803.9,1274.48
92234913,13/02/2023,-40.95,1233.53
92287463,31/01/2023,,257.14
92287463,01/02/2023,-84.96,172.18
92287463,03/02/2023,-85.62,86.55999999999999
92287463,06/02/2023,110.26,196.82
92287463,06/02/2023,-109.51,87.30999999999999
92287463,07/02/2023,-102.22,-14.91000000000001
92287463,09/02/2023,111.55,96.63999999999999
92287463,11/02/2023,31.41,128.04999999999998
92287463,12/02/2023,79.05,207.09999999999997
92319358,31/01/2023,,116.51
92319358,01/02/2023,94.06,210.57
92319358,05/02/2023,700.4,910.97
92319358,06/02/2023,143.57,1054.54
92319358,07/02/2023,-96.55,957.9899999999999
92319358,07/02/2023,-135.69,822.3
92319358,09/02/2023,1877.3,2699.6
92319358,09/02/2023,-625.1,2074.5
92319358,10/02/2023,-47.75,2026.75
92319358,10/02/2023,-137.56,1889.1899999999998
92319358,11/02/2023,157.6,2046.79
92319358,13/02/2023,-126.66,1920.1299999999999
92338537,31/01/2023,,316.24
92338537,01/02/2023,-75.36,240.88
92338537,05/02/2023,170.82,411.7
92338537,05/02/2023,-403.6,8.099999999999966
92338537,08/02/2023,30.21,38.30999999999997
92338537,13/02/2023,262.4,300.7099999999999
92338537,13/02/2023,-22.49,278.2199999999999
92340721,31/01/2023,,844.79
92340721,05/02/2023,1168.4,2013.19
92340721,06/02/2023,-163.65,1849.54
92340721,07/02/2023,744.0,2593.54
92340721,07/02/2023,34.65,2628.19
92340721,08/02/2023,110.64,2738.83
92340721,11/02/2023,-58.37,2680.46
92340721,11/02/2023,-187.8,2492.66
92340721,12/02/2023,-112.23,2380.43
92376825,31/01/2023,,323.68
92376825,01/02/2023,158.59,482.27
92376825,04/02/2023,100.39,582.66
92376825,05/02/2023,197.01,779.6700000000001
92376825,10/02/2023,145.53,925.2
92376825,11/02/2023,1214.6,2139.8
92376825,12/02/2023,120.9,2260.7
92376825,13/02/2023,103.99,2364.69
92390334,31/01/2023,,602.62
92390334,01/02/2023,-136.22,466.4
92390334,04/02/2023,-68.87,397.53
92423759,31/01/2023,,475.1
92423759,04/02/2023,131.28,606.38
92423759,04/02/2023,-664.6,-58.22000000000003
92423759,06/02/2023,90.64,32.41999999999997
92437489,31/01/2023,,24.19
92437489,04/02/2023,-40.15,-15.959999999999997
92437489,06/02/2023,176.4,160.44
92437489,10/02/2023,-73.65,86.78999999999999
92437489,10/02/2023,-89.99,-3.200000000000003
92551293,31/01/2023,,252.3
92551293,03/02/2023,55.02,307.32
92551293,13/02/2023,-122.87,184.45000000000002
92563438,31/01/2023,,965.81
92563438,01/02/2023,107.56,1073.37
92563438,01/02/2023,-164.94,908.43
92563438,04/02/2023,139.7,1048.1299999999999
92563438,09/02/2023,-99.18,948.9499999999999
92563438,10/02/2023,-118.13,830.8199999999999
92563438,13/02/2023,-76.58,754.2399999999999
92563438,14/02/2023,-66.88,687.3599999999999
92684055,31/01/2023,,430.86
92684055,03/02/2023,-165.51,265.35
92684055,11/02/2023,121.16,386.51
92684055,11/02/2023,59.3,445.81
92684055,13/02/2023,-63.47,382.34000000000003
92750088,31/01/2023,,560.4
92750088,01/02/2023,-1069.7,-509.30000000000007
92750088,04/02/2023,199.36,-309.94000000000005
92750088,05/02/2023,149.93,-160.01000000000005
92750088,06/02/2023,66.17,-93.84000000000005
92750088,07/02/2023,104.75,10.909999999999954
92770567,31/01/2023,,949.66
92770567,01/02/2023,-120.09,829.5699999999999
92770567,04/02/2023,-68.76,760.81
92770567,05/02/2023,-39.31,721.5
92770567,06/02/2023,-162.2,559.3
92770567,07/02/2023,135.62,694.92
92770567,07/02/2023,-102.52,592.4
92770567,13/02/2023,136.98,729.3799999999999
92770567,13/02/2023,-33.75,695.6299999999999
92770567,13/02/2023,-144.25,551.3799999999999
92840827,31/01/2023,,403.77
92840827,03/02/2023,106.35,510.12
92840827,10/02/2023,82.0,592.12
92840827,13/02/2023,-78.01,514.11
92840827,13/02/2023,-157.41,356.7
92872571,31/01/2023,,933.03
92872571,01/02/2023,96.06,1029.09
92872571,05/02/2023,89.62,1118.71
92872571,09/02/2023,-50.78,1067.93
92872571,12/02/2023,233.91,1301.84
92872571,14/02/2023,124.26,1426.1
92898446,31/01/2023,,64.49
92898446,07/02/2023,184.29,248.77999999999997
92898446,07/02/2023,41.35,290.13
92898446,07/02/2023,1.77,291.9
92898446,08/02/2023,-46.43,245.47
92898446,09/02/2023,6.95,252.42000000000002
92898446,09/02/2023,-132.58,119.84
92898446,12/02/2023,81.83,201.67000000000002
92910876,31/01/2023,,643.19
92910876,04/02/2023,-8.85,634.34
92910876,05/02/2023,-59.2,575.1400000000001
92910876,07/02/2023,173.79,748.9300000000001
92910876,11/02/2023,-85.36,663.57
92910876,14/02/2023,100.7,764.27
92910876,14/02/2023,-86.73,677.5400000000001
92920645,31/01/2023,,644.88
92920645,10/02/2023,-35.64,609.24
92920645,12/02/2023,-157.87,451.37
92931020,31/01/2023,,754.11
92931020,02/02/2023,-153.04,601.07
92931020,04/02/2023,-34.82,566.25
92931020,05/02/2023,-815.7,-249.45000000000005
92931020,06/02/2023,48.31,-201.14000000000004
92931020,09/02/2023,73.42,-127.72000000000004
92931020,10/02/2023,136.1,8.379999999999953
92931020,11/02/2023,-1742.7,-1734.3200000000002
92931020,12/02/2023,-120.86,-1855.18
92931020,13/02/2023,-77.95,-1933.13
92943637,31/01/2023,,28.23
92943637,02/02/2023,-140.57,-112.33999999999999
92943637,03/02/2023,88.94,-23.39999999999999
92943637,05/02/2023,-76.04,-99.44
92943637,08/02/2023,-76.65,-176.09
92943637,10/02/2023,-110.9,-286.99
92944470,31/01/2023,,445.48
92944470,01/02/2023,152.59,598.07
92944470,06/02/2023,100.9,698.97
92944470,10/02/2023,-103.91,595.0600000000001
92944470,12/02/2023,110.14,705.2
92963966,31/01/2023,,983.65
92963966,01/02/2023,3.04,986.6899999999999
92963966,06/02/2023,90.05,1076.74
93009261,31/01/2023,,675.04
93009261,02/02/2023,100.36,775.4
93009261,05/02/2023,119.42,894.8199999999999
93009261,05/02/2023,65.1,959.92
93009261,06/02/2023,1695.0,2654.92
93009261,07/02/2023,-108.88,2546.04
93009261,08/02/2023,1169.6,3715.64
93009261,09/02/2023,-76.74,3638.9
93009261,09/02/2023,-97.8,3541.1
93009261,10/02/2023,147.51,3688.6099999999997
93009261,10/02/2023,93.3,3781.91
93009261,10/02/2023,-213.83,3568.08
93009261,13/02/2023,125.85,3693.93
93039862,31/01/2023,,806.99
93039862,02/02/2023,61.2,868.19
93039862,03/02/2023,27.83,896.02
93039862,07/02/2023,-66.88,829.14
93039862,09/02/2023,-132.48,696.6600000000001
93039862,10/02/2023,118.13,814.79
93039862,14/02/2023,82.7,897.49
93076057,31/01/2023,,218.56
93076057,02/02/2023,143.82,362.38
93076057,04/02/2023,87.35,449.73
93128216,31/01/2023,,834.73
93128216,03/02/2023,-10.64,824.09
93128216,03/02/2023,-144.61,679.48
93128216,10/02/2023,-44.74,634.74
93128216,11/02/2023,168.92,803.66
93128216,14/02/2023,-136.93,666.73
93147630,31/01/2023,,403.93
93147630,07/02/2023,148.81,552.74
93147630,11/02/2023,-116.92,435.82
93147630,13/02/2023,130.18,566.0
93147630,13/02/2023,-136.72,429.28
93192347,31/01/2023,,298.01
93192347,01/02/2023,-1277.2,-979.19
93192347,04/02/2023,158.04,-821.1500000000001
93192347,04/02/2023,-126.02,-947.1700000000001
93192347,05/02/2023,51.72,-895.45
93192347,08/02/2023,92.59,-802.86
93192347,09/02/2023,1325.7,522.84
93192347,12/02/2023,-2147.9,-1625.06
93192347,14/02/2023,-171.25,-1796.31
93192347,14/02/2023,-626.8,-2423.1099999999997
93248179,31/01/2023,,376.57
93248179,01/02/2023,-27.36,349.21
93248179,01/02/2023,-130.11,219.09999999999997
93248179,04/02/2023,182.66,401.76
93306742,31/01/2023,,388.54
93306742,11/02/2023,181.51,570.05
93306742,13/02/2023,61.83,631.88
93306742,13/02/2023,43.87,675.75
93325549,31/01/2023,,161.45
93325549,01/02/2023,177.63,339.08
93325549,05/02/2023,790.5,1129.58
93325549,08/02/2023,168.29,1297.87
93325549,10/02/2023,106.29,1404.1599999999999
93325549,11/02/2023,-68.2,1335.96
93325549,14/02/2023,79.28,1415.24
93346040,31/01/2023,,816.07
93346040,01/02/2023,-69.18,746.8900000000001
93346040,06/02/2023,-12.77,734.12
93346040,07/02/2023,10.31,744.4300000000001
93346040,07/02/2023,-135.7,608.73
93346040,07/02/2023,-814.4,-205.66999999999996
93346040,08/02/2023,153.79,-51.87999999999997
93346040,09/02/2023,118.46,66.58000000000003
93346040,10/02/2023,118.13,184.71000000000004
93349543,31/01/2023,,329.45
93349543,01/02/2023,-122.63,206.82
93349543,03/02/2023,-103.43,103.38999999999999
93349543,04/02/2023,-118.6,-15.210000000000008
93349543,05/02/2023,66.8,51.58999999999999
93349543,05/02/2023,-86.14,-34.55000000000001
93355755,31/01/2023,,753.84
93355755,03/02/2023,-49.54,704.3000000000001
93355755,09/02/2023,104.28,808.58
93355755,10/02/2023,-11.73,796.85
93388304,31/01/2023,,73.0
93388304,04/02/2023,162.79,235.79
93388304,04/02/2023,66.05,301.84
93388304,08/02/2023,38.91,340.75
93388304,09/02/2023,157.3,498.05
93388304,11/02/2023,-3.02,495.03000000000003
93388304,13/02/2023,142.04,637.0699999999999
93409343,31/01/2023,,748.45
93409343,01/02/2023,830.7,1579.15
93409343,05/02/2023,-81.2,1497.95
93409343,06/02/2023,-66.17,1431.7800000000002
93409343,08/02/2023,94.16,1525.94
93409343,12/02/2023,-110.2,1415.74
93429066,31/01/2023,,652.04
93429066,04/02/2023,-146.82,505.21999999999997
93429066,05/02/2023,131.36,636.5799999999999
93429066,05/02/2023,-149.41,487.16999999999996
93429066,12/02/2023,-96.27,390.9
93443317,31/01/2023,,305.29
93443317,01/02/2023,124.69,429.98
93443317,02/02/2023,94.47,524.45
93443317,03/02/2023,-141.16,383.29
93443317,04/02/2023,87.13,470.42
93446276,31/01/2023,,184.74
93446276,01/02/2023,187.15,371.89
93446276,01/02/2023,89.8,461.69
93446276,01/02/2023,-142.15,319.54
93446276,02/02/2023,701.1,1020.6400000000001
93446276,02/02/2023,162.35,1182.99
93446276,02/02/2023,-95.1,1087.8899999999999
93446276,05/02/2023,-106.71,981.18
93446276,07/02/2023,-141.05,840.13
93446276,09/02/2023,1679.2,2519.33
93446276,10/02/2023,154.12,2673.4500000000003
93529019,31/01/2023,,463.32
93529019,04/02/2023,157.05,620.37
93529019,05/02/2023,94.84,715.21
93529019,06/02/2023,160.08,875.29
93529019,06/02/2023,65.08,940.37
93529019,07/02/2023,184.95,1125.32
93529019,08/02/2023,-59.4,1065.92
93529019,09/02/2023,-111.83,954.09
93529019,10/02/2023,-82.73,871.36
93529019,11/02/2023,1507.4,2378.76
93529019,14/02/2023,-157.14,2221.6200000000003
93559470,31/01/2023,,210.7
93559470,01/02/2023,-126.64,84.05999999999999
93559470,05/02/2023,64.51,148.57
93559470,05/02/2023,-749.9,-601.3299999999999
93559470,08/02/2023,162.59,-438.74
93559470,08/02/2023,-107.7,-546.44
93559470,09/02/2023,-150.22,-696.6600000000001
93559470,10/02/2023,73.99,-622.6700000000001
93559470,10/02/2023,-86.61,-709.28
93564856,31/01/2023,,234.66
93564856,01/02/2023,117.24,351.9
93564856,06/02/2023,93.76,445.65999999999997
93564856,09/02/2023,97.55,543.21
93564856,10/02/2023,67.2,610.41
93564856,11/02/2023,119.87,730.28
93564856,12/02/2023,1690.9,2421.1800000000003
93564856,14/02/2023,-96.41,2324.77
93569124,31/01/2023,,221.11
93569124,10/02/2023,156.63,377.74
93569124,11/02/2023,3.02,380.76
93569124,14/02/2023,-80.98,299.78
93624474,31/01/2023,,622.14
93624474,02/02/2023,114.87,737.01
93624474,03/02/2023,85.3,822.31
93624474,04/02/2023,80.51,902.8199999999999
93624474,04/02/2023,-31.94,870.88
93624474,09/02/2023,-940.9,-70.01999999999998
93624474,10/02/2023,-57.04,-127.05999999999997
93624474,11/02/2023,1058.7,931.6400000000001
93624474,14/02/2023,93.52,1025.16
93630048,31/01/2023,,317.95
93630048,02/02/2023,35.9,353.84999999999997
93630048,03/02/2023,-56.07,297.78
93630048,03/02/2023,-61.29,236.48999999999998
93630048,14/02/2023,34.96,271.45
93630048,14/02/2023,-66.36,205.08999999999997
93707181,31/01/2023,,321.91
93707181,01/02/2023,99.63,421.54
93707181,03/02/2023,144.82,566.36
93707181,05/02/2023,87.06,653.4200000000001
93745446,31/01/2023,,574.89
93745446,02/02/2023,787.6,1362.49
93745446,05/02/2023,177.67,1540.16
93745446,08/02/2023,136.68,1676.84
93745446,09/02/2023,50.28,1727.12
93745446,10/02/2023,-1275.3,451.82000000000016
93745446,12/02/2023,94.0,545.8200000000002
93745446,12/02/2023,-64.01,481.8100000000002
93745446,12/02/2023,-91.07,390.7400000000002
93745446,13/02/2023,-185.27,205.47000000000014
93747938,31/01/2023,,724.31
93747938,07/02/2023,-1076.8,-352.49
93747938,08/02/2023,55.57,-296.92
93747938,09/02/2023,-158.5,-455.42
93747938,10/02/2023,-59.31,-514.73
93840154,31/01/2023,,159.7
93840154,05/02/2023,-94.38,65.32
93840154,08/02/2023,114.36,179.68
93840154,10/02/2023,-90.78,88.89999999999999
93840154,14/02/2023,99.95,188.85
93840154,14/02/2023,-22.59,166.26
93932516,31/01/2023,,575.82
93932516,02/02/2023,-110.52,465.30000000000007
93932516,05/02/2023,-859.9,-394.5999999999999
93932516,07/02/2023,132.98,-261.6199999999999
93932516,07/02/2023,-36.15,-297.7699999999999
93932516,08/02/2023,217.58,-80.18999999999991
93932516,08/02/2023,-15.71,-95.89999999999992
93932516,09/02/2023,105.71,9.810000000000088
93932516,11/02/2023,-62.36,-52.54999999999991
93932516,13/02/2023,-153.14,-205.68999999999988
93981472,31/01/2023,,175.68
93981472,02/02/2023,1298.8,1474.48
93981472,05/02/2023,178.08,1652.56
93981472,08/02/2023,114.16,1766.72
93981472,08/02/2023,-597.4,1169.3200000000002
93981472,10/02/2023,131.62,1300.94
93981472,10/02/2023,108.85,1409.79
93981472,10/02/2023,-82.23,1327.56
93981472,12/02/2023,-190.17,1137.39
93981472,13/02/2023,-104.7,1032.69
93981472,14/02/2023,-135.14,897.5500000000001
94044891,31/01/2023,,367.77
94044891,03/02/2023,123.6,491.37
94044891,05/02/2023,-102.47,388.9
94044891,06/02/2023,57.47,446.37
94044891,13/02/2023,-112.88,333.49
94060198,31/01/2023,,309.9
94060198,01/02/2023,-1663.4,-1353.5
94060198,02/02/2023,-166.1,-1519.6
94060198,03/02/2023,-103.32,-1622.92
94060198,05/02/2023,1317.7,-305.22
94060198,09/02/2023,-82.05,-387.27000000000004
94060198,10/02/2023,145.86,-241.41000000000003
94060198,10/02/2023,59.66,-181.75000000000003
94060198,13/02/2023,47.89,-133.86
94082779,31/01/2023,,49.87
94082779,03/02/2023,-76.42,-26.550000000000004
94082779,06/02/2023,89.28,62.73
94082779,13/02/2023,127.51,190.24
94096082,31/01/2023,,342.2
94096082,05/02/2023,159.46,501.65999999999997
94096082,09/02/2023,-134.28,367.38
94096082,13/02/2023,445.8,813.1800000000001
94106013,31/01/2023,,844.86
94106013,04/02/2023,87.65,932.51
94106013,04/02/2023,58.55,991.0600000000001
94106013,07/02/2023,119.45,1110.51
94106013,12/02/2023,-94.08,1016.4300000000001
94106013,14/02/2023,148.07,1164.5
94163785,31/01/2023,,953.91
94163785,03/02/2023,886.3,1840.21
94163785,04/02/2023,-100.25,1739.96
94163785,06/02/2023,-115.81,1624.1499999999999
94163785,07/02/2023,-118.34,1505.81
94163785,12/02/2023,-100.49,1405.32
94163785,14/02/2023,-166.87,1238.4499999999998
94171142,31/01/2023,,261.94
94171142,01/02/2023,-123.08,138.86
94171142,02/02/2023,148.35,287.21
94171142,02/02/2023,-133.09,154.11999999999998
94171142,08/02/2023,-522.3,-368.17999999999995
94171142,09/02/2023,-65.15,-433.3299999999999
94171142,11/02/2023,17.89,-415.43999999999994
94171142,11/02/2023,-149.19,-564.6299999999999
94171142,14/02/2023,-483.2,-1047.83
94200289,31/01/2023,,207.5
94200289,05/02/2023,-27.36,180.14
94200289,05/02/2023,-123.78,56.36
94200289,06/02/2023,178.95,235.31
94200289,06/02/2023,-15.22,220.09
94200289,07/02/2023,-70.76,149.32999999999998
94200289,12/02/2023,153.75,303.08
94200289,14/02/2023,-131.36,171.71999999999997
94208888,31/01/2023,,97.84
94208888,03/02/2023,-164.94,-67.1
94208888,04/02/2023,109.5,42.400000000000006
94208888,11/02/2023,-1944.9,-1902.5
94208888,12/02/2023,-109.26,-2011.76
94212460,31/01/2023,,215.27
94228831,31/01/2023,,277.02
94228831,02/02/2023,140.61,417.63
94228831,03/02/2023,-131.74,285.89
94228831,06/02/2023,109.48,395.37
94228831,06/02/2023,-110.54,284.83
94228831,12/02/2023,176.03,460.86
94247629,31/01/2023,,308.63
94247629,04/02/2023,39.76,348.39
94247629,05/02/2023,105.91,454.29999999999995
94247629,07/02/2023,-1738.7,-1284.4
94247629,12/02/2023,110.2,-1174.2
94331180,31/01/2023,,89.31
94331180,01/02/2023,-54.98,34.330000000000005
94331180,07/02/2023,101.44,135.77
94331180,11/02/2023,-105.42,30.35000000000001
94331180,13/02/2023,-70.85,-40.499999999999986
94342965,31/01/2023,,282.51
94342965,02/02/2023,107.51,390.02
94342965,05/02/2023,-159.07,230.95
94342965,09/02/2023,1208.0,1438.95
94342965,12/02/2023,-133.51,1305.44
94365401,31/01/2023,,81.28
94365401,02/02/2023,37.62,118.9
94365401,03/02/2023,-101.25,17.650000000000006
94365401,08/02/2023,93.77,111.42
94365401,11/02/2023,122.21,233.63
94365401,12/02/2023,-31.2,202.43
94409941,31/01/2023,,642.83
94409941,01/02/2023,-92.51,550.32
94409941,04/02/2023,629.0,1179.3200000000002
94409941,12/02/2023,66.55,1245.8700000000001
94409941,14/02/2023,-152.69,1093.18
94409941,14/02/2023,-867.5,225.68000000000006
94437482,31/01/2023,,415.91
94437482,06/02/2023,94.32,510.23
94437482,06/02/2023,-143.44,366.79
94437482,09/02/2023,-53.97,312.82000000000005
94437482,10/02/2023,-46.55,266.27000000000004
94437482,14/02/2023,950.7,1216.97
94457332,31/01/2023,,764.02
94457332,05/02/2023,-107.79,656.23
94457332,06/02/2023,146.96,803.19
94457332,14/02/2023,-33.66,769.53
94493359,31/01/2023,,17.96
94493359,03/02/2023,-133.41,-115.44999999999999
94493359,06/02/2023,-112.02,-227.46999999999997
94493359,07/02/2023,-171.17,-398.64
94493359,10/02/2023,-83.93,-482.57
94493359,11/02/2023,129.35,-353.22
94493359,11/02/2023,-102.91,-456.13
94493359,12/02/2023,-106.86,-562.99
94525216,31/01/2023,,635.22
94525216,02/02/2023,44.56,679.78
94525216,05/02/2023,-115.1,564.6800000000001
94525216,07/02/2023,132.14,696.82
94525216,07/02/2023,97.95,794.77
94525216,07/02/2023,-183.44,611.33
94525216,09/02/2023,190.82,802.1500000000001
94525216,10/02/2023,139.51,941.6600000000001
94566140,31/01/2023,,31.61
94566140,04/02/2023,-54.15,-22.54
94566140,06/02/2023,-128.91,-151.45
94566140,07/02/2023,38.88,-112.57
94566140,07/02/2023,-152.23,-264.79999999999995
94566140,09/02/2023,44.94,-219.85999999999999
94566140,13/02/2023,-104.5,-324.36
94566140,14/02/2023,38.12,-286.24
94615411,31/01/2023,,147.21
94615411,02/02/2023,-1015.8,-868.5899999999999
94615411,04/02/2023,151.32,-717.27
94615411,08/02/2023,71.98,-645.29
94615411,09/02/2023,176.97,-468.31999999999994
94615411,09/02/2023,-109.51,-577.8299999999999
94615411,10/02/2023,-79.77,-657.5999999999999
94615411,12/02/2023,138.36,-519.2399999999999
94615411,12/02/2023,-93.78,-613.02
94629877,31/01/2023,,908.69
94629877,03/02/2023,65.94,974.6300000000001
94629877,04/02/2023,884.9,1859.53
94629877,04/02/2023,-686.5,1173.03
94629877,04/02/2023,-1031.4,141.62999999999988
94629877,05/02/2023,-112.93,28.699999999999875
94629877,09/02/2023,899.8,928.4999999999998
94629877,10/02/2023,181.71,1110.2099999999998
94629877,12/02/2023,72.46,1182.6699999999998
94635297,31/01/2023,,353.43
94635297,02/02/2023,-25.81,327.62
94635297,03/02/2023,115.87,443.49
94635297,04/02/2023,-92.27,351.22
94635297,05/02/2023,82.64,433.86
94635297,08/02/2023,-76.81,357.05
94645169,31/01/2023,,854.22
94645169,01/02/2023,-98.05,756.1700000000001
94645169,03/02/2023,-12.0,744.1700000000001
94645169,07/02/2023,125.24,869.4100000000001
94645169,07/02/2023,-74.77,794.64
94645169,07/02/2023,-133.96,660.6800000000001
94645169,11/02/2023,-173.97,486.71000000000004
94645169,12/02/2023,128.94,615.65
94645169,13/02/2023,-127.51,488.14
94645169,14/02/2023,-0.73,487.41
94660017,31/01/2023,,107.29
94660017,01/02/2023,-115.14,-7.849999999999994
94660017,10/02/2023,86.75,78.9
94660017,12/02/2023,41.61,120.51
94660017,13/02/2023,123.64,244.15
94660017,13/02/2023,47.03,291.18
94677908,31/01/2023,,343.33
94677908,01/02/2023,115.41,458.74
94677908,03/02/2023,117.22,575.96
94677908,03/02/2023,88.14,664.1
94677908,04/02/2023,-106.07,558.03
94677908,07/02/2023,-121.46,436.57
94677908,08/02/2023,-143.85,292.72
94677908,09/02/2023,138.19,430.90999999999997
94677908,12/02/2023,-1534.6,-1103.69
94677908,13/02/2023,170.79,-932.9000000000001
94716844,31/01/2023,,605.84
94716844,01/02/2023,-102.9,502.94000000000005
94716844,04/02/2023,168.29,671.23
94716844,04/02/2023,-90.09,581.14
94716844,06/02/2023,-58.17,522.97
94716844,08/02/2023,123.06,646.03
94716844,10/02/2023,62.94,708.97
94716844,11/02/2023,-62.9,646.07
94716844,13/02/2023,80.74,726.81
94716844,13/02/2023,-101.87,624.94
94716844,14/02/2023,198.2,823.14
94716844,14/02/2023,94.45,917.59
94729530,31/01/2023,,635.76
94729530,01/02/2023,136.75,772.51
94729530,01/02/2023,62.95,835.46
94729530,01/02/2023,58.96,894.42
94729530,10/02/2023,-142.57,751.85
94729530,13/02/2023,163.99,915.84
94729530,13/02/2023,104.5,1020.34
94732589,31/01/2023,,697.54
94732589,02/02/2023,-90.91,606.63
94732589,03/02/2023,-139.6,467.03
94732589,03/02/2023,-180.87,286.15999999999997
94732589,04/02/2023,102.44,388.59999999999997
94732589,06/02/2023,124.22,512.8199999999999
94732589,06/02/2023,47.78,560.5999999999999
94732589,14/02/2023,-120.42,440.17999999999995
94748860,31/01/2023,,630.6
94748860,04/02/2023,44.05,674.65
94748860,08/02/2023,119.07,793.72
94748860,08/02/2023,31.3,825.02
94796578,31/01/2023,,700.49
94796578,01/02/2023,-1057.7,-357.21000000000004
94796578,03/02/2023,65.14,-292.07000000000005
94796578,03/02/2023,40.39,-251.68000000000004
94796578,05/02/2023,112.69,-138.99000000000004
94796578,06/02/2023,110.83,-28.16000000000004
94796578,06/02/2023,84.58,56.41999999999996
94796578,07/02/2023,-169.36,-112.94000000000005
94796578,08/02/2023,-167.11,-280.05000000000007
94796578,10/02/2023,249.81,-30.240000000000066
94796578,12/02/2023,48.09,17.849999999999937
94796578,13/02/2023,34.3,52.149999999999935
94796578,14/02/2023,79.54,131.68999999999994
94796578,14/02/2023,68.12,199.80999999999995
94814824,31/01/2023,,716.75
94814824,05/02/2023,159.3,876.05
94814824,07/02/2023,11.37,887.42
94814824,09/02/2023,-87.99,799.4300000000001
94814824,13/02/2023,-119.69,679.74
94814824,14/02/2023,60.02,739.76
94893604,31/01/2023,,289.19
94893604,01/02/2023,122.07,411.26
94893604,02/02/2023,-140.27,270.99
94893604,04/02/2023,150.79,421.78
94893604,08/02/2023,90.52,512.3
94893604,12/02/2023,104.51,616.81
94935991,31/01/2023,,645.53
94935991,03/02/2023,-109.74,535.79
94935991,04/02/2023,118.19,653.98
94935991,04/02/2023,7.06,661.04
94935991,09/02/2023,84.03,745.0699999999999
94935991,10/02/2023,116.72,861.79
94935991,12/02/2023,1015.8,1877.59
94935991,14/02/2023,-36.6,1840.99
94973297,31/01/2023,,761.68
94973297,04/02/2023,-112.13,649.55
94973297,06/02/2023,-81.6,567.9499999999999
94973297,09/02/2023,-69.64,498.30999999999995
94973297,10/02/2023,1275.3,1773.61
94973297,10/02/2023,-73.16,1700.4499999999998
94973297,14/02/2023,-1365.0,335.4499999999998
95009921,31/01/2023,,658.77
95009921,01/02/2023,124.27,783.04
95009921,02/02/2023,103.03,886.0699999999999
95009921,04/02/2023,153.28,1039.35
95009921,05/02/2023,158.54,1197.8899999999999
95009921,06/02/2023,87.21,1285.1
95009921,08/02/2023,94.29,1379.3899999999999
95009921,09/02/2023,-144.93,1234.46
95009921,12/02/2023,87.73,1322.19
95009921,14/02/2023,188.3,1510.49
95009921,14/02/2023,110.66,1621.1499999999999
95009921,14/02/2023,-111.08,1510.07
95060122,31/01/2023,,771.61
95060122,03/02/2023,-116.84,654.77
95060122,03/02/2023,-119.68,535.09
95060122,04/02/2023,152.03,687.12
95060122,06/02/2023,-633.0,54.120000000000005
95060122,10/02/2023,70.94,125.06
95060122,10/02/2023,-65.02,60.040000000000006
95060122,10/02/2023,-163.3,-103.26
95060122,14/02/2023,-29.41,-132.67000000000002
95081571,31/01/2023,,712.07
95081571,01/02/2023,-76.26,635.8100000000001
95081571,02/02/2023,-88.57,547.24
95081571,02/02/2023,-125.99,421.25000000000006
95081571,07/02/2023,17.58,438.83000000000004
95081571,07/02/2023,-168.17,270.6600000000001
95081571,08/02/2023,1330.7,1601.3600000000001
95081571,08/02/2023,60.7,1662.0600000000002
95081571,09/02/2023,156.71,1818.7700000000002
95081571,13/02/2023,104.02,1922.7900000000002
95113741,31/01/2023,,102.12
95113741,02/02/2023,113.73,215.85000000000002
95113741,03/02/2023,189.03,404.88
95113741,07/02/2023,171.53,576.41
95113741,08/02/2023,63.41,639.8199999999999
95213279,31/01/2023,,441.59
95213279,04/02/2023,-7.06,434.53
95213279,04/02/2023,-85.93,348.59999999999997
95213279,05/02/2023,-33.85,314.74999999999994
95213279,07/02/2023,-50.49,264.26
95213279,08/02/2023,-2591.7,-2327.4399999999996
95213279,11/02/2023,-96.92,-2424.3599999999997
95258436,31/01/2023,,59.55
95258436,02/02/2023,139.25,198.8
95258436,02/02/2023,-89.87,108.93
95258436,02/02/2023,-158.32,-49.389999999999986
95258436,06/02/2023,75.55,26.16000000000001
95258436,09/02/2023,141.82,167.98000000000002
95258436,09/02/2023,112.05,280.03000000000003
95258436,10/02/2023,121.81,401.84000000000003
95258436,14/02/2023,963.5,1365.3400000000001
95258436,14/02/2023,-101.59,1263.75
95258436,14/02/2023,-105.98,1157.77
95274344,31/01/2023,,990.84
95274344,05/02/2023,159.79,1150.63
95274344,05/02/2023,-165.04,985.59
95274344,05/02/2023,-962.0,23.590000000000032
95274344,06/02/2023,-99.03,-75.43999999999997
95274344,08/02/2023,123.12,47.680000000000035
95274344,14/02/2023,-85.48,-37.79999999999997
95277712,31/01/2023,,235.91
95277712,03/02/2023,83.69,319.6
95277712,04/02/2023,-88.83,230.76999999999998
95277712,05/02/2023,99.25,330.02
95277712,07/02/2023,-123.68,206.33999999999997
95277712,11/02/2023,-133.67,72.67000000000002
95277712,12/02/2023,-934.7,-862.03
95307629,31/01/2023,,502.48
95307629,01/02/2023,89.15,591.63
95307629,05/02/2023,41.65,633.28
95307629,09/02/2023,-1324.2,-690.9200000000001
95307629,12/02/2023,-68.37,-759.2900000000001
95307629,14/02/2023,171.69,-587.6000000000001
95307629,14/02/2023,31.7,-555.9000000000001
95309911,31/01/2023,,171.61
95309911,01/02/2023,-82.42,89.19000000000001
95309911,02/02/2023,110.35,199.54000000000002
95309911,05/02/2023,39.2,238.74
95309911,06/02/2023,154.75,393.49
95309911,06/02/2023,32.34,425.83000000000004
95309911,09/02/2023,363.8,789.63
95309911,09/02/2023,-97.89,691.74
95309911,12/02/2023,109.26,801.0
95356167,31/01/2023,,170.2
95356167,08/02/2023,-38.77,131.42999999999998
95356167,10/02/2023,28.58,160.01
95356167,12/02/2023,103.79,263.79999999999995
95356167,14/02/2023,123.85,387.65
95367755,31/01/2023,,926.51
95367755,04/02/2023,-622.4,304.11
95367755,07/02/2023,70.62,374.73
95367755,08/02/2023,-130.71,244.02
95367755,13/02/2023,63.17,307.19
95367755,13/02/2023,-101.66,205.53000000000003
95390412,31/01/2023,,553.04
95390412,01/02/2023,-149.8,403.23999999999995
95390412,02/02/2023,-52.25,350.98999999999995
95390412,03/02/2023,79.35,430.3399999999999
95390412,07/02/2023,98.57,528.91
95390412,09/02/2023,-1176.8,-647.89
95390412,11/02/2023,-100.23,-748.12
95412973,31/01/2023,,892.85
95412973,02/02/2023,-200.43,692.4200000000001
95412973,10/02/2023,-163.93,528.49
95412973,13/02/2023,-33.78,494.71000000000004
95446510,31/01/2023,,581.43
95446510,04/02/2023,121.95,703.38
95446510,04/02/2023,88.15,791.53
95446510,04/02/2023,-200.42,591.1099999999999
95446510,06/02/2023,-45.01,546.0999999999999
95446510,08/02/2023,-129.87,416.22999999999996
95446510,13/02/2023,-96.41,319.81999999999994
95452518,31/01/2023,,390.37
95452518,06/02/2023,172.27,562.64
95452518,08/02/2023,-110.07,452.57000000000005
95452518,12/02/2023,-86.17,366.40000000000003
95467370,31/01/2023,,307.45
95467370,02/02/2023,1273.1,1580.55
95467370,03/02/2023,31.0,1611.55
95467370,04/02/2023,50.69,1662.24
95467370,05/02/2023,-20.31,1641.93
95467370,06/02/2023,-124.17,1517.76
95467370,09/02/2023,-73.6,1444.1599999999999
95467370,10/02/2023,162.32,1606.48
95527674,31/01/2023,,688.37
95527674,01/02/2023,164.94,853.31
95527674,03/02/2023,-145.97,707.34
95527674,07/02/2023,-86.51,620.83
95527674,09/02/2023,123.88,744.71
95527674,09/02/2023,-102.14,642.5699999999999
95527674,11/02/2023,133.59,776.16
95527674,11/02/2023,107.57,883.73
95527674,11/02/2023,106.62,990.35
95527674,14/02/2023,-167.84,822.51
95564462,31/01/2023,,643.45
95564462,04/02/2023,165.42,808.87
95564462,06/02/2023,-22.99,785.88
95564462,12/02/2023,78.89,864.77
95600095,31/01/2023,,400.05
95600095,07/02/2023,125.12,525.1700000000001
95600095,12/02/2023,91.81,616.98
95600095,13/02/2023,-125.16,491.82000000000005
95642341,31/01/2023,,695.88
95642341,01/02/2023,546.3,1242.1799999999998
95642341,05/02/2023,-97.45,1144.73
95642341,07/02/2023,-56.49,1088.24
95642341,10/02/2023,-1375.3,-287.05999999999995
95642341,12/02/2023,134.41,-152.64999999999995
95642341,13/02/2023,104.51,-48.139999999999944
95642341,13/02/2023,42.26,-5.879999999999946
95642341,14/02/2023,-175.48,-181.35999999999993
95645055,31/01/2023,,645.58
95645055,06/02/2023,78.61,724.19
95645055,10/02/2023,99.28,823.47
95645055,11/02/2023,24.18,847.6500000000001
95645055,11/02/2023,-40.71,806.94
95674888,31/01/2023,,838.92
95674888,01/02/2023,124.86,963.78
95674888,08/02/2023,-19.59,944.1899999999999
95674888,13/02/2023,1258.1,2202.29
95674888,13/02/2023,77.47,2279.7599999999998
95674888,13/02/2023,4.66,2284.42
95674888,13/02/2023,-49.89,2234.5299999999997
95674888,14/02/2023,178.46,2412.99
95710324,31/01/2023,,978.16
95710324,02/02/2023,-30.01,948.15
95710324,02/02/2023,-82.72,865.43
95710324,09/02/2023,-188.14,677.29
95710324,10/02/2023,1484.2,2161.49
95710324,10/02/2023,73.65,2235.14
95710324,10/02/2023,-142.13,2093.01
95723006,31/01/2023,,861.2
95723006,04/02/2023,1084.8,1946.0
95723006,06/02/2023,-83.83,1862.17
95723006,09/02/2023,-96.82,1765.35
95723006,10/02/2023,128.96,1894.31
95723006,10/02/2023,91.88,1986.19
95723006,11/02/2023,-73.66,1912.53
95743658,31/01/2023,,586.9
95743658,01/02/2023,58.18,645.0799999999999
95743658,02/02/2023,-86.69,558.39
95743658,03/02/2023,-147.01,411.38
95743658,07/02/2023,934.2,1345.58
95743658,07/02/2023,107.79,1453.3700000000001
95743658,07/02/2023,54.63,1508.0
95743658,09/02/2023,-96.52,1411.48
95743658,09/02/2023,-121.16,1290.3200000000002
95743658,11/02/2023,96.16,1386.48
95743658,12/02/2023,27.74,1414.22
95743658,13/02/2023,81.01,1495.23
95759022,31/01/2023,,78.02
95759022,01/02/2023,76.39,154.41
95759022,02/02/2023,-28.18,126.22999999999999
95759022,05/02/2023,33.85,160.07999999999998
95759022,06/02/2023,179.08,339.16
95759022,09/02/2023,484.0,823.1600000000001
95759022,09/02/2023,-156.08,667.08
95868007,31/01/2023,,974.32
95868007,01/02/2023,-89.15,885.1700000000001
95868007,02/02/2023,-69.41,815.76
95868007,03/02/2023,-267.7,548.0600000000001
95868007,05/02/2023,-134.55,413.51000000000005
95868007,06/02/2023,56.08,469.59000000000003
95868007,06/02/2023,-92.7,376.89000000000004
95868007,06/02/2023,-95.31,281.58000000000004
95868007,07/02/2023,79.32,360.90000000000003
95868007,11/02/2023,-134.5,226.40000000000003
95898143,31/01/2023,,197.65
95898143,05/02/2023,97.37,295.02
95898143,09/02/2023,-50.63,244.39000000000001
95898143,10/02/2023,-782.2,-537.8100000000001
95898143,12/02/2023,109.9,-427.9100000000001
95993993,31/01/2023,,95.41
95993993,03/02/2023,-1266.7,-1171.29
95993993,07/02/2023,113.79,-1057.5
95993993,13/02/2023,38.7,-1018.8
95993993,14/02/2023,1137.7,118.90000000000009
96050548,31/01/2023,,299.46
96050548,04/02/2023,-72.83,226.63
96050548,08/02/2023,125.91,352.53999999999996
96050548,09/02/2023,102.32,454.85999999999996
96050548,09/02/2023,-84.55,370.30999999999995
96050548,11/02/2023,-107.86,262.45
96051784,31/01/2023,,21.7
96051784,01/02/2023,111.89,133.59
96051784,05/02/2023,-1121.5,-987.91
96051784,06/02/2023,99.31,-888.5999999999999
96051784,07/02/2023,77.46,-811.14
96051784,13/02/2023,-141.46,-952.5999999999999
96121732,31/01/2023,,771.81
96121732,01/02/2023,84.68,856.49
96121732,01/02/2023,-101.68,754.81
96121732,04/02/2023,70.76,825.5699999999999
96121732,04/02/2023,-81.94,743.63
96121732,05/02/2023,98.3,841.93
96121732,05/02/2023,-98.3,743.63
96121732,05/02/2023,-99.15,644.4799999999999
96121732,10/02/2023,102.74,747.2199999999999
96121732,11/02/2023,1669.7,2416.92
96121732,11/02/2023,-75.16,2341.7599999999998
96121732,13/02/2023,164.0,2505.7599999999998
96121732,13/02/2023,99.06,2604.8199999999997
96121732,14/02/2023,-164.38,2440.44
96153427,31/01/2023,,24.33
96153427,01/02/2023,84.08,108.41
96153427,03/02/2023,120.56,228.97
96153427,07/02/2023,85.35,314.32
96197628,31/01/2023,,829.37
96197628,04/02/2023,-104.91,724.46
96197628,08/02/2023,-27.53,696.9300000000001
96197628,13/02/2023,134.97,831.9
96200049,31/01/2023,,959.58
96200049,01/02/2023,61.23,1020.8100000000001
96200049,02/02/2023,94.5,1115.31
96200049,02/02/2023,28.18,1143.49
96200049,03/02/2023,141.04,1284.53
96200049,03/02/2023,43.6,1328.13
96200049,13/02/2023,23.37,1351.5
96208050,31/01/2023,,171.46
96208050,01/02/2023,-48.99,122.47
96208050,01/02/2023,-139.18,-16.710000000000008
96208050,08/02/2023,-100.19,-116.9
96208050,09/02/2023,99.18,-17.72
96208050,10/02/2023,-115.74,-133.45999999999998
96208050,11/02/2023,89.22,-44.239999999999995
96208050,12/02/2023,92.93,48.69000000000001
96224831,31/01/2023,,926.76
96224831,02/02/2023,-46.46,880.3
96224831,03/02/2023,107.3,987.6
96224831,06/02/2023,-66.16,921.44
96224831,09/02/2023,-108.36,813.08
96224831,10/02/2023,168.64,981.72
96224831,11/02/2023,91.93,1073.65
96224831,12/02/2023,1265.1,2338.75
96224831,14/02/2023,-113.07,2225.68
96227490,31/01/2023,,242.11
96227490,05/02/2023,118.23,360.34000000000003
96227490,07/02/2023,945.2,1305.54
96227490,07/02/2023,-162.51,1143.0300000000002
96227490,12/02/2023,-1291.9,-148.8699999999999
96227490,13/02/2023,-48.77,-197.6399999999999
96227490,14/02/2023,-76.93,-274.56999999999994
96236719,31/01/2023,,999.32
96236719,02/02/2023,1015.8,2015.12
96236719,03/02/2023,-177.67,1837.45
96236719,09/02/2023,55.83,1893.28
96236719,13/02/2023,1370.1,3263.38
96278865,31/01/2023,,930.45
96278865,06/02/2023,1069.0,1999.45
96278865,06/02/2023,100.71,2100.16
96278865,07/02/2023,69.22,2169.38
96278865,07/02/2023,-1298.9,870.48
96278865,09/02/2023,37.9,908.38
96281358,31/01/2023,,463.07
96281358,06/02/2023,49.54,512.61
96281358,08/02/2023,163.93,676.54
96281358,11/02/2023,-56.16,620.38
96291927,31/01/2023,,227.22
96291927,01/02/2023,79.4,306.62
96291927,03/02/2023,-84.7,221.92000000000002
96291927,07/02/2023,-146.76,75.16000000000003
96291927,09/02/2023,-99.44,-24.279999999999973
96291927,09/02/2023,-123.88,-148.15999999999997
96291927,12/02/2023,148.17,0.010000000000019327
96291927,14/02/2023,38.4,38.41000000000002
96319450,31/01/2023,,779.16
96319450,01/02/2023,186.45,965.6099999999999
96319450,09/02/2023,16.12,981.7299999999999
96319450,10/02/2023,-38.95,942.78
96319450,11/02/2023,-207.88,734.9
96319450,13/02/2023,119.69,854.5899999999999
96367781,31/01/2023,,880.44
96367914,31/01/2023,,528.67
96367914,09/02/2023,155.69,684.3599999999999
96367914,12/02/2023,-18.96,665.4
96401230,31/01/2023,,21.44
96401230,01/02/2023,1663.4,1684.8400000000001
96401230,02/02/2023,-198.28,1486.5600000000002
96401230,03/02/2023,-44.59,1441.9700000000003
96401230,03/02/2023,-85.24,1356.7300000000002
96401230,07/02/2023,-24.41,1332.3200000000002
96401230,08/02/2023,96.33,1428.65
96401230,08/02/2023,-797.2,631.45
96401230,11/02/2023,-1813.6,-1182.1499999999999
96510893,31/01/2023,,396.83
96510893,02/02/2023,185.26,582.0899999999999
96510893,09/02/2023,74.41,656.5
96510893,11/02/2023,-782.2,-125.70000000000005
96510893,14/02/2023,-108.65,-234.35000000000005
96605778,31/01/2023,,70.72
96605778,01/02/2023,-112.98,-42.260000000000005
96605778,02/02/2023,-116.89,-159.15
96605778,02/02/2023,-158.28,-317.43
96605778,04/02/2023,-303.4,-620.8299999999999
96605778,08/02/2023,697.8,76.97000000000003
96605778,09/02/2023,75.39,152.36
96605778,09/02/2023,51.97,204.33000000000004
96605778,09/02/2023,-226.54,-22.20999999999998
96649120,31/01/2023,,307.91
96649120,04/02/2023,105.93,413.84000000000003
96649120,05/02/2023,-46.34,367.5
96649120,05/02/2023,-126.99,240.51000000000005
96649120,07/02/2023,98.77,339.28000000000003
96649120,07/02/2023,79.53,418.81000000000006
96649120,08/02/2023,-135.91,282.90000000000003
96649120,12/02/2023,-36.33,246.57000000000005
96649120,13/02/2023,53.33,299.90000000000003
96689242,31/01/2023,,896.22
96689242,01/02/2023,45.7,941.9200000000001
96689242,03/02/2023,85.62,1027.54
96689242,05/02/2023,142.12,1169.66
96689242,06/02/2023,-1253.1,-83.43999999999983
96689242,11/02/2023,82.15,-1.2899999999998215
96719450,31/01/2023,,633.74
96719450,07/02/2023,-744.0,-110.25999999999999
96719450,08/02/2023,118.94,8.680000000000007
96719450,08/02/2023,-104.01,-95.33
96719450,10/02/2023,1362.1,1266.77
96719450,10/02/2023,82.33,1349.1
96719450,11/02/2023,-59.16,1289.94
96719450,11/02/2023,-86.86,1203.08
96719450,11/02/2023,-754.3,448.78
96756719,31/01/2023,,601.68
96756719,04/02/2023,-69.05,532.63
96756719,05/02/2023,-49.84,482.78999999999996
96756719,06/02/2023,-64.62,418.16999999999996
96756719,06/02/2023,-887.9,-469.73
96756719,07/02/2023,113.6,-356.13
96756719,07/02/2023,-155.69,-511.82000000000005
96756719,08/02/2023,-104.55,-616.37
96756719,10/02/2023,871.2,254.83000000000004
96756719,12/02/2023,61.95,316.78000000000003
96756719,13/02/2023,-154.58,162.20000000000005
96837696,31/01/2023,,889.9
96837696,05/02/2023,-1131.8,-241.89999999999998
96837696,07/02/2023,-164.7,-406.59999999999997
96837696,08/02/2023,19.11,-387.48999999999995
96837696,11/02/2023,-173.7,-561.1899999999999
96847078,31/01/2023,,412.48
96847078,01/02/2023,105.94,518.4200000000001
96847078,02/02/2023,-179.67,338.75
96847078,08/02/2023,105.67,444.42
96847078,08/02/2023,-24.38,420.04
96847078,10/02/2023,121.67,541.71
96847078,10/02/2023,-118.13,423.58000000000004
96847078,13/02/2023,20.17,443.75000000000006
96948178,31/01/2023,,217.26
96948178,07/02/2023,86.52,303.78
96948178,07/02/2023,-71.18,232.59999999999997
96948178,08/02/2023,103.89,336.49
96948178,10/02/2023,-80.58,255.90999999999997
96948178,12/02/2023,134.36,390.27
97010482,31/01/2023,,542.39
97010482,01/02/2023,83.77,626.16
97010482,05/02/2023,103.38,729.54
97010482,09/02/2023,-41.77,687.77
97010482,13/02/2023,78.01,765.78
97036090,31/01/2023,,349.78
97036090,03/02/2023,-161.37,188.40999999999997
97036090,04/02/2023,118.37,306.78
97036090,06/02/2023,86.95,393.72999999999996
97036090,09/02/2023,951.0,1344.73
97036090,09/02/2023,65.76,1410.49
97048058,31/01/2023,,977.42
97048058,03/02/2023,584.3,1561.7199999999998
97048058,03/02/2023,96.94,1658.6599999999999
97048058,08/02/2023,-77.23,1581.4299999999998
97048058,09/02/2023,-121.34,1460.09
97048058,10/02/2023,103.59,1563.6799999999998
97098684,31/01/2023,,463.91
97098684,01/02/2023,-0.96,462.95000000000005
97098684,03/02/2023,72.77,535.72
97098684,04/02/2023,76.94,612.6600000000001
97098684,05/02/2023,144.38,757.04
97098684,07/02/2023,-68.86,688.1800000000001
97098684,08/02/2023,204.91,893.09
97187999,31/01/2023,,170.66
97187999,01/02/2023,43.65,214.31
97187999,03/02/2023,-94.5,119.81
97187999,05/02/2023,-27.88,91.93
97187999,10/02/2023,-70.11,21.820000000000007
97187999,11/02/2023,-9.25,12.570000000000007
97187999,13/02/2023,518.3,530.87
97187999,14/02/2023,-60.02,470.85
97187999,14/02/2023,-725.0,-254.14999999999998
97258853,31/01/2023,,348.49
97258853,01/02/2023,106.33,454.82
97258853,02/02/2023,1157.4,1612.22
97258853,03/02/2023,78.66,1690.88
97258853,06/02/2023,1912.9,3603.78
97258853,06/02/2023,-833.9,2769.88
97258853,11/02/2023,157.05,2926.9300000000003
97258853,12/02/2023,-81.63,2845.3
97258853,14/02/2023,-47.84,2797.46
97265555,31/01/2023,,73.24
97265555,01/02/2023,137.25,210.49
97265555,03/02/2023,99.42,309.91
97265555,04/02/2023,-77.66,232.25
97265555,09/02/2023,-159.05,73.19999999999999
97265555,13/02/2023,-158.03,-84.83000000000001
97294152,31/01/2023,,700.06
97294152,01/02/2023,1194.4,1894.46
97294152,01/02/2023,120.93,2015.39
97294152,01/02/2023,3.55,2018.94
97294152,03/02/2023,-240.55,1778.39
97294152,04/02/2023,-153.31,1625.08
97294152,07/02/2023,162.51,1787.5900000000001
97294152,11/02/2023,-159.09,1628.5
97294152,12/02/2023,-95.61,1532.89
97294152,13/02/2023,-111.96,1420.93
97294152,14/02/2023,-149.9,1271.03
97305293,31/01/2023,,241.02
97305293,03/02/2023,196.95,437.97
97305293,09/02/2023,145.02,582.99
97305293,10/02/2023,-158.94,424.05
97305293,11/02/2023,-99.56,324.49
97305293,14/02/2023,-65.5,258.99
97328154,31/01/2023,,535.51
97328154,03/02/2023,-90.64,444.87
97328154,07/02/2023,-78.9,365.96999999999997
97328154,08/02/2023,-143.22,222.75
97328154,09/02/2023,135.18,357.93
97328154,11/02/2023,55.67,413.6
97328154,11/02/2023,-107.57,306.03000000000003
97405607,31/01/2023,,981.02
97405607,02/02/2023,93.09,1074.11
97405607,06/02/2023,527.4,1601.51
97405607,06/02/2023,5.35,1606.86
97405607,08/02/2023,-147.08,1459.78
97405607,10/02/2023,-98.32,1361.46
97405607,11/02/2023,56.36,1417.82
97405607,12/02/2023,122.13,1539.95
97405607,12/02/2023,-139.57,1400.38
97405607,13/02/2023,144.57,1544.95
97426293,31/01/2023,,771.74
97426293,03/02/2023,-44.25,727.49
97426293,08/02/2023,-4.84,722.65
97426293,10/02/2023,-28.23,694.42
97426293,11/02/2023,-116.14,578.28
97426293,12/02/2023,-26.9,551.38
97426293,12/02/2023,-112.63,438.75
97426293,14/02/2023,-79.54,359.21
97439311,31/01/2023,,196.91
97439311,06/02/2023,74.25,271.15999999999997
97439311,06/02/2023,-43.59,227.57
97439311,07/02/2023,218.5,446.07
97439311,10/02/2023,705.9,1151.97
97439311,13/02/2023,-2.0,1149.9699999999998
97439311,14/02/2023,136.93,1286.8999999999999
97445899,31/01/2023,,195.42
97445899,01/02/2023,-473.7,-278.28
97445899,04/02/2023,94.61,-183.67000000000002
97445899,04/02/2023,-123.12,-306.79
97445899,06/02/2023,42.54,-264.25000000000006
97445899,08/02/2023,-687.1,-951.3500000000001
97487639,31/01/2023,,403.96
97487639,01/02/2023,110.45,514.41
97487639,01/02/2023,-119.97,394.44
97487639,02/02/2023,151.59,546.03
97487639,03/02/2023,48.79,594.8199999999999
97487639,08/02/2023,157.04,751.8599999999999
97487639,09/02/2023,-1582.3,-830.44
97487639,10/02/2023,200.96,-629.48
97501557,31/01/2023,,572.14
97501557,05/02/2023,148.09,720.23
97501557,08/02/2023,-114.12,606.11
97501557,10/02/2023,144.36,750.47
97501557,10/02/2023,41.65,792.12
97501557,10/02/2023,-66.98,725.14
97501557,10/02/2023,-87.35,637.79
97521278,31/01/2023,,833.78
97521278,06/02/2023,-86.95,746.8299999999999
97521278,08/02/2023,-165.57,581.26
97521278,10/02/2023,121.92,703.18
97521278,13/02/2023,-66.09,637.09
97521278,14/02/2023,-120.16,516.93
97526378,31/01/2023,,540.88
97526378,02/02/2023,-63.42,477.46
97526378,03/02/2023,-769.3,-291.84
97526378,04/02/2023,200.42,-91.41999999999999
97526378,07/02/2023,-55.28,-146.7
97526378,12/02/2023,-89.7,-236.39999999999998
97541080,31/01/2023,,677.34
97541080,03/02/2023,102.16,779.5
97541080,11/02/2023,-2361.6,-1582.1
97542348,31/01/2023,,768.87
97542348,01/02/2023,97.36,866.23
97542348,01/02/2023,77.94,944.17
97542348,02/02/2023,33.06,977.23
97542348,03/02/2023,89.38,1066.61
97542348,05/02/2023,-897.5,169.11
97542348,06/02/2023,114.33,283.44
97542348,06/02/2023,-193.06,90.38
97542348,14/02/2023,-187.3,-96.92000000000002
97555037,31/01/2023,,405.29
97555037,05/02/2023,141.29,546.58
97555037,10/02/2023,67.07,613.65
97555037,14/02/2023,175.06,788.71
97555037,14/02/2023,-77.4,711.31
97558121,31/01/2023,,699.28
97558121,05/02/2023,135.59,834.87
97558121,08/02/2023,-119.07,715.8
97558121,14/02/2023,132.91,848.71
97558121,14/02/2023,105.11,953.8199999999999
97558121,14/02/2023,53.27,1007.09
97571696,31/01/2023,,622.92
97571696,01/02/2023,1361.0,1983.92
97571696,08/02/2023,15.71,1999.63
97581232,31/01/2023,,608.89
97581232,07/02/2023,135.32,744.21
97581232,09/02/2023,1166.4,1910.6100000000001
97581232,11/02/2023,134.72,2045.3300000000002
97581232,12/02/2023,-143.91,1901.42
97581232,12/02/2023,-146.24,1755.18
97624673,31/01/2023,,481.09
97624673,07/02/2023,-92.81,388.28
97624673,08/02/2023,95.08,483.35999999999996
97624673,11/02/2023,130.33,613.69
97624673,13/02/2023,116.67,730.36
97738591,31/01/2023,,254.4
97738591,09/02/2023,101.26,355.66
97738591,12/02/2023,-88.41,267.25
97738591,14/02/2023,81.15,348.40000000000003
97762952,31/01/2023,,411.87
97762952,01/02/2023,-38.91,372.96000000000004
97762952,02/02/2023,-15.44,357.52
97762952,04/02/2023,-97.94,259.58000000000004
97762952,08/02/2023,128.28,387.86
97762952,09/02/2023,-101.53,286.33000000000004
97762952,11/02/2023,471.8,758.13
97762952,13/02/2023,-113.3,644.83
97773835,31/01/2023,,165.51
97773835,03/02/2023,-72.44,93.07
97773835,09/02/2023,-134.52,-41.45000000000002
97843608,31/01/2023,,19.05
97843608,03/02/2023,349.6,368.65000000000003
97843608,04/02/2023,111.47,480.12
97843608,06/02/2023,22.17,502.29
97843608,12/02/2023,104.69,606.98
97843608,13/02/2023,-187.8,419.18
97844854,31/01/2023,,547.15
97844854,02/02/2023,-142.95,404.2
97844854,12/02/2023,-133.45,270.75
97844854,14/02/2023,-91.73,179.01999999999998
97870414,31/01/2023,,818.88
97870414,01/02/2023,-160.61,658.27
97870414,01/02/2023,-913.5,-255.23000000000002
97870414,03/02/2023,-195.63,-450.86
97870414,06/02/2023,-374.5,-825.36
97870414,07/02/2023,-164.87,-990.23
97870414,12/02/2023,-81.53,-1071.76
97913385,31/01/2023,,498.49
97913385,01/02/2023,98.26,596.75
97913385,01/02/2023,50.55,647.3
97913385,03/02/2023,117.86,765.16
97913385,05/02/2023,-78.62,686.54
97913385,08/02/2023,-362.6,323.94
97913385,10/02/2023,210.62,534.56
97913385,10/02/2023,-27.72,506.84000000000003
97913385,13/02/2023,74.3,581.14
97935683,31/01/2023,,40.96
97935683,06/02/2023,-152.16,-111.19999999999999
97935683,14/02/2023,-173.88,-285.08
97939041,31/01/2023,,320.97
97939041,04/02/2023,66.17,387.14000000000004
97939041,06/02/2023,-68.88,318.26000000000005
97939041,11/02/2023,792.4,1110.66
97939041,11/02/2023,-18.39,1092.27
97939041,13/02/2023,80.1,1172.37
97939041,13/02/2023,-145.1,1027.27
97944124,31/01/2023,,258.19
97944124,14/02/2023,-100.16,158.03
97954732,31/01/2023,,506.16
97954732,04/02/2023,-142.88,363.28000000000003
97954732,11/02/2023,116.92,480.20000000000005
97954732,14/02/2023,154.35,634.55
97970258,31/01/2023,,309.14
97970258,01/02/2023,-35.88,273.26
97970258,01/02/2023,-89.15,184.10999999999999
97970258,03/02/2023,-110.38,73.72999999999999
97970258,08/02/2023,-64.87,8.859999999999985
97970258,11/02/2023,-72.82,-63.96000000000001
97970258,12/02/2023,-94.05,-158.01
97970258,13/02/2023,-37.31,-195.32
97983552,31/01/2023,,584.92
97983552,01/02/2023,670.1,1255.02
97983552,03/02/2023,-214.53,1040.49
97983552,06/02/2023,-1912.9,-872.4100000000001
97983552,10/02/2023,-819.0,-1691.41
97985291,31/01/2023,,234.19
97985291,02/02/2023,-53.0,181.19
97985291,03/02/2023,79.51,260.7
97985291,05/02/2023,131.72,392.42
97985291,08/02/2023,187.67,580.09
97985291,08/02/2023,-62.88,517.21
97985291,13/02/2023,-123.05,394.15999999999997
97988499,31/01/2023,,344.28
97988499,01/02/2023,-97.37,246.90999999999997
97988499,05/02/2023,104.95,351.85999999999996
97988499,06/02/2023,-160.17,191.69
97988499,08/02/2023,1026.8,1218.49
97988499,12/02/2023,127.05,1345.54
97988499,12/02/2023,-98.15,1247.39
98043237,31/01/2023,,491.59
98043237,02/02/2023,-99.34,392.25
98043237,08/02/2023,-154.2,238.04999999999998
98043237,08/02/2023,-473.2,-235.15
98043237,13/02/2023,78.91,-156.24
98043237,13/02/2023,-75.02,-231.26
98070849,31/01/2023,,993.94
98070849,01/02/2023,140.27,1134.21
98070849,01/02/2023,125.14,1259.3500000000001
98070849,01/02/2023,54.98,1314.3300000000002
98070849,01/02/2023,-106.8,1207.53
98070849,04/02/2023,132.93,1340.46
98070849,08/02/2023,442.3,1782.7600000000002
98070849,08/02/2023,-110.55,1672.21
98070849,11/02/2023,96.9,1769.1100000000001
98070849,11/02/2023,68.2,1837.3100000000002
98070849,14/02/2023,120.46,1957.7700000000002
98107200,31/01/2023,,325.82
98107200,02/02/2023,140.34,466.15999999999997
98107200,03/02/2023,-9.03,457.13
98107200,03/02/2023,-66.9,390.23
98107200,10/02/2023,55.17,445.4
98112233,31/01/2023,,123.26
98112233,01/02/2023,-54.5,68.76
98112233,04/02/2023,163.03,231.79000000000002
98112233,04/02/2023,111.88,343.66999999999996
98112233,04/02/2023,74.95,418.62
98112233,04/02/2023,-129.37,289.25
98112233,05/02/2023,146.29,435.53999999999996
98112233,05/02/2023,-44.78,390.76
98112233,06/02/2023,75.16,465.91999999999996
98112233,06/02/2023,-739.3,-273.38
98112233,13/02/2023,114.36,-159.01999999999998
98112233,13/02/2023,113.41,-45.61
98112233,13/02/2023,-101.49,-147.1
98119030,31/01/2023,,179.3
98119030,04/02/2023,75.25,254.55
98119030,04/02/2023,48.63,303.18
98119030,07/02/2023,89.15,392.33000000000004
98119030,14/02/2023,-81.37,310.96000000000004
98138904,31/01/2023,,885.18
98138904,08/02/2023,-40.97,844.2099999999999
98138904,10/02/2023,46.29,890.5
98138904,13/02/2023,-126.07,764.43
98138904,14/02/2023,-118.69,645.74
98156945,31/01/2023,,449.81
98156945,02/02/2023,45.22,495.03
98156945,06/02/2023,711.2,1206.23
98156945,07/02/2023,-1567.0,-360.77
98156945,08/02/2023,150.5,-210.26999999999998
98156945,12/02/2023,44.88,-165.39
98156945,14/02/2023,60.92,-104.46999999999997
98159348,31/01/2023,,703.62
98159348,02/02/2023,-61.45,642.17
98159348,04/02/2023,-503.6,138.57
98159348,10/02/2023,128.06,266.63
98159348,11/02/2023,63.01,329.64
98159348,14/02/2023,92.59,422.23
98221133,31/01/2023,,596.52
98221133,01/02/2023,97.92,694.4399999999999
98221133,03/02/2023,-55.63,638.81
98221133,05/02/2023,111.54,750.35
98221133,06/02/2023,33.32,783.67
98221133,06/02/2023,-28.71,754.96
98221133,08/02/2023,1002.0,1756.96
98221133,09/02/2023,89.48,1846.44
98221133,09/02/2023,-132.75,1713.69
98221133,11/02/2023,-557.0,1156.69
98221133,12/02/2023,37.35,1194.04
98221133,12/02/2023,-62.63,1131.41
98221133,14/02/2023,40.73,1172.14
98237008,31/01/2023,,437.26
98237008,02/02/2023,865.4,1302.6599999999999
98237008,04/02/2023,61.06,1363.72
98237008,05/02/2023,72.53,1436.25
98237008,08/02/2023,61.29,1497.54
98237008,09/02/2023,-1038.5,459.03999999999996
98237008,12/02/2023,93.16,552.1999999999999
98237008,13/02/2023,199.57,751.77
98237008,13/02/2023,-162.05,589.7199999999999
98336782,31/01/2023,,266.46
98336782,06/02/2023,-34.2,232.26
98336782,06/02/2023,-95.71,136.54999999999998
98336782,08/02/2023,-106.87,29.67999999999998
98336782,11/02/2023,128.1,157.77999999999997
98336782,13/02/2023,55.26,213.03999999999996
98353764,31/01/2023,,763.6
98353764,03/02/2023,-179.54,584.0600000000001
98353764,04/02/2023,-85.2,498.86
98353764,13/02/2023,80.09,578.95
98372749,31/01/2023,,136.21
98372749,01/02/2023,130.44,266.65
98372749,01/02/2023,-45.11,221.54000000000002
98372749,07/02/2023,-101.79,119.75
98372749,09/02/2023,-75.46,44.290000000000006
98372749,10/02/2023,72.61,116.9
98372749,12/02/2023,-44.97,71.93
98377332,31/01/2023,,343.09
98377332,03/02/2023,127.44,470.53
98377332,08/02/2023,1779.2,2249.73
98377332,14/02/2023,-132.91,2116.82
98459176,31/01/2023,,168.19
98459176,01/02/2023,-229.8,-61.610000000000014
98459176,03/02/2023,-87.44,-149.05
98459176,03/02/2023,-88.58,-237.63
98459176,05/02/2023,-135.88,-373.51
98459176,06/02/2023,82.75,-290.76
98459176,07/02/2023,-737.4,-1028.1599999999999
98459176,12/02/2023,-155.17,-1183.33
98459176,13/02/2023,-63.98,-1247.31
98517701,31/01/2023,,277.91
98517701,07/02/2023,54.52,332.43
98517701,09/02/2023,-151.14,181.29000000000005
98568929,31/01/2023,,396.03
98568929,04/02/2023,157.68,553.71
98568929,05/02/2023,139.75,693.46
98568929,09/02/2023,-83.47,609.99
98568929,13/02/2023,1121.3,1731.29
98568929,14/02/2023,-119.48,1611.81
98575383,31/01/2023,,937.72
98575383,01/02/2023,-152.59,785.13
98575383,03/02/2023,-10.53,774.6
98575383,08/02/2023,-87.34,687.26
98575383,09/02/2023,-24.12,663.14
98575383,11/02/2023,-33.32,629.82
98575383,11/02/2023,-83.01,546.8100000000001
98575383,11/02/2023,-99.42,447.39
98575383,13/02/2023,-139.76,307.63
98575383,13/02/2023,-144.57,163.06000000000003
98596312,31/01/2023,,768.92
98596312,03/02/2023,-174.31,594.6099999999999
98596312,06/02/2023,-158.11,436.49999999999994
98596312,07/02/2023,-120.62,315.87999999999994
98596312,09/02/2023,88.39,404.2699999999999
98596312,09/02/2023,-33.68,370.5899999999999
98611122,31/01/2023,,595.22
98611122,01/02/2023,12.21,607.4300000000001
98611122,01/02/2023,-84.44,522.99
98611122,03/02/2023,913.8,1436.79
98611122,06/02/2023,76.04,1512.83
98611122,07/02/2023,-123.36,1389.47
98611122,09/02/2023,126.2,1515.67
98611122,09/02/2023,-57.19,1458.48
98611122,13/02/2023,118.5,1576.98
98611122,13/02/2023,-170.79,1406.19
98611122,14/02/2023,-103.89,1302.3
98620342,31/01/2023,,976.13
98620342,05/02/2023,1533.5,2509.63
98620342,10/02/2023,39.48,2549.11
98620342,12/02/2023,1006.5,3555.61
98620342,12/02/2023,91.93,3647.54
98620342,14/02/2023,152.69,3800.23
98671410,31/01/2023,,218.46
98671410,01/02/2023,-45.64,172.82
98671410,01/02/2023,-83.63,89.19000000000001
98671410,02/02/2023,198.45,287.64
98671410,02/02/2023,95.44,383.08
98671410,03/02/2023,1016.9,1399.98
98671410,05/02/2023,90.06,1490.04
98671410,06/02/2023,-32.37,1457.6699999999998
98671410,13/02/2023,-73.86,1383.81
98717357,31/01/2023,,183.63
98717357,03/02/2023,-151.73,31.900000000000006
98717357,04/02/2023,-1369.6,-1337.6999999999998
98717357,06/02/2023,-51.75,-1389.4499999999998
98717357,06/02/2023,-104.0,-1493.4499999999998
98776498,31/01/2023,,79.4
98821521,31/01/2023,,906.51
98821521,01/02/2023,-54.71,851.8
98821521,02/02/2023,-87.06,764.74
98821521,07/02/2023,84.76,849.5
98821521,08/02/2023,-88.56,760.9399999999999
98821521,13/02/2023,139.98,900.92
98821521,13/02/2023,-152.6,748.3199999999999
98849007,31/01/2023,,58.26
98849007,01/02/2023,4.45,62.71
98849007,11/02/2023,103.41,166.12
98849007,12/02/2023,183.53,349.65
98882065,31/01/2023,,630.68
98882065,01/02/2023,92.81,723.49
98882065,01/02/2023,-75.85,647.64
98882065,06/02/2023,-1065.6,-417.9599999999999
98882065,07/02/2023,84.81,-333.1499999999999
98882065,07/02/2023,-125.12,-458.2699999999999
98882065,09/02/2023,56.29,-401.9799999999999
98882065,11/02/2023,-45.84,-447.81999999999994
98882225,31/01/2023,,881.65
98882225,05/02/2023,153.59,1035.24
98882225,05/02/2023,-1712.2,-676.96
98882225,11/02/2023,259.39,-417.57000000000005
98882225,13/02/2023,56.85,-360.72
98886699,31/01/2023,,300.31
98886699,01/02/2023,152.86,453.17
98886699,04/02/2023,80.75,533.9200000000001
98886699,04/02/2023,-44.06,489.86
98886699,10/02/2023,-1124.9,-635.0400000000001
98886699,11/02/2023,32.04,-603.0000000000001
98886699,12/02/2023,180.44,-422.56000000000006
98931016,31/01/2023,,561.33
98931016,02/02/2023,89.8,651.13
98931016,02/02/2023,69.41,720.5400000000001
98931016,02/02/2023,-755.3,-34.75999999999988
98931016,10/02/2023,96.34,61.580000000000126
98931016,14/02/2023,349.1,410.6800000000002
98940578,31/01/2023,,59.28
98940578,06/02/2023,1032.3,1091.58
98940578,06/02/2023,-94.25,997.3299999999999
98940578,07/02/2023,99.74,1097.07
98940578,08/02/2023,-44.49,1052.58
99000939,31/01/2023,,155.29
99000939,04/02/2023,-58.31,96.97999999999999
99000939,06/02/2023,-138.14,-41.16
99000939,07/02/2023,-11.35,-52.51
99000939,07/02/2023,-92.7,-145.21
99000939,09/02/2023,-84.51,-229.72
99015119,31/01/2023,,443.55
99015119,03/02/2023,565.2,1008.75
99015119,03/02/2023,-112.46,896.29
99015119,05/02/2023,49.2,945.49
99015119,06/02/2023,-76.0,869.49
99015119,09/02/2023,147.12,1016.61
99015119,11/02/2023,-125.31,891.3
99015119,12/02/2023,-18.99,872.3100000000001
99244906,31/01/2023,,965.33
99244906,01/02/2023,-88.65,876.6800000000001
99244906,02/02/2023,51.28,927.96
99244906,04/02/2023,-105.17,822.7900000000001
99244906,08/02/2023,-133.74,689.05
99244906,10/02/2023,-50.52,638.53
99244906,13/02/2023,-72.94,565.59
99261094,31/01/2023,,475.8
99261094,01/02/2023,-119.5,356.3
99261094,04/02/2023,85.2,441.5
99261094,06/02/2023,646.5,1088.0
99261094,10/02/2023,-25.17,1062.83
99261094,12/02/2023,209.98,1272.81
99261094,12/02/2023,38.33,1311.14
99261094,14/02/2023,-98.11,1213.03
99261094,14/02/2023,-111.83,1101.2
99296816,31/01/2023,,814.56
99296816,01/02/2023,-246.14,568.42
99296816,02/02/2023,-634.2,-65.78000000000009
99296816,05/02/2023,-76.31,-142.0900000000001
99296816,06/02/2023,56.09,-86.00000000000009
99296816,06/02/2023,-77.23,-163.23000000000008
99296816,08/02/2023,66.6,-96.6300000000001
99296816,10/02/2023,178.01,81.3799999999999
99296816,14/02/2023,-83.33,-1.9500000000001023
99481977,31/01/2023,,940.06
99481977,01/02/2023,114.04,1054.1
99481977,02/02/2023,1695.5,2749.6
99481977,07/02/2023,-43.31,2706.29
99481977,07/02/2023,-1808.5,897.79
99481977,09/02/2023,-89.48,808.31
99481977,13/02/2023,-129.28,679.03
99481977,14/02/2023,-40.82,638.2099999999999
99496896,31/01/2023,,431.32
99496896,08/02/2023,65.82,497.14
99514298,31/01/2023,,154.78
99514298,01/02/2023,-73.14,81.64
99514298,02/02/2023,111.58,193.22
99514298,04/02/2023,-62.25,130.97
99514298,05/02/2023,-81.05,49.92
99514298,06/02/2023,-75.9,-25.980000000000004
99514298,07/02/2023,1121.9,1095.92
99514298,07/02/2023,-104.21,991.71
99514298,10/02/2023,-147.51,844.2
99514298,12/02/2023,-148.17,696.0300000000001
99514298,14/02/2023,-558.8,137.23000000000013
99553778,31/01/2023,,621.65
99553778,04/02/2023,180.29,801.9399999999999
99553778,04/02/2023,163.96,965.9
99553778,04/02/2023,104.91,1070.81
99553778,04/02/2023,-141.33,929.48
99553778,05/02/2023,-974.8,-45.319999999999936
99553778,10/02/2023,97.9,52.58000000000007
99553778,12/02/2023,-63.69,-11.109999999999928
99553778,13/02/2023,-47.54,-58.64999999999993
99553778,14/02/2023,-76.31,-134.95999999999992
99611232,31/01/2023,,849.72
99611232,01/02/2023,-119.74,729.98
99611232,04/02/2023,-117.6,612.38
99611232,06/02/2023,69.84,682.22
99611232,09/02/2023,-161.19,521.03
99611232,10/02/2023,-38.38,482.65000000000003
99611232,14/02/2023,49.55,532.2
99657974,31/01/2023,,263.32
99657974,01/02/2023,-114.47,148.85
99657974,03/02/2023,-157.43,-8.580000000000013
99657974,06/02/2023,1.58,-7.000000000000012
99657974,08/02/2023,160.99,153.99
99657974,09/02/2023,82.14,236.13
99657974,10/02/2023,57.04,293.17
99657974,14/02/2023,134.42,427.59000000000003
99678854,31/01/2023,,664.0
99678854,06/02/2023,128.13,792.13
99678854,07/02/2023,199.41,991.54
99678854,07/02/2023,76.35,1067.8899999999999
99678854,14/02/2023,111.15,1179.04
99685765,31/01/2023,,43.01
99685765,02/02/2023,10.1,53.11
99685765,04/02/2023,91.11,144.22
99685765,06/02/2023,-120.6,23.620000000000005
99685765,08/02/2023,-957.8,-934.18
99685765,09/02/2023,34.17,-900.01
99685765,10/02/2023,-98.69,-998.6999999999999
99685765,11/02/2023,1815.0,816.3000000000001
99709741,31/01/2023,,98.23
99709741,07/02/2023,12.69,110.92
99709741,09/02/2023,73.82,184.74
99709741,13/02/2023,-138.4,46.339999999999975
99729369,31/01/2023,,751.01
99729369,01/02/2023,-1194.4,-443.3900000000001
99729369,02/02/2023,124.21,-319.1800000000001
99729369,03/02/2023,-240.26,-559.44
99729369,03/02/2023,-1619.6,-2179.04
99729369,04/02/2023,127.68,-2051.36
99729369,06/02/2023,-89.63,-2140.99
99729369,07/02/2023,138.38,-2002.61
99729369,10/02/2023,-144.33,-2146.94
99730589,31/01/2023,,988.44
99730589,03/02/2023,58.23,1046.67
99730589,09/02/2023,155.34,1202.01
99730589,10/02/2023,62.26,1264.27
99734848,31/01/2023,,354.29
99734848,04/02/2023,503.6,857.8900000000001
99734848,12/02/2023,-1342.4,-484.51
99734848,14/02/2023,-79.76,-564.27
99760030,31/01/2023,,988.0
99760030,02/02/2023,616.7,1604.7
99760030,02/02/2023,-1028.8,575.9000000000001
99760030,07/02/2023,-173.55,402.3500000000001
99760030,08/02/2023,80.13,482.4800000000001
99760030,11/02/2023,118.35,600.83
99760030,12/02/2023,-139.76,461.07000000000005
99760030,14/02/2023,140.07,601.1400000000001
99791709,31/01/2023,,15.05
99791709,03/02/2023,-89.38,-74.33
99791709,04/02/2023,142.88,68.55
99791709,04/02/2023,-2.86,65.69
99791709,06/02/2023,-1359.0,-1293.31
99791709,11/02/2023,78.32,-1214.99
99791709,13/02/2023,800.9,-414.0899999999999
99877007,31/01/2023,,582.0
99877007,01/02/2023,-103.16,478.84000000000003
99877007,02/02/2023,189.79,668.63
99877007,05/02/2023,-72.33,596.3
99877007,07/02/2023,154.41,750.71
99877007,11/02/2023,84.59,835.3
99937043,31/01/2023,,918.42
99937043,01/02/2023,71.22,989.64
99937043,02/02/2023,-142.45,847.1899999999999
99937043,03/02/2023,-52.49,794.6999999999999
99937043,04/02/2023,123.12,917.8199999999999
99937043,05/02/2023,52.36,970.18
99937043,06/02/2023,-92.42,877.76
99937043,09/02/2023,-122.91,754.8499999999999
99937043,11/02/2023,-125.33,629.52
99937043,13/02/2023,75.16,704.68
